border_size=1
usage=map

Uh          , Uh          , Uh          , Uh          , Uh          , Uh          , Uh          , Uu          , Uu          , Uu          , Uu          , Uu          , Uh          , Uh          , Uh          , Uh          , Uh          , Ur          , Ur          , Ur          , Ur          , Urb         , Urb         , Ur          , Ur          , Uu          , Uu^Uf       , Uu^Uf       , Uh          , Uh          , Uh          , Uu          , Uu          , Uu          , Uu          , Uu          , Uu          , Xu          , Xu          , Xu          , Xu          , Qxv
Uh          , Uh          , Uh          , Uh          , Uh          , Re          , Re          , Uh          , Uu^Uf       , Uu^Uf       , Uu^Uf       , Uu          , Uu          , Uu          , Uu          , Uu^Uf       , Uu^Uf       , Uu          , Uu^Uf       , Ur          , Ur          , Urb         , Urb         , Ur          , Ur          , Ur          , Uu          , Uu^Uf       , Uu^Uf       , Uh          , Uh          , Uh          , Uu          , Uu          , Uu          , Uu          , Uu          , Xu          , Xu          , Xu          , Qxv         , Qxv
Uu          , Uh          , Uu          , Uh          , Re          , Re          , Re^Uf       , Uu^Uf       , Uu^Uf       , Uu^Uf       , Uu          , Uu          , Uu          , Uu          , Uu          , Uu^Uf       , Uu^Uf       , Uu^Uf       , Uu^Uf       , Uu          , Ur          , Ur          , Urb         , Urb         , Ur          , Ur          , Ur          , Uu          , Uu^Uf       , Uh          , Uh          , Uu          , Uu          , Uu          , Uu          , Uu          , Uu          , Xu          , Xu          , Xu          , Qxv         , Qxv
Uu          , Uu          , Uu          , Uu          , Re          , Re^Uf       , Uu          , Uu^Uf       , Ww          , Uu^Uf       , Wwf         , Uu          , Uu          , Uu          , Uh          , Uu^Uf       , Uu          , Uu^Uf       , Uu^Uf       , Uu          , Uu          , Ur          , Ur          , Urb         , Ur          , Ur          , Ur          , Uu          , Uu          , Uu          , Re          , Uh          , Re          , Uu          , Wwf         , Ww          , Uu          , Uu          , Uu          , Xu          , Qxv         , Qxv
Uu^Uf       , Uu          , Uu          , Uu          , Uu          , Uh          , Uh          , Uu^Uf       , Ww          , Wwf         , Wwf         , Uu^Uf       , Uu^Uf       , Uh          , Uh          , Uu          , Uu^Uf       , Uu^Uf       , Uu^Uf       , Uu          , Uu          , Ur          , Ur          , Urb         , Urb         , Ur          , Ur          , Uu^Uf       , Uu^Uf       , Re          , Re^Uf       , Re          , Uu          , Wwf         , Uu          , Wwf         , Uu          , Uu          , Uu          , Qxv         , Qxv         , Qxv
Uu^Uf       , Uu^Uf       , Uu          , Uu          , Uh          , Uu          , Wwf         , Ww          , Wwf         , Wwf         , Uu          , Uh          , Uu^Uf       , Uh          , Uh          , Uh          , Uu          , Uu          , Uu          , Uu          , Uu^Uf       , Ur          , Ur          , Ur          , Urb         , Ur          , Ur          , Ur          , Uu          , Uu^Uf       , Re^Uf       , Re          , Uh          , Uu          , Uu          , Uu          , Uu          , Uu          , Uu          , Uu          , Qxv         , Qxv
Uh          , Uu^Uf       , Uu^Uf       , Uh          , Uh          , Uu          , Uu^Uf       , Wwf         , Ww          , Ww          , Uu          , Uh          , Uh          , Uh          , Uh          , Uh          , Uh          , Uu          , Re          , Uu          , Uu^Uf       , Uu          , Ur          , Ur          , Ur          , Urb         , Ur          , Ur          , Uu          , Uu          , Uu          , Uu          , Wwf         , Uh          , Uh          , Wwf         , Wwf         , Uu          , Uu          , Uu          , Uu          , Qxv
Uh          , Uh          , Uu^Uf       , Uh          , Uh          , Uh          , Uu^Uf       , Wwf         , Uu^Uf       , Ww          , Uu          , Uu          , Uh          , Uh          , Uh          , Uh          , Uh          , Uu          , Re          , Re^Uf       , Uu^Uf       , Uu          , Uu          , Ur          , Ur          , Ur          , Ur          , Ur          , Re          , Uu          , Uu^Uf       , Uu          , Wwf         , Uh          , Uh          , Wwf         , Wwf         , Ww          , Uu          , Uu          , Uu          , Uu
Uu^Uf       , Uh          , Re^Uf       , Uh          , Uu          , Uh          , Uu^Uf       , Re^Uf       , Re^Uf       , Uu          , Uu          , Uu          , Uu          , Uh          , Uh          , Uh          , Uh          , Uh          , Uu          , Re^Uf       , Uu^Uf       , Uu^Uf       , Wwf         , Uu          , Uu          , Uu          , Uu          , Re          , Re          , Uu^Uf       , Uu^Uf       , Wwf         , Uh          , Uh          , Uu          , Uu          , Uu          , Uu          , Uzw          , Uu          , Uu          , Uu
Uh          , Uu^Uf       , Re          , Re^Uf       , Uh          , Uu          , Re^Uf       , Re^Uf       , Re          , Re^Uf       , Re^Uf       , Uu          , Uu          , Uu          , Uu          , Re          , Uh          , Uh          , Uu          , Re          , Uu          , Uu^Uf       , Wwf         , Uu          , Uu          , Uu          , Uu          , Re          , Re          , Re^Uf       , Uu          , Wwf         , Uh          , Uh          , Uh          , Uu          , Uzw          , Uzw          , Uzw          , Uu          , Uu          , Uu
Uh          , Uh          , Re          , Uh          , Uh          , Uu^Uf       , Uu          , Uu          , Uu          , Uu          , Uu          , Uu          , Uu          , Uu^Dr       , Re          , Re          , Uu          , Uu          , Uu          , Uu          , Uu          , Uu          , Wwf         , Wwf         , Uu          , Uu          , Uu          , Uu          , Uu          , Re          , Uh          , Uh          , Uh          , Uh          , Uu          , Uu          , Uzw          , Uu          , Uu          , Uu          , Qxv         , Qxv
Uu          , Uu          , Uu          , Re          , Uu          , Uu          , Ur          , Ur          , Ur          , Uu          , Uu          , Uh          , Uh          , Uu          , Uu          , Re          , Uu          , Uu          , Uh          , Uu          , Uh          , Uh          , Uh          , Wwf         , Uu          , Uu          , Uu          , Uu          , Uu          , Uu          , Uu          , Uh          , Uu          , Uh          , Uu          , Uu          , Uzw          , Uu          , Qxv         , Qxv         , Qxv         , Qxv
Uu          , Uu          , Uu^Dr       , Uu          , Uu          , Uu          , Ur          , Ur          , Uu          , Uu          , Uu          , Uh          , Uh          , Uh          , Uh          , Uu          , Ww          , Uu          , Uu^Dr       , Uh          , Uh          , Uh          , Uh          , Uu          , Uh          , Uu          , Uu          , Uu          , Uu          , Uu          , Uzw          , Uu          , Uu          , Uu          , Uu          , Uu          , Uzw          , Qxv         , Qxv         , Qxv         , Qxv         , Qxv
Uu          , Uu          , Uu          , Uu          , Uu          , Ur          , Ur          , Uu          , Uu          , Uh          , Uh          , Uh          , Uh          , Uh          , Uh          , Uu          , Ww          , Ww          , Ww          , Uh          , Uh          , Uh          , Uh          , Uh^Dr       , Uh          , Uu          , Uu          , Uu          , Uu          , Uzw          , Uzw          , Uzw          , Uu          , Uu          , Uu          , Uu          , Qxv         , Qxv         , Qxv         , Qxv         , Qxv         , Qxv
Ur          , Ur          , Ur          , Ur          , Ur          , Ur          , Ur          , Ur          , Ur          , Uu          , Uu          , Uzw          , Uu          , Uh          , Uh          , Uh          , Ww          , Wo          , Wo          , Uh          , Uu          , Uh          , Uh          , Uh          , Uh          , Uzw          , Uzw          , Uu          , Uu          , Uu          , Uzw          , Uzw          , Uu          , Uu          , Qxv         , Qxv         , Qxv         , Qxv         , Qxv         , Qxv         , Qxv         , Qxv
Ur          , Ur          , Uu          , Ur          , Ur          , Ur          , Uu          , Ur          , Ur          , Uu          , Uu          , Uzw          , Uzw          , Uu          , Uu          , Uu          , Uu          , Ww          , Wo          , Ww          , Ww          , Uh          , Uu          , Uh          , Uzw          , Uzw          , Uzw          , Uu          , Uu          , Uu          , Uzw          , Uu          , Uu          , Qxv         , Qxv         , Qxv         , Qxv         , Qxv         , Qxv         , Qxv         , Qxv^Xo      , Qxv^Xo
Uu          , Uu          , Uu          , Uu          , Uu          , Uu          , Uu          , Uu          , Uu          , Uu          , Re          , Uu          , Uzw          , Uu          , Uu          , Uu          , Uu          , Ww          , Wo          , Wo          , Uu          , Uu          , Uzw          , Uzw^Dr       , Uu          , Uzw          , Uh          , Uu          , Uh          , Uu          , Uu          , Uu          , Uu          , Uh          , Uu^Dr       , Uh          , Uh          , Qxv         , Uu^Xo       , Uh^Xo       , Uu          , Uu
Uu          , Uu          , Qxv^Xo      , Uu          , Qxv^Xo      , Uu          , Uzw          , Uzw          , Uzw          , Uu          , Uzw          , Re          , Re          , Uu          , Uzw          , Uu          , Uu          , Ww          , Ww          , Uu          , Uu          , Uu          , Uu          , Uzw          , Uu          , Uu          , Uh          , Uh          , Uu          , Uu          , Uu          , Uu          , Uu          , Uu          , Uu          , Uu          , Uu          , Uh          , Uu^Xo       , Uu^Xo       , Uh          , Uu
Qxv^Xo      , Qxv^Xo      , Qxv         , Qxv^Xo      , Qxv         , Qxv^Xo      , Qxv^Xo      , Uzw          , Uu          , Uzw          , Uzw          , Re          , Re          , Uzw          , Uzw          , Uu          , Re          , Uu          , Ww          , Uu          , Uu          , Uu          , Re          , Uu          , Re          , Uh          , Uh          , Uh          , Uh          , Re          , Re          , Re          , Qxv^Xo      , Uh          , Uu          , Uh          , Uu^Xo       , Uu^Xo       , Uu          , Uu          , Uu          , Uh
Qxv         , Qxv         , Qxv         , Qxv         , Qxv         , Qxv         , Qxv^Xo      , Uu          , Uu          , Uu          , Uu          , Uu          , Uu          , Uzw          , Uzw          , Uzw          , Re          , Uu          , Uu          , Uu          , Uu          , Re          , Re          , Re          , Uu          , Uh          , Xu          , Xu          , Xu          , Uh          , Re          , Re          , Qxv^Xo      , Qxv^Xo      , Qxv^Xo      , Qxv^Xo      , Uu^Xo       , Uh          , Uu          , Uu          , Uh          , Uu
Qxv         , Qxv         , Qxv         , Qxv         , Qxv         , Qxv         , Qxv         , Qxv^Xo      , Xu          , Xu          , Xu          , Uu          , Xu          , Uu          , Uu          , Uzw          , Re          , Uu          , Uu          , Uu          , Qxv^Xo      , Qxv^Xo      , Qxv^Xo      , Qxv^Xo      , Qxv^Xo      , Qxv^Xo      , Xu          , Xu          , Xu          , Qxv^Xo      , Qxv^Xo      , Qxv^Xo      , Qxv         , Qxv         , Qxv^Xo      , Qxv^Xo      , Uu^Uf       , Uu          , Uh          , Uh          , Uu          , Uu
Qxv         , Qxv         , Qxv         , Qxv         , Qxv         , Qxv         , Qxv         , Qxv^Xo      , Qxv^Xo      , Xu          , Xu          , Xu          , Xu          , Xu          , Uu          , Uu          , Uu          , Re          , Uu          , Uu          , Qxv^Xo      , Qxv^Xo      , Qxv         , Qxv         , Qxv         , Qxv         , Xu          , Xu          , Xu          , Xu          , Qxv         , Qxv         , Qxv^Xo      , Qxv^Xo      , Uu          , Uu          , Uh          , Uh          , Uu          , Uh          , Uu          , Uu
Qxv         , Qxv         , Qxv         , Qxv         , Qxv         , Qxv         , Qxv         , Qxv         , Xu          , Xu          , Xu          , Xu          , Xu          , Xu          , Qxv^Xo      , Uu          , Uu          , Uu          , Uu          , Re          , Qxv^Xo      , Qxv         , Qxv         , Qxv         , Qxv         , Qxv         , Xu          , Xu          , Xu          , Xu          , Qxv^Xo      , Qxv^Xo      , Uu          , Uu          , Ur          , Uu^Ii       , Uu          , Uh          , Uu^Uf       , Uu^Uf       , Xu          , Xu
Qxv         , Qxv         , Qxv         , Qxv         , Qxv         , Qxv         , Qxv         , Xu          , Xu          , Xu          , Xu          , Xu          , Xu          , Xu          , Xu          , Qxv^Xo      , Qxv^Xo      , Qxv^Xo      , Qxv^Xo      , Qxv^Xo      , Qxv         , Qxv         , Qxv         , Uu          , Uu          , Xu          , Xu          , Xu          , Xu          , Xu          , Uu^Uf       , Uu          , Uu^Uf       , Ur          , Ur^Ii       , Uu^Ii       , Uu          , Uu          , Uu^Uf       , Yhl         , Xu          , Xu
Qxv         , Qxv         , Xu          , Qxv         , Xu          , Xu          , Xu          , Xu          , Xu          , Xu          , Xu          , Xu          , Qxv         , Qxv         , Qxv         , Qxv         , Qxv         , Qxv         , Qxv         , Qxv         , Qxv         , Qxv         , Uu          , Uu          , Xu          , Xu          , Xu          , Xu          , Xu          , Xu          , Uu^Uf       , Uu          , Uu^Uf       , Uu^Ufi      , Uu^Ii       , Ur          , Uu^Uf       , Uu          , Yhl         , Xu          , Xu          , Xu
Uu          , Xu          , Xu          , Xu          , Uu          , Xu          , Xu          , Xu          , Xu          , Xu          , Xu          , Xu          , Qxv         , Qxv         , Qxv         , Qxv         , Uu          , Qxv         , Qxv         , Qxv         , Qxv         , Uu          , Uu          , Uu          , Xu          , Xu          , Xu          , Xu          , Xu          , Xu          , Xu          , Xu          , Xu          , Uu^Ufi      , Uu          , Ur          , Ur          , Uu          , Yhl         , Yhl^Uf      , Xu          , Xu
Uu          , Uu          , Uu          , Uu          , Uu          , Uu          , Uu          , Uu          , Uu          , Xu          , Xu          , Xu          , Xu          , Qxv         , Qxv         , Qxv         , Uu          , Uu          , Uu          , Qxv         , Uu          , Uu          , Xu          , Xu          , Xu          , Xu          , Xu          , Xu          , Xu          , Xu          , Xu          , Xu          , Xu          , Xu          , Xu          , Uu          , Ur          , Ur          , Uu          , Yhl^Uf      , Yhl^Uf      , Xu
