border_size=1
usage=map

Xv          , Xv          , Xv          , Xv          , Xv          , Xv          , Xv          , Xv          , Xv          , Xv          , Xv          , Xv          , Xv          , Xv          , Xv          , Xv          , Xv          , Xv          , Xv          , Xv          , Xv          , Xv          , Xv          , Xv          , Xv          , Xv          , Xu          , Xu          , Uu^Ii       , Xu          , Xos         , Xos         , Xos         , Xos         , Yhl         , Xos         , Xos         , Xos         , Xos         , Xos         , Xos         , Xos         , Xos         , Xos         , Xos         , Xos         , Yhr         , Yhr         , Yhr^Xp      , Yhr         , Xos         , Xos         , Xos         , Yhr
Xos         , Xv          , Xv          , Xv          , Xv          , Xv          , Xv          , Xv          , Xv          , Xv          , Xv          , Xv          , Xv          , Xv          , Xv          , Xv          , Xv          , Xv          , Xv          , Xv          , Xv          , Xv          , Xv          , Xv          , Xu          , Xu          , Xu          , Xu          , Uzw          , Xu          , Xos         , Xos         , Yhl^Xp      , Yhl^Xp      , Xos         , Xos         , Xos         , Xos         , Xos         , Xos         , Xos         , Xos         , Xos         , Xos         , Yhr^Uf      , Yhr^Xp      , Yhr         , Yhr^Xp      , Xos         , Xos         , Xos         , Xos         , Yhr         , Yhr
Xos         , Xos         , Xos         , Xv          , Xv          , Xv          , Xv          , Xv          , Xv          , Xv          , Xv          , Xv          , Xv          , Xv          , Xv          , Xv          , Xv          , Xv          , Xv          , Xv          , Xv          , Xv          , Urb         , Xu          , Xu          , Xu          , Uu^Ii       , Xu          , Urb         , Xu          , Yhl^Xp      , Urb         , Yhl         , Xos         , Xos         , Yhl         , Yhl         , Xos         , Xos         , Xos         , Xos         , Xos         , Yhr         , Yhr         , Yhl         , Yhr         , Xos         , Xos         , Yhl         , Yhr^Xp      , Yhr         , Yhr         , Yhr         , Yhr
Xos         , Xos         , Xos         , Xos         , Xos         , Xv          , Xv          , Xv          , Xv          , Xv          , Xv          , Xv          , Xv          , Xv          , Xv          , Xv          , Xv          , Xv          , Xv          , Xv          , Urb         , Urb         , Urb         , Urb         , Uu^Ii       , Urb         , Urb         , Urb         , Uu^Ii       , Xu          , Yhl         , Urb         , Uu^Ii       , Yhl^Xp      , Yhl         , Uzw          , Uzw^Uf       , Yhl^Uf      , Yhl^Xp      , Xos         , Yhl         , Yhl         , Xos         , Xos         , Yhl^Xp      , Xos         , Yhl         , Yhl         , Xos         , Yhr         , Uh          , Yhr         , Xos         , Xos
Xos         , Xos         , Xos         , Xos         , Xos         , Xos         , Xos         , Xv          , Xv          , Xv          , Xv          , Xv          , Xv          , Xv          , Xv          , Xv          , Xv          , Xv          , Urb         , Urb         , Xos         , Xos         , Xos         , Urb         , Urb         , Urb         , Urb         , Urb         , Urb         , Xu          , Yhl^Xp      , Yhl         , Uzw          , Uzw          , Uzw          , Uzw          , Uzw          , Yhl         , Uzw          , Yhl         , Xos         , Yhl         , Yhl         , Xos         , Xos         , Yhl         , Xos         , Xos         , Yhr^Xp      , Yhr         , Yhl         , Yhr         , Yhr         , Yhl
Xos         , Xos         , Xos         , Xos         , Xos         , Xos         , Xos         , Xos         , Xos         , Xv          , Xv          , Xv          , Xv          , Xv          , Xv          , Xv          , Urb         , Urb         , Xos         , Xos         , Xos         , Xos         , Xu          , Xos         , Xos         , Uu^Ii       , Xu          , Uu^Ii       , Xu          , Xu          , Yhl^Xp      , Yhl^Xp      , Uzw          , Uzw          , Uzw          , Urb         , Urb         , Yhl         , Uzw          , Uzw^Uf       , Uzw          , Yhl         , Yhl^Xp      , Yhr         , Yhl         , Yhl^Xp      , Xos         , Xos         , Yhr         , Yhr         , Xos         , Yhr         , Yhr         , Yhr
Xos         , Xos         , Xos         , Xos         , Xos         , Xos         , Xos         , Xos         , Xos         , Xos         , Xos         , Xv          , Xv          , Xv          , Urb         , Urb         , Urb^Xo      , Urb^Xo      , Urb         , Xos         , Uu^Uf       , Xu          , Uu^Uf       , Xu          , Xu          , Xu          , Xu          , Xu          , Xu          , Xu          , Uu^Uf       , Yhl         , Uzw          , Uu^Ii       , Urb         , Yhl         , Yhl         , Yhl         , Yhl^Xp      , Uzw^Uf       , Yhr         , Yhr         , Yhl         , Yhr         , Yhr         , Xos         , Uzw          , Yhr         , Xos         , Yhl^Xp      , Yhl^Xp      , Xos         , Yhl         , Yhl
Xos         , Xos         , Xos         , Xos         , Xos         , Xos         , Xos         , Xos         , Xos         , Xos         , Xos         , Xos         , Xos         , Urb         , Xos         , Xos         , Xos         , Urb         , Urb         , Urb         , Urb         , Uu^Uf       , Uu^Uf       , Yhl^Xp      , Yhl         , Yhl^Xp      , Yhl         , Uu^Ii       , Uzw          , Urb         , Uu^Uf       , Uh          , Uzw          , Yhl         , Yhl         , Yhl         , Yhl         , Yhr         , Yhr         , Yhr         , Yhr^Xp      , Xos         , Xos         , Yhl^Xp      , Yhr^Uf      , Uzw          , Yhl         , Yhl^Xp      , Yhr         , Xos         , Yhl         , Yhl^Xp      , Yhl         , Yhr
Xos         , Xos         , Xu          , Xos         , Xos         , Xos         , Xos         , Xos         , Xos         , Xos         , Xos         , Xos         , Xos         , Xos         , Xos         , Xos         , Xos         , Urb         , Urb         , Urb         , Yhl^Xp      , Yhl         , Uu^Uf       , Uzw          , Yhl^Xp      , Uh          , Yhl^Xp      , Yhl^Xp      , Uzw          , Uzw          , Uzw          , Uu^Uf       , Yhl^Xp      , Yhl^Xp      , Yhl         , Yhl^Xp      , Yhl^Xp      , Yhl         , Yhl^Xp      , Yhr         , Yhl         , Yhl^Xp      , Yhr         , Yhr         , Uzw^Ufi      , Uzw          , Uzw          , Yhr         , Yhl         , Yhr         , Yhr         , Yhr^Ii      , Yhr         , Yhr
Xu          , Xu          , Xu          , Xu          , Xu          , Xos         , Xos         , Xos         , Urb         , Xos         , Xos         , Xos         , Xos         , Xos         , Uzw          , Uzw          , Uzw          , Urb         , Yhl^Xp      , Yhl         , Yhl         , Uu^Ii       , Uzw          , Uzw          , Urb         , Uzw          , Urb         , Urb         , Yhl^Xp      , Uzw          , Yhl         , Uu^Ii       , Uzw          , Yhl         , Yhl^Xp      , Uu^Uf       , Uu^Uf       , Yhl         , Yhl         , Uh          , Uzw          , Uzw          , Yhr         , Yhl^Ufi     , Yhl         , Yhl         , Xos         , Yhr         , Yhr^Uf      , Yhl         , Yhl         , Yhr^Ufi     , Yhl^Uf      , Yhl
Xu          , Xu          , Uzw          , Xu          , Uu^Uf       , Yhl         , Yhl^Xp      , Xos         , Urb         , Urb         , Yhl         , Yhl         , Uzw          , Uzw          , Urb         , Urb         , Uu^Uf       , Uu^Uf       , Yhl         , Yhl^Xp      , Uzw          , Uzw          , Uzw          , Urb         , Uzw          , Uzw          , Uzw          , Uzw          , Uu^Ii       , Uzw          , Uzw          , Uzw          , Uzw          , Uu^Uf       , Uu^Uf       , Yhl^Xp      , Yhl^Xp      , Yhl         , Yhl         , Yhr^Xp      , Yhr^Ii      , Uzw          , Yhr^Uf      , Yhl         , Yhl         , Xos         , Yhl^Xp      , Xos         , Xos         , Yhl         , Yhl         , Yhr^Uf      , Yhl         , Yhl
Xu          , Uu^Ii       , Uu^Uf       , Uzw          , Uu          , Uu          , Urb         , Yhl         , Urb         , Yhl         , Uu^Ii       , Yhl         , Yhl^Xp      , Yhl         , Uzw          , Yhl         , Uu^Uf       , Uu^Uf       , Uu^Uf       , Yhl^Xp      , Uzw          , 1 Uh        , Yhr         , Yhr         , Urb         , Uzw          , Ww          , Uzw          , Uzw          , Uzw          , Uzw          , Yhl         , Uu^Uf       , Uu^Uf       , Yhl^Xp      , Urb         , Urb         , Yhl         , Yhl         , Yhl         , Yhr^Ii      , Yhr^Xp      , Yhr         , Yhl^Ufi     , Yhl^Uf      , Xos         , Yhl         , Yhl         , Yhl         , Xos         , Xos         , Yhl         , Xos         , Xos
Xu          , Xu          , Uzw          , Uu^Uf       , Urb         , Urb         , Urb         , Urb         , Uzw          , Uzw          , Yhl         , Yhl^Xp      , Yhl^Xp      , Uzw          , Uzw          , Yhl^Xp      , Uu^Ii       , Yhl         , Uzw          , Uh          , Uzw          , Yhl^Xp      , Urb         , Urb         , Ww          , Yhr         , Ww          , Ww          , Uzw          , Yhl         , Yhl         , Yhl^Xp      , Uzw          , Yhl         , Urb         , Yhl^Xp      , Yhl^Xp      , Yhl         , Yhl         , Yhr         , Yhl^Xp      , Yhl         , Yhl^Xp      , Yhr^Ufi     , Yhr         , Yhl         , Yhr         , Yhl         , Yhr         , Yhl^Xp      , Xos         , Xos         , Yhr         , Yhl^Xp
Xu          , Xu          , Xu          , Uu          , Uh          , Yhl         , Uu^Uf       , Yhl         , Yhl^Xp      , Yhl         , Yhl^Xp      , Yhl^Xp      , Yhl         , Yhl         , Urb         , Yhl         , Yhl^Xp      , Yhl         , Uzw          , Uzw          , Uzw          , Uzw          , Urb         , Urb         , Ww          , Ww          , Ww          , Uzw          , Uzw          , Urb         , Uzw          , Uzw          , Uu^Ii       , Urb         , Yhl^Xp      , Uu^Uf       , Uu^Uf       , Yhl         , Xos         , Xos         , Xos         , Yhl         , Yhl         , Yhr         , Uzw^Ii       , Uzw          , Yhr^Xp      , Yhr^Uf      , Yhr^Uf      , Yhr         , Yhr         , Yhl^Xp      , Yhr         , Yhr
Xu          , Xu          , Xu          , Uzw          , Yhl^Xp      , Yhl^Xp      , Uu          , Uu^Ii       , Uu          , Yhl         , Urb         , Urb         , Uzw          , Uzw          , Urb         , Urb         , Yhl         , Uzw          , Uzw          , Yhl^Xp      , Uzw          , Urb         , Uzw          , Ww          , Ww          , Wo          , Ww          , Uzw          , Urb         , Uzw          , Uzw          , Yhl^Xp      , Yhl^Xp      , Uu^Uf       , Uu^Uf       , Yhl         , Yhl         , Yhl         , Xos         , Xos         , Yhr^Xp      , Yhr         , Yhr^Xp      , Yhr^Ii      , Uzw^Ii       , Uzw          , Yhl         , Yhl         , Yhl         , Yhr^Uf      , Uh          , Yhr         , Yhl         , Yhl
Xu          , Xu          , Xu          , Xu          , Yhl         , Uu^Uf       , Uu          , Uu          , Uu          , Uu          , Uh          , Uu^Uf       , Uu^Uf       , Uzw          , Yhl^Xp      , Yhl         , Urb         , Uzw          , Uzw          , Uzw          , Urb         , Urb         , Uzw          , Uzw          , Uzw          , Ww          , Uzw          , Urb         , Yhl^Xp      , Uzw          , Uzw          , Uu^Ii       , Urb         , Yhl         , Yhl         , Yhl         , Uzw          , Yhr         , Yhl         , Xos         , Xos         , Yhr         , Yhr         , Uzw^Ii       , Yhr         , Uzw          , Xos         , Xos         , Yhl         , Yhr^Uf      , Yhl^Uf      , Uzw^Uf       , Uzw          , Yhl
Xu          , Xu          , Xu          , Xu          , Xu          , Uu^Ii       , Uu          , Uu          , Uu          , Uu          , Uu          , Uu          , Uu^Uf       , Uu^Ii       , Yhl         , Yhl         , Urb         , Uzw          , Yhl         , Uu^Ii       , Uu^Uf       , Uzw          , Yhl         , Yhl         , Yhl^Xp      , Uzw          , Yhl^Xp      , Yhl         , Uzw          , Yhl         , Yhl         , Urb         , Urb         , Uh          , Yhl         , Uzw          , Uzw          , Yhl         , Yhr         , Yhr^Xp      , Yhl         , Xos         , Yhr^Xp      , Yhl^Xp      , Yhr         , Yhr         , Xos         , Yhl^Xp      , Xos         , Yhr         , Uzw^Uf       , Uzw          , Uzw^Ii       , Uzw
Xu          , Xu          , Xu          , Xu          , Urb         , Urb         , Uzw          , Uu          , Uzw          , Uu          , Uu          , Uu          , Uu^Uf       , Urb         , Urb         , Urb         , Yhl         , Yhl^Xp      , Cud         , Uu^Uf       , Urb         , Yhl         , Uzw          , Urb         , Uu^Uf       , Uzw          , Yhl         , Uzw          , Uu^Uf       , Urb         , Uzw          , Yhl         , Yhl         , Uh          , Yhl         , Uzw          , Uu^Ii       , Uzw          , Yhl         , Yhl         , Yhl         , Xos         , Yhl         , Yhl         , Yhl         , Yhr         , Xos         , Xos         , Yhr         , Yhr         , Yhl^Xp      , Yhr         , Yhr^Ii      , Yhl^Ii
Yhl         , Xu          , Yhl         , Xu          , Uzw          , Uzw          , Yhl         , Urb         , Yhl         , Yhl         , Uzw          , Uu^Uf       , Yhl         , Uu^Uf       , Yhl         , Yhl         , Yhl         , Cud         , 8 Kud       , Cud         , Yhl         , Uzw          , Yhl         , Uu^Uf       , Yhl         , Uh          , Yhl         , Yhl         , Uh          , Uu^Uf       , Uzw          , Yhl         , Uh          , Uh          , Uh          , Uzw          , Uzw          , Yhl         , Uh          , Yhl         , Yhl^Xp      , Yhl         , Yhl         , Yhl^Xp      , Yhl         , Xos         , Yhl         , Yhl         , Uzw          , Yhl         , Uzw          , Yhr^Xp      , Yhr^Ii      , Yhr^Ii
Yhl         , Yhl^Xp      , Uzw^Uf       , Uzw^Uf       , Uzw          , Uu^Uf       , Uu^Uf       , Yhl         , Yhl^Xp      , Yhl         , Uzw          , Yhl         , Yhl^Xp      , Yhl^Xp      , Yhl         , Yhl^Xp      , Cud         , Cud         , Cud         , Cud         , Yhl^Xp      , Uu          , Yhl         , Yhl         , Yhl         , Yhl         , Yhl^Uf      , Uzw          , Uzw          , Uh          , Uh          , Uh          , Xu          , Xu          , Xu          , Uh          , Uh          , Uh          , Yhl         , Yhl         , Yhl         , Yhl         , Yhl^Uf      , Yhl         , Yhr         , Uu^Ii       , Yhr^Ii      , Uzw          , Uzw^Uf       , Uzw^Uf       , Uh          , Yhr^Ii      , Yhr         , Yhl
Uzw          , Uzw          , Uzw          , Uzw^Uf       , Yhl^Xp      , Uu          , Uu          , Uu^Uf       , Uu^Uf       , Yhl^Xp      , Yhl         , Yhl         , Uzw          , Uzw          , Uzw          , Uu          , Uzw          , Yhl         , Urb         , Yhl         , Yhl         , Yhl         , Uu          , Yhl         , Yhl         , Yhl^Uf      , Uzw^Uf       , Uzw^Uf       , Uzw          , Uu^Uf       , Uh          , Xu          , Xu          , Xu          , Xu          , Xu          , Uh          , Uzw          , Uzw          , Yhl         , Yhr^Uf      , Yhr^Uf      , Yhl         , Yhr         , Yhl         , Yhr^Ii      , Yhl^Xp      , Uzw          , Uzw          , Uzw^Uf       , Yhr         , Yhl         , Yhl         , Yhl
Uzw          , Uzw          , Yhl         , Uzw          , Yhl         , Yhl         , Uu^Uf       , Uu^Ii       , Uzw          , Yhl         , Yhl         , Yhl         , Uu^Uf       , Uu^Uf       , Uu^Ii       , Uu          , Yhl         , Yhl         , Urb         , Urb         , Uu          , Uu^Ii       , Yhl^Xp      , Yhl         , Yhl         , Uzw          , Uu^Ii       , Yhl         , Uu^Uf       , Uu^Uf       , Uh          , Xu          , Xu          , 2 Xu        , Xu          , Xu          , Uh          , Uzw          , Uu^Ii       , Yhl         , Yhl         , Yhr^Uf      , Yhl         , Yhr^Xp      , Yhl         , Xos         , Xos         , Yhl         , Yhr^Xp      , Yhr^Uf      , Yhr         , Uh          , Uh          , Uh
Uzw          , Yhl         , Yhl^Xp      , Yhl         , Uzw          , Uzw^Uf       , Uu^Uf       , Uu          , Uh          , Uu          , Yhl         , Yhl^Uf      , Uzw          , Uu          , Yhl         , Yhl         , Yhl         , Yhl^Xp      , Yhl^Xp      , Uu          , Uh          , Uu          , Yhl^Xp      , Yhl^Xp      , Yhl         , Uzw^Uf       , Uzw          , Uu^Uf       , Uu^Uf       , Uu^Uf       , Uh          , Xu          , Xu          , Xu          , Xu          , Xu          , Uh          , Uzw          , Uzw          , Uzw          , Yhl         , Yhl         , Urb         , Yhr         , Cud         , Xos         , Xos         , Yhl         , Uzw          , Uzw          , Yhl^Xp      , Uh          , Xu          , Xu
Yhl         , Yhl         , Yhl         , Uzw          , Yhl         , Yhl         , Uu          , Uu^Uf       , Yhl         , Yhl^Xp      , Uzw          , Uzw          , Yhl^Xp      , Yhl         , Urb         , Yhl         , Yhl         , Yhl^Xp      , Uu          , Uu          , Yhl         , Yhl         , Yhl         , Yhl         , Yhl         , Yhl^Uf      , Yhl^Uf      , Yhl         , Uh          , Uh          , Yhl^Uf      , Uh          , Uh          , Xu          , Uh          , Uh          , Yhl         , Uh          , Uh          , Uzw          , Yhr         , Urb         , Uu^Uf       , Yhl         , Cud         , 9 Kud       , Cud         , Cud         , Yhr         , Uzw          , Xu          , Uh          , Xu          , Xu
Xu          , Xu          , Xu          , Yhl         , Yhl^Xp      , Urb         , Urb         , Yhl         , Uu          , Yhl         , Yhl         , Yhl         , Yhl         , Yhl         , Yhl         , Urb         , Yhl         , Yhl         , Yhl         , Uu          , Yhl         , Yhl         , Xos         , Yhl         , Yhl         , Yhl         , Yhl         , Yhl         , Yhl         , Yhl^Uf      , Uzw^Uf       , Uzw          , Uu          , Uh          , Uu          , Uzw          , Uzw          , Yhl         , Yhl         , Yhl         , Yhr^Xp      , Urb         , Yhl^Uf      , Uu^Uf       , Yhl         , Cud         , Yhr         , Yhr         , Yhl^Xp      , Yhl         , Xu          , Xu          , Xu          , Xu
Xu          , Xu          , Xu          , Yhl         , Yhl         , Yhl         , Urb         , Urb         , Uu          , Uu          , Yhl         , Yhl         , Xos         , Xos         , Xos         , Yhl         , Yhl         , Yhl         , Yhl         , Yhl^Xp      , Yhl         , Yhl         , Xos         , Yhl^Xp      , Xos         , Yhl         , Yhr         , Yhl         , Uzw          , Yhl^Uf      , Uu          , Uu          , Uu          , Uh          , Uu          , Uu^Ii       , Uzw          , Yhl         , Urb         , Yhl         , Uu          , Uu          , Uu^Uf       , Uu^Uf       , Uu^Uf       , Yhr         , Yhl         , Urb^Ii      , Urb^Ii      , Yhl^Ii      , Xu          , Xu          , Xu          , Xu
Xu          , Xu          , Xu          , Xu          , Yhl^Xp      , Yhl         , Yhl         , Yhl^Xp      , Yhl         , Yhl         , Xos         , Xos         , Xos         , Yhl^Xp      , Yhl         , Xos         , Xos         , Yhl         , Yhl         , Yhl         , Yhl         , Yhl         , Xos         , Xos         , Yhl         , Yhl         , Yhr^Xp      , Yhl         , Yhl         , Yhr         , Yhr         , Uu          , Urb         , Uh          , Yhl         , Yhl         , Urb         , Urb         , Yhr         , Uu^Ii       , Yhl         , Uu          , Uh          , Uu^Uf       , Yhl         , Uu^Uf       , Uu          , Uu          , Uu^Ii       , Urb         , Xu          , Xu          , Xu          , Xu
Xv          , Xu          , Xu          , Xu          , Xos         , Xos         , Xos         , Yhl         , Xos         , Xos         , Xos         , Yhl^Xp      , Yhl         , Xos         , Xos         , Yhl         , Yhl         , Yhl         , Yhl         , Yhl^Xp      , Yhl         , Yhl         , Xos         , Yhl^Xp      , Yhl         , Yhr         , Uu          , Yhl         , Uu          , Yhl         , Yhr^Uf      , Yhl         , Yhl         , Urb         , Yhr         , Yhr         , Yhl         , Yhl         , Yhr^Xp      , Urb         , Cud         , Cud         , Urb         , Yhl         , Yhl         , Uu^Uf       , Xu          , Uu          , Uu          , Xu          , Xu          , Xu          , Xu          , Xu
Xv          , Xv          , Xv          , Xu          , Xu          , Xos         , Xos         , Xos         , Xos         , Yhl^Xp      , Yhl         , Xos         , Xos         , Yhl         , Yhl         , Yhl         , Ql          , Ql          , Uu          , Yhl         , Uh          , Yhl         , Yhl         , Xos         , Xos         , Yhl         , Yhl         , Uu^Ii       , Urb         , Uu^Uf       , Yhl^Uf      , Yhr^Xp      , Yhr         , Yhr         , Urb         , Yhr         , Uu          , Yhr         , Yhl         , Urb         , Cud         , Kud         , Cud         , Urb         , Urb         , Xu          , Yhl^Xp      , Yhr         , Uh          , Xu          , Xu          , Xu          , Xu          , Xu
Xv          , Xv          , Xv          , Xv          , Xv          , Xu          , Xu          , Xos         , Xos         , Xos         , Xos         , Yhl         , Yhl         , Yhl         , Ql          , Ql          , Uh          , Yhl         , Uu^Ii       , Yhl         , Yhl         , Yhl         , Uu          , Yhl         , Xos         , Yhl         , Xos         , Uu          , Yhl         , Urb         , Urb         , Yhr^Uf      , Yhr         , Yhl         , Yhl         , Yhr^Ii      , Uu^Ii       , Uu          , Urb         , Cud         , Urb         , Urb         , Yhr         , Yhl         , Yhr         , Urb         , Urb         , Yhr         , Uh          , Xu          , Xu          , Xu          , Xu          , Xu
Xv          , Xv          , Xv          , Xv          , Xv          , Xv          , Xv          , Xu          , Xu          , Xu          , Ql          , Yhl         , Ql          , Ql          , Uu          , Uu          , Uu          , Uu          , Yhl         , Uu          , Urb         , Yhl         , Uu          , Yhl         , Xos         , Yhl^Xp      , Xos         , Yhr         , Yhr         , Yhl         , Urb         , Uh          , Yhl^Xp      , Yhl         , Urb^Ii      , Yhl^Ii      , Yhl         , Uu          , Urb         , Yhl         , Yhl         , Yhr         , Uu          , Uh          , Yhl         , Yhl         , Urb^Ii      , Yhl         , Uu          , Xu          , Xu          , Xu          , Xu          , Xu
Xv          , Xv          , Xv          , Xv          , Xv          , Xv          , Xv          , Xu          , Ql          , Ql^Xo       , Ql^Xo       , Ql          , Xu          , Uu          , Xos         , Xos         , Xos         , Yhl         , Yhl         , Uh          , Uu          , Urb         , Urb         , Uu          , Yhl         , Xos         , Yhr         , Yhr         , Yhl         , Urb         , Yhr         , Yhl         , Yhr         , Urb^Ii      , Yhr^Ii      , Urb         , Urb         , Urb         , Urb         , Yhl         , Yhr         , Yhr^Xp      , Yhr         , Uu          , Uu^Ii       , Uu^Ii       , Xu          , Uh          , Xu          , Xu          , Xu          , Xu          , Xu          , Xu
Xv          , Xv          , Xv          , Xv          , Xv          , Xv          , Xv          , Xv          , Xv          , Ql          , Xu          , Xu          , Xu          , Xos         , Xos         , Xos         , Xos         , Xos         , Yhl         , Yhl         , Uu          , Uu          , Uu          , Uu          , Yhr         , Yhl^Xp      , Uu          , Uu^Ii       , Urb         , Urb         , Yhl         , Yhr         , Yhl         , Yhr^Ii      , Yhl         , Yhl         , Uu          , Yhr         , Uu^Ii       , Uu          , Yhl         , Urb         , Urb         , Urb         , Yhr         , Uu^Ii       , Xu          , Xu          , Xu          , Xu          , Xu          , Xu          , Xu          , Xu
Xv          , Xv          , Xv          , Xv          , Xv          , Xv          , Xv          , Xv          , Xv          , Xv          , Xv          , Xv          , Xv          , Xu          , Xu          , Xos         , Xos         , Xos         , Yhl         , Yhl         , Yhl         , Uu          , Uu          , Uu          , Uu          , Uu          , Yhl         , Urb         , Urb         , Urb         , Urb         , Urb         , Urb         , Urb         , Urb         , Urb         , Urb         , Uu          , Urb^Ii      , Urb^Ii      , Urb         , Urb         , Yhl         , Urb         , Yhl         , Yhr         , Yhr         , Xu          , Yhl         , Xu          , Xu          , Xu          , Xu          , Xu
