border_size=1
usage=map

Xv          , Xv          , Xv          , Xv          , Xv          , Xv          , Xv          , Xv          , Xv          , Xv          , Xv          , Xv          , Xv          , Xv          , Xv          , Xv          , Xv          , Xv          , Xv          , Xv          , Xv          , Xv          , Xv          , Xv          , Xv          , Xv          , Xu          , Xu          , Uu^Ii       , Xu          , Xos         , Xos         , Xos         , Xos         , Yhl         , Xos         , Xos         , Xos         , Xos         , Xos         , Xos         , Xos         , Xos         , Xos         , Xos         , Xos         , Yhr         , Yhr         , Yhr^Xp      , Yhr         , Xos         , Xos         , Xos         , Yhr         
Xos         , Xv          , Xv          , Xv          , Xv          , Xv          , Xv          , Xv          , Xv          , Xv          , Xv          , Xv          , Xv          , Xv          , Xv          , Xv          , Xv          , Xv          , Xv          , Xv          , Xv          , Xv          , Xv          , Xv          , Xu          , Xu          , Xu          , Xu          , Zw          , Xu          , Xos         , Xos         , Yhl^Xp      , Yhl^Xp      , Xos         , Xos         , Xos         , Xos         , Xos         , Xos         , Xos         , Xos         , Xos         , Xos         , Yhr^Uf      , Yhr^Xp      , Yhr         , Yhr^Xp      , Xos         , Xos         , Xos         , Xos         , Yhr         , Yhr         
Xos         , Xos         , Xos         , Xv          , Xv          , Xv          , Xv          , Xv          , Xv          , Xv          , Xv          , Xv          , Xv          , Xv          , Xv          , Xv          , Xv          , Xv          , Xv          , Xv          , Xv          , Xv          , Ryd         , Xu          , Xu          , Xu          , Uu^Ii       , Xu          , Ryd         , Xu          , Yhl^Xp      , Ryd         , Yhl         , Xos         , Xos         , Yhl         , Yhl         , Xos         , Xos         , Xos         , Xos         , Xos         , Yhr         , Yhr         , Yhl         , Yhr         , Xos         , Xos         , Yhl         , Yhr^Xp      , Yhr         , Yhr         , Yhr         , Yhr         
Xos         , Xos         , Xos         , Xos         , Xos         , Xv          , Xv          , Xv          , Xv          , Xv          , Xv          , Xv          , Xv          , Xv          , Xv          , Xv          , Xv          , Xv          , Xv          , Xv          , Ryd         , Ryd         , Ryd         , Ryd         , Uu^Ii       , Ryd         , Ryd         , Ryd         , Uu^Ii       , Xu          , Yhl         , Ryd         , Uu^Ii       , Yhl^Xp      , Yhl         , Zw          , Zw^Uf       , Yhl^Uf      , Yhl^Xp      , Xos         , Yhl         , Yhl         , Xos         , Xos         , Yhl^Xp      , Xos         , Yhl         , Yhl         , Xos         , Yhr         , Uh          , Yhr         , Xos         , Xos         
Xos         , Xos         , Xos         , Xos         , Xos         , Xos         , Xos         , Xv          , Xv          , Xv          , Xv          , Xv          , Xv          , Xv          , Xv          , Xv          , Xv          , Xv          , Ryd         , Ryd         , Xos         , Xos         , Xos         , Ryd         , Ryd         , Ryd         , Ryd         , Ryd         , Ryd         , Xu          , Yhl^Xp      , Yhl         , Zw          , Zw          , Zw          , Zw          , Zw          , Yhl         , Zw          , Yhl         , Xos         , Yhl         , Yhl         , Xos         , Xos         , Yhl         , Xos         , Xos         , Yhr^Xp      , Yhr         , Yhl         , Yhr         , Yhr         , Yhl         
Xos         , Xos         , Xos         , Xos         , Xos         , Xos         , Xos         , Xos         , Xos         , Xv          , Xv          , Xv          , Xv          , Xv          , Xv          , Xv          , Ryd         , Ryd         , Xos         , Xos         , Xos         , Xos         , Xu          , Xos         , Xos         , Uu^Ii       , Xu          , Uu^Ii       , Xu          , Xu          , Yhl^Xp      , Yhl^Xp      , Zw          , Zw          , Zw          , Ryd         , Ryd         , Yhl         , Zw          , Zw^Uf       , Zw          , Yhl         , Yhl^Xp      , Yhr         , Yhl         , Yhl^Xp      , Xos         , Xos         , Yhr         , Yhr         , Xos         , Yhr         , Yhr         , Yhr         
Xos         , Xos         , Xos         , Xos         , Xos         , Xos         , Xos         , Xos         , Xos         , Xos         , Xos         , Xv          , Xv          , Xv          , Ryd         , Ryd         , Ryd^Zb      , Ryd^Zb      , Ryd         , Xos         , Uu^Uf       , Xu          , Uu^Uf       , Xu          , Xu          , Xu          , Xu          , Xu          , Xu          , Xu          , Uu^Uf       , Yhl         , Zw          , Uu^Ii       , Ryd         , Yhl         , Yhl         , Yhl         , Yhl^Xp      , Zw^Uf       , Yhr         , Yhr         , Yhl         , Yhr         , Yhr         , Xos         , Zw          , Yhr         , Xos         , Yhl^Xp      , Yhl^Xp      , Xos         , Yhl         , Yhl         
Xos         , Xos         , Xos         , Xos         , Xos         , Xos         , Xos         , Xos         , Xos         , Xos         , Xos         , Xos         , Xos         , Ryd         , Xos         , Xos         , Xos         , Ryd         , Ryd         , Ryd         , Ryd         , Uu^Uf       , Uu^Uf       , Yhl^Xp      , Yhl         , Yhl^Xp      , Yhl         , Uu^Ii       , Zw          , Ryd         , Uu^Uf       , Uh          , Zw          , Yhl         , Yhl         , Yhl         , Yhl         , Yhr         , Yhr         , Yhr         , Yhr^Xp      , Xos         , Xos         , Yhl^Xp      , Yhr^Uf      , Zw          , Yhl         , Yhl^Xp      , Yhr         , Xos         , Yhl         , Yhl^Xp      , Yhl         , Yhr         
Xos         , Xos         , Xu          , Xos         , Xos         , Xos         , Xos         , Xos         , Xos         , Xos         , Xos         , Xos         , Xos         , Xos         , Xos         , Xos         , Xos         , Ryd         , Ryd         , Ryd         , Yhl^Xp      , Yhl         , Uu^Uf       , Zw          , Yhl^Xp      , Uh          , Yhl^Xp      , Yhl^Xp      , Zw          , Zw          , Zw          , Uu^Uf       , Yhl^Xp      , Yhl^Xp      , Yhl         , Yhl^Xp      , Yhl^Xp      , Yhl         , Yhl^Xp      , Yhr         , Yhl         , Yhl^Xp      , Yhr         , Yhr         , Zw^Ufi      , Zw          , Zw          , Yhr         , Yhl         , Yhr         , Yhr         , Yhr^Ii      , Yhr         , Yhr         
Xu          , Xu          , Xu          , Xu          , Xu          , Xos         , Xos         , Xos         , Ryd         , Xos         , Xos         , Xos         , Xos         , Xos         , Zw          , Zw          , Zw          , Ryd         , Yhl^Xp      , Yhl         , Yhl         , Uu^Ii       , Zw          , Zw          , Ryd         , Zw          , Ryd         , Ryd         , Yhl^Xp      , Zw          , Yhl         , Uu^Ii       , Zw          , Yhl         , Yhl^Xp      , Uu^Uf       , Uu^Uf       , Yhl         , Yhl         , Uh          , Zw          , Zw          , Yhr         , Yhl^Ufi     , Yhl         , Yhl         , Xos         , Yhr         , Yhr^Uf      , Yhl         , Yhl         , Yhr^Ufi     , Yhl^Uf      , Yhl         
Xu          , Xu          , Zw          , Xu          , Uu^Uf       , Yhl         , Yhl^Xp      , Xos         , Ryd         , Ryd         , Yhl         , Yhl         , Zw          , Zw          , Ryd         , Ryd         , Uu^Uf       , Uu^Uf       , Yhl         , Yhl^Xp      , Zw          , Zw          , Zw          , Ryd         , Zw          , Zw          , Zw          , Zw          , Uu^Ii       , Zw          , Zw          , Zw          , Zw          , Uu^Uf       , Uu^Uf       , Yhl^Xp      , Yhl^Xp      , Yhl         , Yhl         , Yhr^Xp      , Yhr^Ii      , Zw          , Yhr^Uf      , Yhl         , Yhl         , Xos         , Yhl^Xp      , Xos         , Xos         , Yhl         , Yhl         , Yhr^Uf      , Yhl         , Yhl         
Xu          , Uu^Ii       , Uu^Uf       , Zw          , Uu          , Uu          , Ryd         , Yhl         , Ryd         , Yhl         , Uu^Ii       , Yhl         , Yhl^Xp      , Yhl         , Zw          , Yhl         , Uu^Uf       , Uu^Uf       , Uu^Uf       , Yhl^Xp      , Zw          , 1 Uh        , Yhr         , Yhr         , Ryd         , Zw          , Ww          , Zw          , Zw          , Zw          , Zw          , Yhl         , Uu^Uf       , Uu^Uf       , Yhl^Xp      , Ryd         , Ryd         , Yhl         , Yhl         , Yhl         , Yhr^Ii      , Yhr^Xp      , Yhr         , Yhl^Ufi     , Yhl^Uf      , Xos         , Yhl         , Yhl         , Yhl         , Xos         , Xos         , Yhl         , Xos         , Xos         
Xu          , Xu          , Zw          , Uu^Uf       , Ryd         , Ryd         , Ryd         , Ryd         , Zw          , Zw          , Yhl         , Yhl^Xp      , Yhl^Xp      , Zw          , Zw          , Yhl^Xp      , Uu^Ii       , Yhl         , Zw          , Uh          , Zw          , Yhl^Xp      , Ryd         , Ryd         , Ww          , Yhr         , Ww          , Ww          , Zw          , Yhl         , Yhl         , Yhl^Xp      , Zw          , Yhl         , Ryd         , Yhl^Xp      , Yhl^Xp      , Yhl         , Yhl         , Yhr         , Yhl^Xp      , Yhl         , Yhl^Xp      , Yhr^Ufi     , Yhr         , Yhl         , Yhr         , Yhl         , Yhr         , Yhl^Xp      , Xos         , Xos         , Yhr         , Yhl^Xp      
Xu          , Xu          , Xu          , Uu          , Uh          , Yhl         , Uu^Uf       , Yhl         , Yhl^Xp      , Yhl         , Yhl^Xp      , Yhl^Xp      , Yhl         , Yhl         , Ryd         , Yhl         , Yhl^Xp      , Yhl         , Zw          , Zw          , Zw          , Zw          , Ryd         , Ryd         , Ww          , Ww          , Ww          , Zw          , Zw          , Ryd         , Zw          , Zw          , Uu^Ii       , Ryd         , Yhl^Xp      , Uu^Uf       , Uu^Uf       , Yhl         , Xos         , Xos         , Xos         , Yhl         , Yhl         , Yhr         , Zw^Ii       , Zw          , Yhr^Xp      , Yhr^Uf      , Yhr^Uf      , Yhr         , Yhr         , Yhl^Xp      , Yhr         , Yhr         
Xu          , Xu          , Xu          , Zw          , Yhl^Xp      , Yhl^Xp      , Uu          , Uu^Ii       , Uu          , Yhl         , Ryd         , Ryd         , Zw          , Zw          , Ryd         , Ryd         , Yhl         , Zw          , Zw          , Yhl^Xp      , Zw          , Ryd         , Zw          , Ww          , Ww          , Wo          , Ww          , Zw          , Ryd         , Zw          , Zw          , Yhl^Xp      , Yhl^Xp      , Uu^Uf       , Uu^Uf       , Yhl         , Yhl         , Yhl         , Xos         , Xos         , Yhr^Xp      , Yhr         , Yhr^Xp      , Yhr^Ii      , Zw^Ii       , Zw          , Yhl         , Yhl         , Yhl         , Yhr^Uf      , Uh          , Yhr         , Yhl         , Yhl         
Xu          , Xu          , Xu          , Xu          , Yhl         , Uu^Uf       , Uu          , Uu          , Uu          , Uu          , Uh          , Uu^Uf       , Uu^Uf       , Zw          , Yhl^Xp      , Yhl         , Ryd         , Zw          , Zw          , Zw          , Ryd         , Ryd         , Zw          , Zw          , Zw          , Ww          , Zw          , Ryd         , Yhl^Xp      , Zw          , Zw          , Uu^Ii       , Ryd         , Yhl         , Yhl         , Yhl         , Zw          , Yhr         , Yhl         , Xos         , Xos         , Yhr         , Yhr         , Zw^Ii       , Yhr         , Zw          , Xos         , Xos         , Yhl         , Yhr^Uf      , Yhl^Uf      , Zw^Uf       , Zw          , Yhl         
Xu          , Xu          , Xu          , Xu          , Xu          , Uu^Ii       , Uu          , Uu          , Uu          , Uu          , Uu          , Uu          , Uu^Uf       , Uu^Ii       , Yhl         , Yhl         , Ryd         , Zw          , Yhl         , Uu^Ii       , Uu^Uf       , Zw          , Yhl         , Yhl         , Yhl^Xp      , Zw          , Yhl^Xp      , Yhl         , Zw          , Yhl         , Yhl         , Ryd         , Ryd         , Uh          , Yhl         , Zw          , Zw          , Yhl         , Yhr         , Yhr^Xp      , Yhl         , Xos         , Yhr^Xp      , Yhl^Xp      , Yhr         , Yhr         , Xos         , Yhl^Xp      , Xos         , Yhr         , Zw^Uf       , Zw          , Zw^Ii       , Zw          
Xu          , Xu          , Xu          , Xu          , Ryd         , Ryd         , Zw          , Uu          , Zw          , Uu          , Uu          , Uu          , Uu^Uf       , Ryd         , Ryd         , Ryd         , Yhl         , Yhl^Xp      , Cud         , Uu^Uf       , Ryd         , Yhl         , Zw          , Ryd         , Uu^Uf       , Zw          , Yhl         , Zw          , Uu^Uf       , Ryd         , Zw          , Yhl         , Yhl         , Uh          , Yhl         , Zw          , Uu^Ii       , Zw          , Yhl         , Yhl         , Yhl         , Xos         , Yhl         , Yhl         , Yhl         , Yhr         , Xos         , Xos         , Yhr         , Yhr         , Yhl^Xp      , Yhr         , Yhr^Ii      , Yhl^Ii      
Yhl         , Xu          , Yhl         , Xu          , Zw          , Zw          , Yhl         , Ryd         , Yhl         , Yhl         , Zw          , Uu^Uf       , Yhl         , Uu^Uf       , Yhl         , Yhl         , Yhl         , Cud         , 8 Kud       , Cud         , Yhl         , Zw          , Yhl         , Uu^Uf       , Yhl         , Uh          , Yhl         , Yhl         , Uh          , Uu^Uf       , Zw          , Yhl         , Uh          , Uh          , Uh          , Zw          , Zw          , Yhl         , Uh          , Yhl         , Yhl^Xp      , Yhl         , Yhl         , Yhl^Xp      , Yhl         , Xos         , Yhl         , Yhl         , Zw          , Yhl         , Zw          , Yhr^Xp      , Yhr^Ii      , Yhr^Ii      
Yhl         , Yhl^Xp      , Zw^Uf       , Zw^Uf       , Zw          , Uu^Uf       , Uu^Uf       , Yhl         , Yhl^Xp      , Yhl         , Zw          , Yhl         , Yhl^Xp      , Yhl^Xp      , Yhl         , Yhl^Xp      , Cud         , Cud         , Cud         , Cud         , Yhl^Xp      , Uu          , Yhl         , Yhl         , Yhl         , Yhl         , Yhl^Uf      , Zw          , Zw          , Uh          , Uh          , Uh          , Xu          , Xu          , Xu          , Uh          , Uh          , Uh          , Yhl         , Yhl         , Yhl         , Yhl         , Yhl^Uf      , Yhl         , Yhr         , Uu^Ii       , Yhr^Ii      , Zw          , Zw^Uf       , Zw^Uf       , Uh          , Yhr^Ii      , Yhr         , Yhl         
Zw          , Zw          , Zw          , Zw^Uf       , Yhl^Xp      , Uu          , Uu          , Uu^Uf       , Uu^Uf       , Yhl^Xp      , Yhl         , Yhl         , Zw          , Zw          , Zw          , Uu          , Zw          , Yhl         , Ryd         , Yhl         , Yhl         , Yhl         , Uu          , Yhl         , Yhl         , Yhl^Uf      , Zw^Uf       , Zw^Uf       , Zw          , Uu^Uf       , Uh          , Xu          , Xu          , Xu          , Xu          , Xu          , Uh          , Zw          , Zw          , Yhl         , Yhr^Uf      , Yhr^Uf      , Yhl         , Yhr         , Yhl         , Yhr^Ii      , Yhl^Xp      , Zw          , Zw          , Zw^Uf       , Yhr         , Yhl         , Yhl         , Yhl         
Zw          , Zw          , Yhl         , Zw          , Yhl         , Yhl         , Uu^Uf       , Uu^Ii       , Zw          , Yhl         , Yhl         , Yhl         , Uu^Uf       , Uu^Uf       , Uu^Ii       , Uu          , Yhl         , Yhl         , Ryd         , Ryd         , Uu          , Uu^Ii       , Yhl^Xp      , Yhl         , Yhl         , Zw          , Uu^Ii       , Yhl         , Uu^Uf       , Uu^Uf       , Uh          , Xu          , Xu          , 2 Xu        , Xu          , Xu          , Uh          , Zw          , Uu^Ii       , Yhl         , Yhl         , Yhr^Uf      , Yhl         , Yhr^Xp      , Yhl         , Xos         , Xos         , Yhl         , Yhr^Xp      , Yhr^Uf      , Yhr         , Uh          , Uh          , Uh          
Zw          , Yhl         , Yhl^Xp      , Yhl         , Zw          , Zw^Uf       , Uu^Uf       , Uu          , Uh          , Uu          , Yhl         , Yhl^Uf      , Zw          , Uu          , Yhl         , Yhl         , Yhl         , Yhl^Xp      , Yhl^Xp      , Uu          , Uh          , Uu          , Yhl^Xp      , Yhl^Xp      , Yhl         , Zw^Uf       , Zw          , Uu^Uf       , Uu^Uf       , Uu^Uf       , Uh          , Xu          , Xu          , Xu          , Xu          , Xu          , Uh          , Zw          , Zw          , Zw          , Yhl         , Yhl         , Ryd         , Yhr         , Cud         , Xos         , Xos         , Yhl         , Zw          , Zw          , Yhl^Xp      , Uh          , Xu          , Xu          
Yhl         , Yhl         , Yhl         , Zw          , Yhl         , Yhl         , Uu          , Uu^Uf       , Yhl         , Yhl^Xp      , Zw          , Zw          , Yhl^Xp      , Yhl         , Ryd         , Yhl         , Yhl         , Yhl^Xp      , Uu          , Uu          , Yhl         , Yhl         , Yhl         , Yhl         , Yhl         , Yhl^Uf      , Yhl^Uf      , Yhl         , Uh          , Uh          , Yhl^Uf      , Uh          , Uh          , Xu          , Uh          , Uh          , Yhl         , Uh          , Uh          , Zw          , Yhr         , Ryd         , Uu^Uf       , Yhl         , Cud         , 9 Kud       , Cud         , Cud         , Yhr         , Zw          , Xu          , Uh          , Xu          , Xu          
Xu          , Xu          , Xu          , Yhl         , Yhl^Xp      , Ryd         , Ryd         , Yhl         , Uu          , Yhl         , Yhl         , Yhl         , Yhl         , Yhl         , Yhl         , Ryd         , Yhl         , Yhl         , Yhl         , Uu          , Yhl         , Yhl         , Xos         , Yhl         , Yhl         , Yhl         , Yhl         , Yhl         , Yhl         , Yhl^Uf      , Zw^Uf       , Zw          , Uu          , Uh          , Uu          , Zw          , Zw          , Yhl         , Yhl         , Yhl         , Yhr^Xp      , Ryd         , Yhl^Uf      , Uu^Uf       , Yhl         , Cud         , Yhr         , Yhr         , Yhl^Xp      , Yhl         , Xu          , Xu          , Xu          , Xu          
Xu          , Xu          , Xu          , Yhl         , Yhl         , Yhl         , Ryd         , Ryd         , Uu          , Uu          , Yhl         , Yhl         , Xos         , Xos         , Xos         , Yhl         , Yhl         , Yhl         , Yhl         , Yhl^Xp      , Yhl         , Yhl         , Xos         , Yhl^Xp      , Xos         , Yhl         , Yhr         , Yhl         , Zw          , Yhl^Uf      , Uu          , Uu          , Uu          , Uh          , Uu          , Uu^Ii       , Zw          , Yhl         , Ryd         , Yhl         , Uu          , Uu          , Uu^Uf       , Uu^Uf       , Uu^Uf       , Yhr         , Yhl         , Ryd^Ii      , Ryd^Ii      , Yhl^Ii      , Xu          , Xu          , Xu          , Xu          
Xu          , Xu          , Xu          , Xu          , Yhl^Xp      , Yhl         , Yhl         , Yhl^Xp      , Yhl         , Yhl         , Xos         , Xos         , Xos         , Yhl^Xp      , Yhl         , Xos         , Xos         , Yhl         , Yhl         , Yhl         , Yhl         , Yhl         , Xos         , Xos         , Yhl         , Yhl         , Yhr^Xp      , Yhl         , Yhl         , Yhr         , Yhr         , Uu          , Ryd         , Uh          , Yhl         , Yhl         , Ryd         , Ryd         , Yhr         , Uu^Ii       , Yhl         , Uu          , Uh          , Uu^Uf       , Yhl         , Uu^Uf       , Uu          , Uu          , Uu^Ii       , Ryd         , Xu          , Xu          , Xu          , Xu          
Xv          , Xu          , Xu          , Xu          , Xos         , Xos         , Xos         , Yhl         , Xos         , Xos         , Xos         , Yhl^Xp      , Yhl         , Xos         , Xos         , Yhl         , Yhl         , Yhl         , Yhl         , Yhl^Xp      , Yhl         , Yhl         , Xos         , Yhl^Xp      , Yhl         , Yhr         , Uu          , Yhl         , Uu          , Yhl         , Yhr^Uf      , Yhl         , Yhl         , Ryd         , Yhr         , Yhr         , Yhl         , Yhl         , Yhr^Xp      , Ryd         , Cud         , Cud         , Ryd         , Yhl         , Yhl         , Uu^Uf       , Xu          , Uu          , Uu          , Xu          , Xu          , Xu          , Xu          , Xu          
Xv          , Xv          , Xv          , Xu          , Xu          , Xos         , Xos         , Xos         , Xos         , Yhl^Xp      , Yhl         , Xos         , Xos         , Yhl         , Yhl         , Yhl         , Ql          , Ql          , Uu          , Yhl         , Uh          , Yhl         , Yhl         , Xos         , Xos         , Yhl         , Yhl         , Uu^Ii       , Ryd         , Uu^Uf       , Yhl^Uf      , Yhr^Xp      , Yhr         , Yhr         , Ryd         , Yhr         , Uu          , Yhr         , Yhl         , Ryd         , Cud         , Kud         , Cud         , Ryd         , Ryd         , Xu          , Yhl^Xp      , Yhr         , Uh          , Xu          , Xu          , Xu          , Xu          , Xu          
Xv          , Xv          , Xv          , Xv          , Xv          , Xu          , Xu          , Xos         , Xos         , Xos         , Xos         , Yhl         , Yhl         , Yhl         , Ql          , Ql          , Uh          , Yhl         , Uu^Ii       , Yhl         , Yhl         , Yhl         , Uu          , Yhl         , Xos         , Yhl         , Xos         , Uu          , Yhl         , Ryd         , Ryd         , Yhr^Uf      , Yhr         , Yhl         , Yhl         , Yhr^Ii      , Uu^Ii       , Uu          , Ryd         , Cud         , Ryd         , Ryd         , Yhr         , Yhl         , Yhr         , Ryd         , Ryd         , Yhr         , Uh          , Xu          , Xu          , Xu          , Xu          , Xu          
Xv          , Xv          , Xv          , Xv          , Xv          , Xv          , Xv          , Xu          , Xu          , Xu          , Ql          , Yhl         , Ql          , Ql          , Uu          , Uu          , Uu          , Uu          , Yhl         , Uu          , Ryd         , Yhl         , Uu          , Yhl         , Xos         , Yhl^Xp      , Xos         , Yhr         , Yhr         , Yhl         , Ryd         , Uh          , Yhl^Xp      , Yhl         , Ryd^Ii      , Yhl^Ii      , Yhl         , Uu          , Ryd         , Yhl         , Yhl         , Yhr         , Uu          , Uh          , Yhl         , Yhl         , Ryd^Ii      , Yhl         , Uu          , Xu          , Xu          , Xu          , Xu          , Xu          
Xv          , Xv          , Xv          , Xv          , Xv          , Xv          , Xv          , Xu          , Ql          , Ql^Zb       , Ql^Zb       , Ql          , Xu          , Uu          , Xos         , Xos         , Xos         , Yhl         , Yhl         , Uh          , Uu          , Ryd         , Ryd         , Uu          , Yhl         , Xos         , Yhr         , Yhr         , Yhl         , Ryd         , Yhr         , Yhl         , Yhr         , Ryd^Ii      , Yhr^Ii      , Ryd         , Ryd         , Ryd         , Ryd         , Yhl         , Yhr         , Yhr^Xp      , Yhr         , Uu          , Uu^Ii       , Uu^Ii       , Xu          , Uh          , Xu          , Xu          , Xu          , Xu          , Xu          , Xu          
Xv          , Xv          , Xv          , Xv          , Xv          , Xv          , Xv          , Xv          , Xv          , Ql          , Xu          , Xu          , Xu          , Xos         , Xos         , Xos         , Xos         , Xos         , Yhl         , Yhl         , Uu          , Uu          , Uu          , Uu          , Yhr         , Yhl^Xp      , Uu          , Uu^Ii       , Ryd         , Ryd         , Yhl         , Yhr         , Yhl         , Yhr^Ii      , Yhl         , Yhl         , Uu          , Yhr         , Uu^Ii       , Uu          , Yhl         , Ryd         , Ryd         , Ryd         , Yhr         , Uu^Ii       , Xu          , Xu          , Xu          , Xu          , Xu          , Xu          , Xu          , Xu          
Xv          , Xv          , Xv          , Xv          , Xv          , Xv          , Xv          , Xv          , Xv          , Xv          , Xv          , Xv          , Xv          , Xu          , Xu          , Xos         , Xos         , Xos         , Yhl         , Yhl         , Yhl         , Uu          , Uu          , Uu          , Uu          , Uu          , Yhl         , Ryd         , Ryd         , Ryd         , Ryd         , Ryd         , Ryd         , Ryd         , Ryd         , Ryd         , Ryd         , Uu          , Ryd^Ii      , Ryd^Ii      , Ryd         , Ryd         , Yhl         , Ryd         , Yhl         , Yhr         , Yhr         , Xu          , Yhl         , Xu          , Xu          , Xu          , Xu          , Xu          
