border_size=1
usage=map

Xv          , Xv          , Xv          , Xv          , Xv          , Xv          , Xv          , Xv          , Xv          , Xv          , Xv          , Xv          , Xv          , Xv          , Xv          , Xv          , Xv          , Xv          , Xv          , Xv          , Xv          , Xv          , Xv          , Xv          , Xv          , Xv          , Xu          , Xu          , Uu^Ii       , Xu          , Xos         , Xos         , Xos         , Xos         , Yhl         , Xos         , Xos         , Xos         , Xos         , Xos         , Xos         , Xos         , Xos         , Xos         , Xos         , Xos         , Yhr         , Yhr         , Yhr^Xp      , Yhr         , Xos         , Xos         , Xos         , Yhr         
Xos         , Xv          , Xv          , Xv          , Xv          , Xv          , Xv          , Xv          , Xv          , Xv          , Xv          , Xv          , Xv          , Xv          , Xv          , Xv          , Xv          , Xv          , Xv          , Xv          , Xv          , Xv          , Xv          , Xv          , Xu          , Xu          , Xu          , Xu          , Zw          , Xu          , Xos         , Xos         , Yhl^Xp      , Yhl^Xp      , Xos         , Xos         , Xos         , Xos         , Xos         , Xos         , Xos         , Xos         , Xos         , Xos         , Yhr^Uf      , Yhr^Xp      , Yhr         , Yhr^Xp      , Xos         , Xos         , Xos         , Xos         , Yhr         , Yhr         
Xos         , Xos         , Xos         , Xv          , Xv          , Xv          , Xv          , Xv          , Xv          , Xv          , Xv          , Xv          , Xv          , Xv          , Xv          , Xv          , Xv          , Xv          , Xv          , Xv          , Xv          , Xv          , Urb         , Xu          , Xu          , Xu          , Uu^Ii       , Xu          , Urb         , Xu          , Yhl^Xp      , Urb         , Yhl         , Xos         , Xos         , Yhl         , Yhl         , Xos         , Xos         , Xos         , Xos         , Xos         , Yhr         , Yhr         , Yhl         , Yhr         , Xos         , Xos         , Yhl         , Yhr^Xp      , Yhr         , Yhr         , Yhr         , Yhr         
Xos         , Xos         , Xos         , Xos         , Xos         , Xv          , Xv          , Xv          , Xv          , Xv          , Xv          , Xv          , Xv          , Xv          , Xv          , Xv          , Xv          , Xv          , Xv          , Xv          , Urb         , Urb         , Urb         , Urb         , Uu^Ii       , Urb         , Urb         , Urb         , Uu^Ii       , Xu          , Yhl         , Urb         , Uu^Ii       , Yhl^Xp      , Yhl         , Zw          , Zw^Uf       , Yhl^Uf      , Yhl^Xp      , Xos         , Yhl         , Yhl         , Xos         , Xos         , Yhl^Xp      , Xos         , Yhl         , Yhl         , Xos         , Yhr         , Uh          , Yhr         , Xos         , Xos         
Xos         , Xos         , Xos         , Xos         , Xos         , Xos         , Xos         , Xv          , Xv          , Xv          , Xv          , Xv          , Xv          , Xv          , Xv          , Xv          , Xv          , Xv          , Urb         , Urb         , Xos         , Xos         , Xos         , Urb         , Urb         , Urb         , Urb         , Urb         , Urb         , Xu          , Yhl^Xp      , Yhl         , Zw          , Zw          , Zw          , Zw          , Zw          , Yhl         , Zw          , Yhl         , Xos         , Yhl         , Yhl         , Xos         , Xos         , Yhl         , Xos         , Xos         , Yhr^Xp      , Yhr         , Yhl         , Yhr         , Yhr         , Yhl         
Xos         , Xos         , Xos         , Xos         , Xos         , Xos         , Xos         , Xos         , Xos         , Xv          , Xv          , Xv          , Xv          , Xv          , Xv          , Xv          , Urb         , Urb         , Xos         , Xos         , Xos         , Xos         , Xu          , Xos         , Xos         , Uu^Ii       , Xu          , Uu^Ii       , Xu          , Xu          , Yhl^Xp      , Yhl^Xp      , Zw          , Zw          , Zw          , Urb         , Urb         , Yhl         , Zw          , Zw^Uf       , Zw          , Yhl         , Yhl^Xp      , Yhr         , Yhl         , Yhl^Xp      , Xos         , Xos         , Yhr         , Yhr         , Xos         , Yhr         , Yhr         , Yhr         
Xos         , Xos         , Xos         , Xos         , Xos         , Xos         , Xos         , Xos         , Xos         , Xos         , Xos         , Xv          , Xv          , Xv          , Urb         , Urb         , Urb^Xo      , Urb^Xo      , Urb         , Xos         , Uu^Uf       , Xu          , Uu^Uf       , Xu          , Xu          , Xu          , Xu          , Xu          , Xu          , Xu          , Uu^Uf       , Yhl         , Zw          , Uu^Ii       , Urb         , Yhl         , Yhl         , Yhl         , Yhl^Xp      , Zw^Uf       , Yhr         , Yhr         , Yhl         , Yhr         , Yhr         , Xos         , Zw          , Yhr         , Xos         , Yhl^Xp      , Yhl^Xp      , Xos         , Yhl         , Yhl
Xos         , Xos         , Xos         , Xos         , Xos         , Xos         , Xos         , Xos         , Xos         , Xos         , Xos         , Xos         , Xos         , Urb         , Xos         , Xos         , Xos         , Urb         , Urb         , Urb         , Urb         , Uu^Uf       , Uu^Uf       , Yhl^Xp      , Yhl         , Yhl^Xp      , Yhl         , Uu^Ii       , Zw          , Urb         , Uu^Uf       , Uh          , Zw          , Yhl         , Yhl         , Yhl         , Yhl         , Yhr         , Yhr         , Yhr         , Yhr^Xp      , Xos         , Xos         , Yhl^Xp      , Yhr^Uf      , Zw          , Yhl         , Yhl^Xp      , Yhr         , Xos         , Yhl         , Yhl^Xp      , Yhl         , Yhr         
Xos         , Xos         , Xu          , Xos         , Xos         , Xos         , Xos         , Xos         , Xos         , Xos         , Xos         , Xos         , Xos         , Xos         , Xos         , Xos         , Xos         , Urb         , Urb         , Urb         , Yhl^Xp      , Yhl         , Uu^Uf       , Zw          , Yhl^Xp      , Uh          , Yhl^Xp      , Yhl^Xp      , Zw          , Zw          , Zw          , Uu^Uf       , Yhl^Xp      , Yhl^Xp      , Yhl         , Yhl^Xp      , Yhl^Xp      , Yhl         , Yhl^Xp      , Yhr         , Yhl         , Yhl^Xp      , Yhr         , Yhr         , Zw^Ufi      , Zw          , Zw          , Yhr         , Yhl         , Yhr         , Yhr         , Yhr^Ii      , Yhr         , Yhr         
Xu          , Xu          , Xu          , Xu          , Xu          , Xos         , Xos         , Xos         , Urb         , Xos         , Xos         , Xos         , Xos         , Xos         , Zw          , Zw          , Zw          , Urb         , Yhl^Xp      , Yhl         , Yhl         , Uu^Ii       , Zw          , Zw          , Urb         , Zw          , Urb         , Urb         , Yhl^Xp      , Zw          , Yhl         , Uu^Ii       , Zw          , Yhl         , Yhl^Xp      , Uu^Uf       , Uu^Uf       , Yhl         , Yhl         , Uh          , Zw          , Zw          , Yhr         , Yhl^Ufi     , Yhl         , Yhl         , Xos         , Yhr         , Yhr^Uf      , Yhl         , Yhl         , Yhr^Ufi     , Yhl^Uf      , Yhl         
Xu          , Xu          , Zw          , Xu          , Uu^Uf       , Yhl         , Yhl^Xp      , Xos         , Urb         , Urb         , Yhl         , Yhl         , Zw          , Zw          , Urb         , Urb         , Uu^Uf       , Uu^Uf       , Yhl         , Yhl^Xp      , Zw          , Zw          , Zw          , Urb         , Zw          , Zw          , Zw          , Zw          , Uu^Ii       , Zw          , Zw          , Zw          , Zw          , Uu^Uf       , Uu^Uf       , Yhl^Xp      , Yhl^Xp      , Yhl         , Yhl         , Yhr^Xp      , Yhr^Ii      , Zw          , Yhr^Uf      , Yhl         , Yhl         , Xos         , Yhl^Xp      , Xos         , Xos         , Yhl         , Yhl         , Yhr^Uf      , Yhl         , Yhl         
Xu          , Uu^Ii       , Uu^Uf       , Zw          , Uu          , Uu          , Urb         , Yhl         , Urb         , Yhl         , Uu^Ii       , Yhl         , Yhl^Xp      , Yhl         , Zw          , Yhl         , Uu^Uf       , Uu^Uf       , Uu^Uf       , Yhl^Xp      , Zw          , 1 Uh        , Yhr         , Yhr         , Urb         , Zw          , Ww          , Zw          , Zw          , Zw          , Zw          , Yhl         , Uu^Uf       , Uu^Uf       , Yhl^Xp      , Urb         , Urb         , Yhl         , Yhl         , Yhl         , Yhr^Ii      , Yhr^Xp      , Yhr         , Yhl^Ufi     , Yhl^Uf      , Xos         , Yhl         , Yhl         , Yhl         , Xos         , Xos         , Yhl         , Xos         , Xos         
Xu          , Xu          , Zw          , Uu^Uf       , Urb         , Urb         , Urb         , Urb         , Zw          , Zw          , Yhl         , Yhl^Xp      , Yhl^Xp      , Zw          , Zw          , Yhl^Xp      , Uu^Ii       , Yhl         , Zw          , Uh          , Zw          , Yhl^Xp      , Urb         , Urb         , Ww          , Yhr         , Ww          , Ww          , Zw          , Yhl         , Yhl         , Yhl^Xp      , Zw          , Yhl         , Urb         , Yhl^Xp      , Yhl^Xp      , Yhl         , Yhl         , Yhr         , Yhl^Xp      , Yhl         , Yhl^Xp      , Yhr^Ufi     , Yhr         , Yhl         , Yhr         , Yhl         , Yhr         , Yhl^Xp      , Xos         , Xos         , Yhr         , Yhl^Xp      
Xu          , Xu          , Xu          , Uu          , Uh          , Yhl         , Uu^Uf       , Yhl         , Yhl^Xp      , Yhl         , Yhl^Xp      , Yhl^Xp      , Yhl         , Yhl         , Urb         , Yhl         , Yhl^Xp      , Yhl         , Zw          , Zw          , Zw          , Zw          , Urb         , Urb         , Ww          , Ww          , Ww          , Zw          , Zw          , Urb         , Zw          , Zw          , Uu^Ii       , Urb         , Yhl^Xp      , Uu^Uf       , Uu^Uf       , Yhl         , Xos         , Xos         , Xos         , Yhl         , Yhl         , Yhr         , Zw^Ii       , Zw          , Yhr^Xp      , Yhr^Uf      , Yhr^Uf      , Yhr         , Yhr         , Yhl^Xp      , Yhr         , Yhr         
Xu          , Xu          , Xu          , Zw          , Yhl^Xp      , Yhl^Xp      , Uu          , Uu^Ii       , Uu          , Yhl         , Urb         , Urb         , Zw          , Zw          , Urb         , Urb         , Yhl         , Zw          , Zw          , Yhl^Xp      , Zw          , Urb         , Zw          , Ww          , Ww          , Wo          , Ww          , Zw          , Urb         , Zw          , Zw          , Yhl^Xp      , Yhl^Xp      , Uu^Uf       , Uu^Uf       , Yhl         , Yhl         , Yhl         , Xos         , Xos         , Yhr^Xp      , Yhr         , Yhr^Xp      , Yhr^Ii      , Zw^Ii       , Zw          , Yhl         , Yhl         , Yhl         , Yhr^Uf      , Uh          , Yhr         , Yhl         , Yhl         
Xu          , Xu          , Xu          , Xu          , Yhl         , Uu^Uf       , Uu          , Uu          , Uu          , Uu          , Uh          , Uu^Uf       , Uu^Uf       , Zw          , Yhl^Xp      , Yhl         , Urb         , Zw          , Zw          , Zw          , Urb         , Urb         , Zw          , Zw          , Zw          , Ww          , Zw          , Urb         , Yhl^Xp      , Zw          , Zw          , Uu^Ii       , Urb         , Yhl         , Yhl         , Yhl         , Zw          , Yhr         , Yhl         , Xos         , Xos         , Yhr         , Yhr         , Zw^Ii       , Yhr         , Zw          , Xos         , Xos         , Yhl         , Yhr^Uf      , Yhl^Uf      , Zw^Uf       , Zw          , Yhl         
Xu          , Xu          , Xu          , Xu          , Xu          , Uu^Ii       , Uu          , Uu          , Uu          , Uu          , Uu          , Uu          , Uu^Uf       , Uu^Ii       , Yhl         , Yhl         , Urb         , Zw          , Yhl         , Uu^Ii       , Uu^Uf       , Zw          , Yhl         , Yhl         , Yhl^Xp      , Zw          , Yhl^Xp      , Yhl         , Zw          , Yhl         , Yhl         , Urb         , Urb         , Uh          , Yhl         , Zw          , Zw          , Yhl         , Yhr         , Yhr^Xp      , Yhl         , Xos         , Yhr^Xp      , Yhl^Xp      , Yhr         , Yhr         , Xos         , Yhl^Xp      , Xos         , Yhr         , Zw^Uf       , Zw          , Zw^Ii       , Zw          
Xu          , Xu          , Xu          , Xu          , Urb         , Urb         , Zw          , Uu          , Zw          , Uu          , Uu          , Uu          , Uu^Uf       , Urb         , Urb         , Urb         , Yhl         , Yhl^Xp      , Cud         , Uu^Uf       , Urb         , Yhl         , Zw          , Urb         , Uu^Uf       , Zw          , Yhl         , Zw          , Uu^Uf       , Urb         , Zw          , Yhl         , Yhl         , Uh          , Yhl         , Zw          , Uu^Ii       , Zw          , Yhl         , Yhl         , Yhl         , Xos         , Yhl         , Yhl         , Yhl         , Yhr         , Xos         , Xos         , Yhr         , Yhr         , Yhl^Xp      , Yhr         , Yhr^Ii      , Yhl^Ii      
Yhl         , Xu          , Yhl         , Xu          , Zw          , Zw          , Yhl         , Urb         , Yhl         , Yhl         , Zw          , Uu^Uf       , Yhl         , Uu^Uf       , Yhl         , Yhl         , Yhl         , Cud         , 8 Kud       , Cud         , Yhl         , Zw          , Yhl         , Uu^Uf       , Yhl         , Uh          , Yhl         , Yhl         , Uh          , Uu^Uf       , Zw          , Yhl         , Uh          , Uh          , Uh          , Zw          , Zw          , Yhl         , Uh          , Yhl         , Yhl^Xp      , Yhl         , Yhl         , Yhl^Xp      , Yhl         , Xos         , Yhl         , Yhl         , Zw          , Yhl         , Zw          , Yhr^Xp      , Yhr^Ii      , Yhr^Ii      
Yhl         , Yhl^Xp      , Zw^Uf       , Zw^Uf       , Zw          , Uu^Uf       , Uu^Uf       , Yhl         , Yhl^Xp      , Yhl         , Zw          , Yhl         , Yhl^Xp      , Yhl^Xp      , Yhl         , Yhl^Xp      , Cud         , Cud         , Cud         , Cud         , Yhl^Xp      , Uu          , Yhl         , Yhl         , Yhl         , Yhl         , Yhl^Uf      , Zw          , Zw          , Uh          , Uh          , Uh          , Xu          , Xu          , Xu          , Uh          , Uh          , Uh          , Yhl         , Yhl         , Yhl         , Yhl         , Yhl^Uf      , Yhl         , Yhr         , Uu^Ii       , Yhr^Ii      , Zw          , Zw^Uf       , Zw^Uf       , Uh          , Yhr^Ii      , Yhr         , Yhl         
Zw          , Zw          , Zw          , Zw^Uf       , Yhl^Xp      , Uu          , Uu          , Uu^Uf       , Uu^Uf       , Yhl^Xp      , Yhl         , Yhl         , Zw          , Zw          , Zw          , Uu          , Zw          , Yhl         , Urb         , Yhl         , Yhl         , Yhl         , Uu          , Yhl         , Yhl         , Yhl^Uf      , Zw^Uf       , Zw^Uf       , Zw          , Uu^Uf       , Uh          , Xu          , Xu          , Xu          , Xu          , Xu          , Uh          , Zw          , Zw          , Yhl         , Yhr^Uf      , Yhr^Uf      , Yhl         , Yhr         , Yhl         , Yhr^Ii      , Yhl^Xp      , Zw          , Zw          , Zw^Uf       , Yhr         , Yhl         , Yhl         , Yhl         
Zw          , Zw          , Yhl         , Zw          , Yhl         , Yhl         , Uu^Uf       , Uu^Ii       , Zw          , Yhl         , Yhl         , Yhl         , Uu^Uf       , Uu^Uf       , Uu^Ii       , Uu          , Yhl         , Yhl         , Urb         , Urb         , Uu          , Uu^Ii       , Yhl^Xp      , Yhl         , Yhl         , Zw          , Uu^Ii       , Yhl         , Uu^Uf       , Uu^Uf       , Uh          , Xu          , Xu          , 2 Xu        , Xu          , Xu          , Uh          , Zw          , Uu^Ii       , Yhl         , Yhl         , Yhr^Uf      , Yhl         , Yhr^Xp      , Yhl         , Xos         , Xos         , Yhl         , Yhr^Xp      , Yhr^Uf      , Yhr         , Uh          , Uh          , Uh          
Zw          , Yhl         , Yhl^Xp      , Yhl         , Zw          , Zw^Uf       , Uu^Uf       , Uu          , Uh          , Uu          , Yhl         , Yhl^Uf      , Zw          , Uu          , Yhl         , Yhl         , Yhl         , Yhl^Xp      , Yhl^Xp      , Uu          , Uh          , Uu          , Yhl^Xp      , Yhl^Xp      , Yhl         , Zw^Uf       , Zw          , Uu^Uf       , Uu^Uf       , Uu^Uf       , Uh          , Xu          , Xu          , Xu          , Xu          , Xu          , Uh          , Zw          , Zw          , Zw          , Yhl         , Yhl         , Urb         , Yhr         , Cud         , Xos         , Xos         , Yhl         , Zw          , Zw          , Yhl^Xp      , Uh          , Xu          , Xu          
Yhl         , Yhl         , Yhl         , Zw          , Yhl         , Yhl         , Uu          , Uu^Uf       , Yhl         , Yhl^Xp      , Zw          , Zw          , Yhl^Xp      , Yhl         , Urb         , Yhl         , Yhl         , Yhl^Xp      , Uu          , Uu          , Yhl         , Yhl         , Yhl         , Yhl         , Yhl         , Yhl^Uf      , Yhl^Uf      , Yhl         , Uh          , Uh          , Yhl^Uf      , Uh          , Uh          , Xu          , Uh          , Uh          , Yhl         , Uh          , Uh          , Zw          , Yhr         , Urb         , Uu^Uf       , Yhl         , Cud         , 9 Kud       , Cud         , Cud         , Yhr         , Zw          , Xu          , Uh          , Xu          , Xu          
Xu          , Xu          , Xu          , Yhl         , Yhl^Xp      , Urb         , Urb         , Yhl         , Uu          , Yhl         , Yhl         , Yhl         , Yhl         , Yhl         , Yhl         , Urb         , Yhl         , Yhl         , Yhl         , Uu          , Yhl         , Yhl         , Xos         , Yhl         , Yhl         , Yhl         , Yhl         , Yhl         , Yhl         , Yhl^Uf      , Zw^Uf       , Zw          , Uu          , Uh          , Uu          , Zw          , Zw          , Yhl         , Yhl         , Yhl         , Yhr^Xp      , Urb         , Yhl^Uf      , Uu^Uf       , Yhl         , Cud         , Yhr         , Yhr         , Yhl^Xp      , Yhl         , Xu          , Xu          , Xu          , Xu          
Xu          , Xu          , Xu          , Yhl         , Yhl         , Yhl         , Urb         , Urb         , Uu          , Uu          , Yhl         , Yhl         , Xos         , Xos         , Xos         , Yhl         , Yhl         , Yhl         , Yhl         , Yhl^Xp      , Yhl         , Yhl         , Xos         , Yhl^Xp      , Xos         , Yhl         , Yhr         , Yhl         , Zw          , Yhl^Uf      , Uu          , Uu          , Uu          , Uh          , Uu          , Uu^Ii       , Zw          , Yhl         , Urb         , Yhl         , Uu          , Uu          , Uu^Uf       , Uu^Uf       , Uu^Uf       , Yhr         , Yhl         , Urb^Ii      , Urb^Ii      , Yhl^Ii      , Xu          , Xu          , Xu          , Xu          
Xu          , Xu          , Xu          , Xu          , Yhl^Xp      , Yhl         , Yhl         , Yhl^Xp      , Yhl         , Yhl         , Xos         , Xos         , Xos         , Yhl^Xp      , Yhl         , Xos         , Xos         , Yhl         , Yhl         , Yhl         , Yhl         , Yhl         , Xos         , Xos         , Yhl         , Yhl         , Yhr^Xp      , Yhl         , Yhl         , Yhr         , Yhr         , Uu          , Urb         , Uh          , Yhl         , Yhl         , Urb         , Urb         , Yhr         , Uu^Ii       , Yhl         , Uu          , Uh          , Uu^Uf       , Yhl         , Uu^Uf       , Uu          , Uu          , Uu^Ii       , Urb         , Xu          , Xu          , Xu          , Xu          
Xv          , Xu          , Xu          , Xu          , Xos         , Xos         , Xos         , Yhl         , Xos         , Xos         , Xos         , Yhl^Xp      , Yhl         , Xos         , Xos         , Yhl         , Yhl         , Yhl         , Yhl         , Yhl^Xp      , Yhl         , Yhl         , Xos         , Yhl^Xp      , Yhl         , Yhr         , Uu          , Yhl         , Uu          , Yhl         , Yhr^Uf      , Yhl         , Yhl         , Urb         , Yhr         , Yhr         , Yhl         , Yhl         , Yhr^Xp      , Urb         , Cud         , Cud         , Urb         , Yhl         , Yhl         , Uu^Uf       , Xu          , Uu          , Uu          , Xu          , Xu          , Xu          , Xu          , Xu          
Xv          , Xv          , Xv          , Xu          , Xu          , Xos         , Xos         , Xos         , Xos         , Yhl^Xp      , Yhl         , Xos         , Xos         , Yhl         , Yhl         , Yhl         , Ql          , Ql          , Uu          , Yhl         , Uh          , Yhl         , Yhl         , Xos         , Xos         , Yhl         , Yhl         , Uu^Ii       , Urb         , Uu^Uf       , Yhl^Uf      , Yhr^Xp      , Yhr         , Yhr         , Urb         , Yhr         , Uu          , Yhr         , Yhl         , Urb         , Cud         , Kud         , Cud         , Urb         , Urb         , Xu          , Yhl^Xp      , Yhr         , Uh          , Xu          , Xu          , Xu          , Xu          , Xu          
Xv          , Xv          , Xv          , Xv          , Xv          , Xu          , Xu          , Xos         , Xos         , Xos         , Xos         , Yhl         , Yhl         , Yhl         , Ql          , Ql          , Uh          , Yhl         , Uu^Ii       , Yhl         , Yhl         , Yhl         , Uu          , Yhl         , Xos         , Yhl         , Xos         , Uu          , Yhl         , Urb         , Urb         , Yhr^Uf      , Yhr         , Yhl         , Yhl         , Yhr^Ii      , Uu^Ii       , Uu          , Urb         , Cud         , Urb         , Urb         , Yhr         , Yhl         , Yhr         , Urb         , Urb         , Yhr         , Uh          , Xu          , Xu          , Xu          , Xu          , Xu          
Xv          , Xv          , Xv          , Xv          , Xv          , Xv          , Xv          , Xu          , Xu          , Xu          , Ql          , Yhl         , Ql          , Ql          , Uu          , Uu          , Uu          , Uu          , Yhl         , Uu          , Urb         , Yhl         , Uu          , Yhl         , Xos         , Yhl^Xp      , Xos         , Yhr         , Yhr         , Yhl         , Urb         , Uh          , Yhl^Xp      , Yhl         , Urb^Ii      , Yhl^Ii      , Yhl         , Uu          , Urb         , Yhl         , Yhl         , Yhr         , Uu          , Uh          , Yhl         , Yhl         , Urb^Ii      , Yhl         , Uu          , Xu          , Xu          , Xu          , Xu          , Xu          
Xv          , Xv          , Xv          , Xv          , Xv          , Xv          , Xv          , Xu          , Ql          , Ql^Xo       , Ql^Xo       , Ql          , Xu          , Uu          , Xos         , Xos         , Xos         , Yhl         , Yhl         , Uh          , Uu          , Urb         , Urb         , Uu          , Yhl         , Xos         , Yhr         , Yhr         , Yhl         , Urb         , Yhr         , Yhl         , Yhr         , Urb^Ii      , Yhr^Ii      , Urb         , Urb         , Urb         , Urb         , Yhl         , Yhr         , Yhr^Xp      , Yhr         , Uu          , Uu^Ii       , Uu^Ii       , Xu          , Uh          , Xu          , Xu          , Xu          , Xu          , Xu          , Xu
Xv          , Xv          , Xv          , Xv          , Xv          , Xv          , Xv          , Xv          , Xv          , Ql          , Xu          , Xu          , Xu          , Xos         , Xos         , Xos         , Xos         , Xos         , Yhl         , Yhl         , Uu          , Uu          , Uu          , Uu          , Yhr         , Yhl^Xp      , Uu          , Uu^Ii       , Urb         , Urb         , Yhl         , Yhr         , Yhl         , Yhr^Ii      , Yhl         , Yhl         , Uu          , Yhr         , Uu^Ii       , Uu          , Yhl         , Urb         , Urb         , Urb         , Yhr         , Uu^Ii       , Xu          , Xu          , Xu          , Xu          , Xu          , Xu          , Xu          , Xu          
Xv          , Xv          , Xv          , Xv          , Xv          , Xv          , Xv          , Xv          , Xv          , Xv          , Xv          , Xv          , Xv          , Xu          , Xu          , Xos         , Xos         , Xos         , Yhl         , Yhl         , Yhl         , Uu          , Uu          , Uu          , Uu          , Uu          , Yhl         , Urb         , Urb         , Urb         , Urb         , Urb         , Urb         , Urb         , Urb         , Urb         , Urb         , Uu          , Urb^Ii      , Urb^Ii      , Urb         , Urb         , Yhl         , Urb         , Yhl         , Yhr         , Yhr         , Xu          , Yhl         , Xu          , Xu          , Xu          , Xu          , Xu          
