border_size=1
usage=map

Mm^Xm, Mm^Xm, Mm^Xm, Mm^Xm, Mm^Xm, Mm^Xm, Mm^Xm, Mm^Xm, Mm, Mm, Mm, Mm, Mm, Mm, Mm, Mm, Mm, Mm, Mm, Mm, Mm, Mm, Hh, Hh, Hh, Gg, Gg^Efm, Gg, Rp, Hh, Hh, Mm, Mm, Mm, Mm, Mm, Mm, Mm, Mm, Mm, Mm, Mm
Mm^Xm, Mm^Xm, Mm^Xm, Mm, Mm, Mm, Mm, Mm, Mm, Mm, Hh, Hh^Fp, Gs^Fms, Mm, Mm, Mm, Mm, Mm, Mm, Mm, Mm, Mm, Mm, Hh, Hh^Fds, Gll^Fp, Gg, Gs^Fds, Rp, Hh, Gg^Ve, Mm, Hh, Mm, Mm, Mm, Mm^Xm, Mm^Xm, Mm, Mm, Mm^Xm, Mm^Xm
Mm^Xm, Mm^Xm, Mm^Xm, Mm^Xm, Mm^Xm, Mm, Mm, Mm, Mm, Mm, Hh^Fp, Hh^Fp, Cv, Gs^Fms, Gs^Fms, Gs^Fp, Hh, Hh, Mm, Mm, Mm, Hh, Gs^Fp, Hh, Gg^Ve, Gll^Fp, Gll^Fp, Gg^Efm, Rp, Hh, Hh, Mm, Hh, Hh, Hh, Mm, Mm, Mm^Xm, Mm, Mm, Mm^Xm, Mm^Xm
Mm^Xm, Mm^Xm, Mm, Mm, Mm, Mm, Mm^Xm, Mm^Xm, Mm, Mm, Mm, Hh, Hh, Gs^Fms, Hh^Fp, Gg^Fet, Hh, Hh, Mm, Cv, Cv, Hh, Hh, Hh^Fds, Gs^Fp, Gll^Fp, Gg^Efm, Cv, Re, Gs^Fds, Hh, Mm, Hh^Fds, Hh^Fds, Hh, Gll^Fp, Mm, Mm, Mm^Xm, Mm^Xm, Mm^Xm, Mm^Xm
Mm^Xm, Mm, Mm, Mm, Mm^Xm, Mm^Xm, Mm^Xm, Mm, Mm, Mm^Xm, Mm, Mm, Mm, Hh, Gs^Fms, Hh^Fp, Mm, Mm, Mm, Cv, Hh, Gg^Fet, Gs^Fds, Hh^Fp, Gll^Fp, Gs^Fds, Rp, Re, Hh, Gs^Fp, Cv, Hh, Hh^Fp, Gs^Fms, Gs^Fms, Gll^Fp, Hh, Mm, Mm^Xm, Mm^Xm, Mm^Xm, Mm^Xm
Mm^Xm, Mm^Xm, Mm, Mm^Xm, Mm^Xm, Mm^Xm, Mm^Xm, Mm^Xm, Mm, Mm, Mm, Mm, Mm, Mm, Mm, Mm, Mm, Mm, Mm, Mm, Hh, Gs^Fp, Gg^Ve, Gs^Fds, Gll^Fp, Gll^Fp, Hh, Gs^Fp, Hh, Cv, Gll^Fp, Gg^Ve, Gs^Fds, Gll^Fp, Gs^Fms, Hh, Hh, Mm, Mm, Mm, Mm^Xm, Mm^Xm
Mm^Xm, Mm, Mm, Mm^Xm, Mm^Xm, Mm^Xm, Mm^Xm, Mm^Xm, Mm, Mm^Xm, Mm^Xm, Mm, Mm^Xm, Mm^Xm, Mm^Xm, Mm, Mm, Mm, Mm, Mm, Mm, Hh, Gg^Efm, Gg^Efm, Gll^Fp, Gll^Fp, Gll^Fp, Hh^Fp, Gs^Fp, Gll^Fp, Gll^Fp, Gs^Fp, Hh, Gll^Fp, Gll^Fp, Hh^Fds, Mm, Mm, Mm^Xm, Mm, Mm^Xm, Mm^Xm
Mm^Xm, Mm, Mm, Mm, Mm, Mm, Mm, Mm, Mm, Mm^Xm, Mm^Xm, Mm^Xm, Mm^Xm, Mm^Xm, Hhd, Hhd, Hhd, Mm, Mm, Mm, Mm, Cv, Hh^Fp, Gll^Fp, Gll^Fp, Rp, Gll^Fp, Hh^Fp, Gll^Fp, Gll^Fp, Gll^Fp, Gll^Fp, Gll^Fp, Gll^Fp, Mm, Mm, Mm^Xm, Mm^Xm, Mm, Mm, Mm^Xm, Mm^Xm
Mm^Xm, Mm, Mm^Xm, Mm^Xm, Mm^Xm, Mm^Xm, Mm^Xm, Mm^Xm, Mm, Mm, Mm, Mm, Mm, Mm^Xm, Mm, Hhd, Hhd, Mm, Mm, Mm, Hh, Gll^Fp, Gll^Fp, Gs^Fms, Rp, Rp, Gs^Fms, Hh, Gll^Fp, Gll^Fp, Mm, Gs^Fds, Gll^Fp, Gll^Fp, Gs^Fp, Mm, Mm, Mm, Mm, Mm^Xm, Mm^Xm, Mm^Xm
Mm^Xm, Mm^Xm, Mm^Xm, Mm, Mm^Xm, Mm^Xm, Mm, Mm, Mm, Mm, Cv, Mm, Mm, Mm, Mm, Mm, Hhd, Mm, Hh, Hh, Rp, Gll^Fp, Gll^Fp, Gs^Fds, Gs^Fms, Hh, Gs^Ft, Hh, Mm, Gll^Fp, Mm, Mm, Mm, Mm, Gs^Fms, Hh^Fds, Hh, Mm, Mm, Mm^Xm, Mm^Xm, Mm^Xm
Mm^Xm, Mm^Xm, Mm, Mm^Xm, Mm, Mm^Xm, Mm, Mm, Gs^Fds, Gs^Fds, Cv, Mm, Mm, Mm, Hhd, Hhd, Gll^Fp, Gs^Fds, Rp, Gs^Fds, Gs^Fds, Gll^Fp, Gll, Gs, Gs^Fms, Gs^Fms, Mm^Xm, Gg^Fet, Hh, Mm, Mm, Mm, Mm, Gs^Fp, Mm, Hh^Fds, Hh, Hh, Mm, Mm^Xm, Mm^Xm, Mm^Xm
Wo, Mm^Xm, Mm^Xm, Mm, Mm^Xm, Mm^Xm, Mm^Xm, Mm, Gs^Fds, Gs^Fds, Gs^Fds, Hh, Gs^Fds, Gg^Fet, Hhd, Hhd, Gs, Rp, Gs, Gll, Cv, Hh, Gs, Gll^Fp, Hhd, Hhd, Mm^Xm, Mm^Xm, Mm^Xm, Mm^Xm, Mm^Xm, Mm^Xm, Mm^Xm, Mm^Xm, Md^Xm, Mm^Xm, Mm^Xm, Mm^Xm, Mm^Xm, Mm^Xm, Mm^Xm, Mm^Xm
Wo, Wo, Wo, Mm^Xm, Mm^Xm, Mm, Mm^Xm, Mm^Xm, Mm, Mm, Gs^Fds, Hh^Fds, Gs^Ft, Gs^Fds, Gs^Fds, Gs, Gs^Ve, Gs, Gll, Cv, 1 Kv, Cv, Gll, Gll, Hhd, Hhd, Md, Mm, Md^Xm, Mm^Xm, Mm^Xm, Mm^Xm, Mm^Xm, Md^Xm, Md^Xm, Mm^Xm, Mm^Xm, Mm^Xm, Md, Mm^Xm, Md, Mm
Wo, Wo, Wo, Mm, Mm^Xm, Mm, Mm^Xm, Mm^Xm, Mm, Mm, Mm, Gs^Ft, Gs^Ft, Gs^Fds, Gll, Gll, Gs, Rp, Gs, Cv, Cv, Cv, Gs, Hhd, Md, Mm, Md, Md^Xm, Md, Md^Xm, Md^Xm, Md^Xm, Md, Mm, Md^Xm, Mm, Md, Md, Chr, Md, Md, Md^Xm
Mm^Xm, Wo, Wo, Wo, Mm^Xm, Mm^Xm, Mm^Xm, Mm^Xm, Mm, Mm, Mm, Cv, Mm, Hh, Gll, Ce, Ce, Gll, Rp, Hhd, Hhd, Gll, Hh^Fds, Md, Hhd, Md^Xm, Md^Xm, Md^Xm, Md, Md^Xm, Hhd, Md, Hhd, Md, Md^Xm, Md^Xm, Hhd, Hhd, Hhd, Md, Md, Md^Xm
Mm^Xm, Mm^Xm, Wo, Ww, Ww, Mm^Xm, Mm, Mm^Xm, Mm^Xm, Mm, Mm, Mm, Mm, Cv, Mm, Gll^Fp, Gll^Fp, Gll^Fp, Gs, Rp, Rp, Gll, Hhd, Hhd, Md^Xm, Md, Md, Hhd, Hhd, Md, Gs^Ft, Gd, Md, Hhd, Md, Md, Hhd, Md, Md, Hhd, Md^Xm, Md^Xm
Md^Xm, Mm^Xm, Mm^Xm, Ww, Ww, Wwf, Mm^Xm, Mm^Xm, Md^Xm, Md^Xm, Mm^Xm, Mm^Xm, Mm^Xm, Mm, Hhd, Hhd, Mm, Gll, Gll, Gll^Fp, Ce, Re, Ce, Md, Md, Md, Gd^Fdw, Hhd, Hd, Gd^Ft, Md, Gs^Ft, Hhd, Hhd, Md, Md, Gd^Ft, Md, Hhd, Hhd, Md^Xm, Md^Xm
Md, Md^Xm, Mm^Xm, Mm^Xm, Ww, Ww, Mm, Mm^Xm, Md^Xm, Md^Xm, Md^Xm, Mm^Xm, Md, Md^Xm, Md, Hhd, Hhd, Ce, Ce, Ce, Gd, Gd, Re, Ce, Ce, Ce, Gd^Ft, Gd^Ft, Hd, Md^Xm, Ds, Dd, Hd, Gd^Ft, Hhd, Md, Gd^Ft, Md, Hhd, Hhd, Hhd, Md^Xm
Md, Md^Xm, Hhd, Mm^Xm, Ww, Wwf, Hhd, Hhd, Hhd, Md^Xm, Md^Xm, Md^Xm, Hhd, Ce, Ce, Ce, Hhd, Hd, Hhd, Hhd, Hhd, Gd, Gd, Re, Re, Gd, Hd, Gd^Ft, Gd, Gd^Vda, Hhd, Dd, Hd, Rd, Hd, Gd^Ft, Hd, Hhd, Gd^Ft, Gd^Ft, Hd, Hhd
Hd, Md, Hd, Hhd, Wwf, Wwf, Ww, Ds, Ds, Md, Ds, Md, Md, Hhd, Hd, Hd, Hd, Ds, Ds, Chr, Re, Re^Vda, Re, Re, Re, Re, Re, Ds, Rd, Gd, Hhd, Dd, Dd, Dd^Edpp, Hd, Md, Md, Hd, Gd^Ft, Hd, Md, Md
Ds, Hd, Md, Hd, Ds, Ww, Wwf, Ww, Ww, Ds, Ww, Ds, Ds, Md, Hd, Hd, Chr, Md, Hd, Gll^Ft, Hd, Re, Re, Re, Re, Rd, Hd, Ds, Dd, Ds, Ce, Ce, Rd, Rd, Dd, Dd, Dd, Hd, Md, Rd, Md^Xm, Md^Xm
Ds, Hhd, Md, Md, Hhd, Ds, Ds, Wwf, Ww, Wwf, Wwf, Ww, Ww, Hd, Md, Md^Xm, Hd^Edpp, Md, Dd, Hd, Dd, Dd, Ce, Rd, Ds^Edpp, Rd^Edpp, Dd^Edpp, Dd, Ds, Hd, Ke, Hd, Hd, Rd, Hd, Dd, Md, Dd, Hd, Md, Md^Xm, Md^Xm
Hhd, Hhd, Md, Md, Md, Dd, Hhd, Md, Md^Xm, Hd, Hd, Wwf, Ww, Ds, Dd, Dd^Edpp, Dd^Edpp, Dd, Hd, Hd, Dd^Vda, Rd, Ds, Ds, Rd, Ds^Edpp, Ds, Rd, Dd, Ds, Ce, Hd, Hd, Hd, Md, Md^Xm, Hd, Hd, Hd, Md^Xm, Hd, Md^Xm
Md, Hhd, Md, Hhd, Hd, Hhd, Hhd, Md, Md^Xm, Md^Xm, Ds, Ww, Wwf, Ds, Ds, Dd^Edpp, Md, Md^Xm, Md^Xm, Hd, Ds, Hd^Dr, Dd^Edpp, Ds, Ce, Dd, Ds, Hd, Gd, Ds, Gd^Ft, Ds, Dd, Ds, Gd, Md^Xm, Ds, Ds^Edpp, Hd, Hd, Dd, Dd
Md, Md, Md^Xm, Md, Md, Dd, Hhd, Md, Md^Xm, Md^Xm, Md, Ww, Ww, Wwf, Ww, Ds, Ds, Hd, Md^Xm, Md, Hd, Ds, Dd, Hd, Hd, Hd, Hd, Dd, Dd, Gd, Gd^Ft, Dd, Gd^Ft, Dd, Gd, Ds, Dd, Dd, Hd, Hd, Dd, Dd
Md, Md^Xm, Md^Xm, Md^Xm, Md, Hhd, Hhd, Md, Md, Md, Md^Xm, Md, Md, Wwf, Ww, Ww, Ww, Hd, Hd, Dd, Hd, Hd, Ds, Dd, Hd, Hd, Rd, Hd^Dr, Dd, Ds, Dd, Dd, Hhd, Wwf, Wwf, Gd^Ft, Gd, Dd, Gd, Gd, Ww, Ww
Md^Xm, Md^Xm, Md, Md^Xm, Md^Xm, Md, Hhd, Hhd, Hhd, Hhd, Md^Xm, Md^Xm, Md^Xm, Md, Ds, Wwf, Wwf, Ds, Dd, Dd, Ds, Ds, Ds, Dd, Hd, Rd, Rd, Dd, Ds, Dd, Dd, Hhd, Hhd, Ww, Ww, Gd^Ft, Ww, Gd, Ww, Wwf, Hhd, Hhd
Md^Xm, Md^Xm, Md, Md, Md, Md, Dd, Hhd, Ds, Ds, Dd, Md^Xm, Md, Md^Xm, Gd, Wwf, Wwf, Ds, Hd, Md, Md^Xm, Md^Xm, Hd, Dd, Dd, Gd, Hhd, Rd, Gd, Dd^Edpp, Ds, Ds, Gd, Wwf, Ww, Ww, Ww, Wwf, Wwf, Ww, Gd^Vht, Gd
Md, Md, Md, Hd, Hd, Ds, Ds, Ds, Rd, Rd, Hd, Md, Md, Md^Xm, Hhd, Gd, Ww, Wwf, Ds, Hd, Md, Hd, Hhd, Hhd, Hhd, Gd^Ft, Hhd, Re, Gd, Dd, Hhd, Gd^Ft, Wwf, Wwf, Ww, Gd^Ft, Hhd, Ww, Wwf, Ww, Ww, Gd
Hd, Md, Md, Hd, Hd^Dr, Dd, Hhd, Hd, Dd, Rd^Edpp, Dd^Edpp, Hhd, Hhd, Md, Md, Gd, Ww, Wwf, Wwf, Ds, Hd, Hd, Hhd, Gd, Gd, Hhd, Gd, Gd^Ft, Gd, Hhd, Wwf, Gd, Ww, Ww, Hhd, Gd, Dd^Vdt, Ds, Ce, Ce, Ce, Hd
Md, Md, Md, Hd, Hd, Dd^Edpp, Hhd, Hhd, Dd, Ds^Edpp, Dd^Edpp, Dd, Hhd, Hhd, Hhd, Ds, Gd, Ww, Ww, Ww, Ww, Dd, Wwf, Ww, Ww, Wwf, Wwf, Gd, Ww, Wwf, Ww, Ww, Wwf, Ww, Gd, Gd, Gd, Dd, Ce, 2 Ke, Hd, Hd
Md^Xm, Md^Xm, Md, Md, Md, Hd, Hd, Hhd, Hhd, Hd, Dd, Dd, Rd, Hhd, Dd, Dd, Gd, Gd, Ds, Wwf, Ww, Ww, Wwf, Ww, Dd^Vdt, Ww, Wwf, Ww, Ww, Wwf, Ds^Ecf, Ds, Ds, Ds, Dd^Vdt, Ds, Gd^Ecf, Dd, Ce, Hd, Dd, Dd^Edpp
Md^Xm, Md^Xm, Md, Md, Md, Hd, Dd, Hhd, Hd, Dd, Ds^Edpp, Rd, Rd, Dd, Dd, Dd^Edpp, Dd, Dd, Dd, Ww, Wwf, Ww, Dd, Dd, Hd^Dr, Ds, Ds, Wwf, Gd, Ds, Ds, Ds, Dd^Edpp, Dd, Dd, Ds, Dd, Dd, Dd, Hd, Dd^Edpp, Dd^Edpp
Md^Xm, Md^Xm, Md^Xm, Md, Hd, Hd, Rd^Edpp, Dd, Ds, Ds^Edpp, Rd, Rd, Hd, Dd, Ds, Ds^Edpp, Rd, Rd, Dd, Ww, Ww, Ds, Ds, Ds^Edpp, Hd, Gd, Ce, Dd, Ds, Ds, Rd, Ds, Ds, Ds^Edp, Dd, Ds, Dd^Vdt, Ds, Rd, Ds^Edpp, Ds^Edpp, Ds
Md, Md^Xm, Md, Md, Hd, Hd^Dr, Dd^Edpp, Dd^Edpp, Ds, Ds, Ds^Edpp, Hd, Md, Dd, Hhd, Hhd, Ds, Rd, Rd, Dd, Wwf, Ww, Dd^Vdt, Ds, Ds, Ce, 3 Ke, Ce, Rd, Dd^Vdt, Dd, Ds^Edp, Ds, Ds, Dd, Ds^Edp, Rd, Ds, Rd, Ds^Ecf, Ds, Ds
Hd, Md, Md, Hd, Hd, Dd^Edpp, Rd, Dd, Dd, Dd^Edpp, Hd^Edpp, Hd, Md, Hd^Edpp, Hhd, Hhd, Ds, Dd, Dd^Edpp, Dd, Ds, Ww, Wwf, Ds, Ds, Ce, Ce, Ce, Rd^Edpp, Dd, Dd^Ecf, Rd, Rd^Edpp, Ds, Ds, Dd, Ds, Rd, Ds, Rd, Rd, Ds
Hd, Hd, Hd, Hd, Ds, Ds, Ds, Dd, Ds, Hd, Md, Md, Md, Hd, Hd, Hd, Hd, Dd, Dd, Dd, Dd, Dd, Ds, Wwf, Wwf, Ds, Ds, Dd, Dd, Dd, Rd, Dd, Dd, Dd, Ds, Dd, Ds, Ds^Edpp, Ds, Ds, Ds, Rd
