border_size=1
usage=map

Mm^Xm       , Mm^Xm       , Mm^Xm       , Mm^Xm       , Mm^Xm       , Mm^Xm       , Mm^Xm       , Mm^Xm       , Mm          , Mm          , Mm          , Mm          , Mm          , Mm          , Mm          , Mm          , Mm          , Mm          , Mm          , Mm          , Mm          , Mm          , Hh          , Hh          , Hh          , Gg          , Ggf         , Gg          , Rp          , Hh          , Hh          , Mm          , Mm          , Mm          , Mm          , Mm          , Mm          , Mm          , Mm          , Mm          , Mm          , Mm          
Mm^Xm       , Mm^Xm       , Mm^Xm       , Mm          , Mm          , Mm          , Mm          , Mm          , Mm          , Mm          , Hh          , Hh^Fp       , Gs^Fp       , Mm          , Mm          , Mm          , Mm          , Mm          , Mm          , Mm          , Mm          , Mm          , Mm          , Hh          , Hh^Fp       , Gs^Fp       , Gg          , Gs^Fp       , Rp          , Hh          , Gg^Ve       , Mm          , Hh          , Mm          , Mm          , Mm          , Mm^Xm       , Mm^Xm       , Mm          , Mm          , Mm^Xm       , Mm^Xm       
Mm^Xm       , Mm^Xm       , Mm^Xm       , Mm^Xm       , Mm^Xm       , Mm          , Mm          , Mm          , Mm          , Mm          , Hh^Fp       , Hh^Fp       , Cv          , Gs^Fp       , Gs^Fp       , Gs^Fp       , Hh          , Hh          , Mm          , Mm          , Mm          , Hh          , Gs^Ft       , Hh          , Gg^Ve       , Gs^Ft       , Gs^Fp       , Ggf         , Rp          , Hh          , Hh          , Mm          , Hh          , Hh          , Hh          , Mm          , Mm          , Mm^Xm       , Mm          , Mm          , Mm^Xm       , Mm^Xm       
Mm^Xm       , Mm^Xm       , Mm          , Mm          , Mm          , Mm          , Mm^Xm       , Mm^Xm       , Mm          , Mm          , Mm          , Hh          , Hh          , Gs^Fp       , Hh^Fp       , Gg^Fet      , Hh          , Hh          , Mm          , Cv          , Cv          , Hh          , Hh          , Hh^Fp       , Gs^Ft       , Gs^Ft       , Ggf         , Cv          , Re          , Gs^Fp       , Hh          , Mm          , Hh^Fp       , Hh^Fp       , Hh          , Gs^Ft       , Mm          , Mm          , Mm^Xm       , Mm^Xm       , Mm^Xm       , Mm^Xm       
Mm^Xm       , Mm          , Mm          , Mm          , Mm^Xm       , Mm^Xm       , Mm^Xm       , Mm          , Mm          , Mm^Xm       , Mm          , Mm          , Mm          , Hh          , Gs^Fp       , Hh^Fp       , Mm          , Mm          , Mm          , Cv          , Hh          , Gg^Fet      , Gs^Fp       , Hh^Fp       , Gs^Fp       , Gs^Fp       , Rp          , Re          , Hh          , Gs^Fp       , Cv          , Hh          , Hh^Fp       , Gs^Fp       , Gs^Fp       , Gs^Ft       , Hh          , Mm          , Mm^Xm       , Mm^Xm       , Mm^Xm       , Mm^Xm       
Mm^Xm       , Mm^Xm       , Mm          , Mm^Xm       , Mm^Xm       , Mm^Xm       , Mm^Xm       , Mm^Xm       , Mm          , Mm          , Mm          , Mm          , Mm          , Mm          , Mm          , Mm          , Mm          , Mm          , Mm          , Mm          , Hh          , Gs^Fp       , Gg^Ve       , Gs^Fp       , Gs^Fp       , Gs^Ft       , Hh          , Gs^Fp       , Hh          , Cv          , Hh          , Gg^Ve       , Gs^Fp       , Gs^Ft       , Gs^Fp       , Hh          , Hh          , Mm          , Mm          , Mm          , Mm^Xm       , Mm^Xm       
Mm^Xm       , Mm          , Mm          , Mm^Xm       , Mm^Xm       , Mm^Xm       , Mm^Xm       , Mm^Xm       , Mm          , Mm^Xm       , Mm^Xm       , Mm          , Mm^Xm       , Mm^Xm       , Mm^Xm       , Mm          , Mm          , Mm          , Mm          , Mm          , Mm          , Hh          , Ggf         , Ggf         , Gs^Fp       , Gs^Ft       , Gs^Fp       , Hh^Fp       , Gs^Fp       , Hh          , Gs^Fp       , Gs^Fp       , Hh          , Gs^Fp       , Gs^Ft       , Hh^Fp       , Mm          , Mm          , Mm^Xm       , Mm          , Mm^Xm       , Mm^Xm       
Mm^Xm       , Mm          , Mm          , Mm          , Mm          , Mm          , Mm          , Mm          , Mm          , Mm^Xm       , Mm^Xm       , Mm^Xm       , Mm^Xm       , Mm^Xm       , Mm^Xm       , Mm^Xm       , Mm^Xm       , Mm          , Mm          , Mm          , Mm          , Cv          , Hh^Fp       , Gs^Fp       , Gs^Fp       , Rp          , Gs^Fp       , Hh^Fp       , Mm          , Gs^Fp       , Mm          , Gs^Fp       , Gg^Fet      , Gs^Ft       , Mm          , Mm          , Mm^Xm       , Mm^Xm       , Mm          , Mm          , Mm^Xm       , Mm^Xm       
Mm^Xm       , Mm          , Mm^Xm       , Mm^Xm       , Mm^Xm       , Mm^Xm       , Mm^Xm       , Mm^Xm       , Mm          , Mm          , Mm          , Mm          , Mm          , Mm^Xm       , Mm          , Mm          , Mm          , Mm          , Mm          , Mm          , Hh          , Hh          , Gs^Ft       , Gs^Fp       , Rp          , Rp          , Gs^Fp       , Hh          , Mm          , Cv          , Mm          , Gs^Fp       , Gs^Fp       , Gs^Ft       , Gs^Fp       , Mm          , Mm          , Mm          , Mm          , Mm^Xm       , Mm^Xm       , Mm^Xm       
Mm^Xm       , Mm^Xm       , Mm^Xm       , Mm          , Mm^Xm       , Mm^Xm       , Mm          , Mm          , Mm          , Mm          , Cv          , Mm          , Mm          , Mm          , Mm          , Mm          , Gs^Ft       , Mm          , Hh          , Hh          , Rp          , Rp          , Gs^Ft       , Gs^Fp       , Gs^Fp       , Hh          , Gs^Ft       , Hh          , Mm          , Mm          , Mm          , Mm          , Mm          , Mm          , Gs^Fp       , Hh^Fp       , Hh          , Mm          , Mm          , Mm^Xm       , Mm^Xm       , Mm^Xm       
Mm^Xm       , Mm^Xm       , Mm          , Mm^Xm       , Mm          , Mm^Xm       , Mm          , Mm          , Gs^Fp       , Gs^Fp       , Cv          , Mm          , Mm          , Mm          , Mm          , Gs^Ft       , Gs^Ft       , Gs^Fp       , Rp          , Gs^Fp       , Gs^Fp       , Gs^Ft       , Mm          , Gs^Fp       , Gs^Fp       , Gs^Fp       , Mm^Xm       , Gg^Fet      , Hh          , Mm          , Mm          , Mm          , Mm          , Gs^Fp       , Mm          , Hh^Fp       , Hh          , Hh          , Mm          , Mm^Xm       , Mm^Xm       , Mm^Xm       
Wo          , Mm^Xm       , Mm^Xm       , Mm          , Mm^Xm       , Mm^Xm       , Mm^Xm       , Mm          , Gs^Fp       , Gs^Fp       , Gs^Fp       , Hh          , Gs^Fp       , Gg^Fet      , Gs^Fp       , Gs^Fp       , Gs^Ft       , Rp          , Gs^Fp       , Gs^Fp       , Cv          , Hh          , Mm^Xm       , Mm^Xm       , Mm^Xm       , Mm^Xm       , Mm^Xm       , Mm^Xm       , Mm^Xm       , Mm^Xm       , Mm^Xm       , Mm^Xm       , Mm^Xm       , Mm^Xm       , Mm^Xm       , Mm^Xm       , Mm^Xm       , Mm^Xm       , Mm^Xm       , Mm^Xm       , Mm^Xm       , Mm^Xm       
Wo          , Wo          , Wo          , Mm^Xm       , Mm^Xm       , Mm          , Mm^Xm       , Mm^Xm       , Mm          , Mm          , Gs^Fp       , Hh^Fp       , Gs^Ft       , Gs^Fp       , Gs^Fp       , Gs^Ft       , Gg^Ve       , Gs^Fp       , Gs^Fp       , Cv          , 1 Kv        , Cv          , Mm^Xm       , Mm^Xm       , Mm^Xm       , Mm^Xm       , Mm          , Mm          , Mm^Xm       , Mm^Xm       , Mm^Xm       , Mm^Xm       , Mm^Xm       , Mm^Xm       , Mm^Xm       , Mm^Xm       , Mm^Xm       , Mm^Xm       , Mm          , Mm^Xm       , Mm          , Mm          
Wo          , Wo          , Wo          , Mm          , Mm^Xm       , Mm          , Mm^Xm       , Mm^Xm       , Mm          , Mm          , Mm          , Gs^Ft       , Gs^Ft       , Gs^Fp       , Gs^Fp       , Gs^Fp       , Gs^Fp       , Rp          , Gs^Ft       , Cv          , Cv          , Cv          , Mm^Xm       , Mm          , Mm          , Mm          , Mm          , Mm          , Mm          , Mm^Xm       , Mm          , Mm          , Mm          , Mm          , Mm          , Mm          , Mm          , Mm          , Chr         , Mm          , Mm          , Mm^Xm       
Mm^Xm       , Wo          , Wo          , Wo          , Mm^Xm       , Mm^Xm       , Mm^Xm       , Mm^Xm       , Mm          , Mm          , Mm          , Cv          , Mm          , Hh          , Hh          , Gs^Ft       , Gs^Fp       , Rp          , Rp          , Hh          , Hh          , Gs^Fp       , Hh^Fp       , Mm          , Mm          , Mm^Xm       , Mm          , Mm          , Mm          , Mm          , Hh          , Mm          , Hh          , Mm          , Mm          , Mm          , Hh          , Hh          , Hh          , Mm          , Mm          , Mm^Xm       
Mm^Xm       , Mm^Xm       , Wo          , Ww          , Ww          , Mm^Xm       , Mm          , Mm^Xm       , Mm^Xm       , Mm          , Mm          , Mm          , Mm          , Cv          , Mm          , Gs^Ft       , Gs^Ft       , Gs^Ft       , Gs^Fp       , Rp          , Rp          , Gs^Ft       , Hh          , Mm          , Mm^Xm       , Mm          , Mm          , Hh          , Hh          , Mm          , Gs^Ft       , Gs          , Mm          , Hh          , Mm          , Mm          , Hh          , Mm          , Mm          , Hh          , Mm^Xm       , Mm^Xm       
Md^Xm       , Mm^Xm       , Mm^Xm       , Ww          , Ww          , Wwf         , Mm^Xm       , Mm^Xm       , Md^Xm       , Md^Xm       , Mm^Xm       , Mm^Xm       , Mm^Xm       , Mm          , Mm          , Mm^Xm       , Mm          , Hh          , Hh^Fp       , Gs^Ft       , Gs          , Re          , Re          , Mm          , Mm          , Mm          , Gs^Ft       , Hh          , Hd          , Gs^Ft       , Md          , Gs^Ft       , Hh          , Hh          , Mm          , Mm          , Gs^Ft       , Hh          , Hh          , Hh          , Mm^Xm       , Mm^Xm       
Md          , Md^Xm       , Mm^Xm       , Mm^Xm       , Ww          , Ww          , Mm          , Mm^Xm       , Md^Xm       , Mm^Xm       , Md^Xm       , Mm^Xm       , Md^Xm       , Mm^Xm       , Md^Xm       , Mm          , Md^Xm       , Hh          , Gg^Fet      , Gs^Ft       , Hh          , Re          , Re          , Gs          , Ds          , Chr         , Gs^Ft       , Gs^Ft       , Hd          , Md^Xm       , Ds          , Dd          , Hd          , Gs^Ft       , Hh          , Mm          , Gs^Ft       , Mm          , Hh          , Hh          , Hh          , Mm^Xm       
Md          , Md^Xm       , Hd          , Mm^Xm       , Ww          , Wwf         , Hh          , Hd          , Hd          , Md^Xm       , Md^Xm       , Md^Xm       , Md^Xm       , Md^Xm       , Md          , Md^Xm       , Md          , Hd          , Hh          , Hh          , Hh          , Gs          , Ds          , Rd          , Ds          , Ds          , Hd          , Hd          , Gs          , Dd^Vda      , Hh          , Dd          , Hd          , Rd          , Hd          , Gs^Ft       , Hd          , Hh          , Gs^Ft       , Gs^Ft       , Hd          , Hh          
Hd          , Md          , Hd          , Hh          , Wwr         , Wwf         , Ww          , Ds          , Ds          , Md          , Ds          , Md          , Md          , Md          , Hd          , Hd          , Hd          , Ds          , Ds          , Chr         , Ds          , Dd^Vda      , Ds          , Rd          , Hd          , Ds          , Ds          , Ds          , Rd          , Gs          , Hh          , Dd          , Dd          , Dd          , Hd          , Md          , Md          , Hd          , Gs^Ft       , Hd          , Md          , Md          
Ds          , Hd          , Md          , Hd          , Ds          , Ww          , Wwr         , Ww          , Ww          , Ds          , Ww          , Ds          , Ds          , Md          , Hd          , Hd          , Chr         , Md          , Hd          , Gs^Ft       , Hd          , Ds          , Rd          , Hd          , Ds          , Rd          , Hd          , Ds          , Dd          , Ds          , Md          , Md^Xm       , Rd          , Rd          , Dd          , Dd          , Dd          , Hd          , Md          , Rd          , Md^Xm       , Md^Xm       
Ds          , Hd          , Md          , Md          , Hd          , Ds          , Ds          , Wwr         , Ww          , Wwf         , Wwf         , Ww          , Ww          , Hd          , Md          , Md^Xm       , Hd          , Md          , Dd          , Hd          , Dd          , Dd          , Hd          , Rd          , Ds          , Rd          , Dd          , Dd          , Ds          , Hd          , Md^Xm       , Hd          , Hd          , Rd          , Hd          , Dd          , Md          , Dd          , Hd          , Md          , Md^Xm       , Md^Xm       
Hd          , Dd          , Md          , Md          , Md          , Dd          , Hd          , Md          , Md^Xm       , Hd          , Hd          , Wwf         , Ww          , Ds          , Dd          , Dd          , Dd          , Dd          , Hd          , Hd          , Dd^Vda      , Gs^Ft       , Ds          , Ds          , Rd          , Ds          , Ds          , Rd          , Dd          , Ds          , Md          , Hd          , Hd          , Hd          , Md          , Md^Xm       , Hd          , Hd          , Hd          , Md^Xm       , Hd          , Md^Xm       
Md          , Hd          , Md          , Dd          , Hd          , Dd          , Hd          , Md          , Md^Xm       , Md^Xm       , Ds          , Ww          , Wwr         , Ds          , Ds          , Dd          , Md          , Md^Xm       , Md^Xm       , Hd          , Ds          , Hd          , Dd          , Ds          , Rd          , Dd          , Ds          , Hd          , Gs          , Ds          , Gs^Ft       , Ds          , Dd          , Ds          , Gs          , Md^Xm       , Ds          , Ds          , Hd          , Hd          , Dd          , Dd          
Md          , Md          , Md^Xm       , Md          , Md          , Dd          , Dd          , Md          , Md^Xm       , Md^Xm       , Md          , Ww          , Ww          , Wwr         , Ww          , Ds          , Ds          , Hd          , Md^Xm       , Md          , Hd          , Ds          , Dd          , Hd          , Hd          , Hd          , Hd          , Dd          , Dd          , Gs          , Gs^Ft       , Dd          , Gs^Ft       , Dd          , Gs          , Ds          , Dd          , Dd          , Hd          , Hd          , Dd          , Dd          
Md          , Md^Xm       , Md^Xm       , Md^Xm       , Md          , Dd          , Ds          , Md          , Md          , Md          , Md^Xm       , Md          , Md          , Wwr         , Ww          , Ww          , Ww          , Hd          , Hd          , Dd          , Hd          , Hd          , Ds          , Dd          , Hd          , Hd          , Rd          , Hd          , Dd          , Ds          , Dd          , Dd          , Hh          , Wwr         , Wwr         , Gs^Ft       , Gs          , Dd          , Gs          , Gs          , Wwr         , Wwr         
Md^Xm       , Md^Xm       , Md          , Md^Xm       , Md^Xm       , Md          , Ds          , Hd          , Ds          , Dd          , Md^Xm       , Md^Xm       , Md^Xm       , Md          , Ds          , Wwr         , Wwf         , Ds          , Dd          , Dd          , Ds          , Ds          , Ds          , Dd          , Hd          , Rd          , Rd          , Dd          , Ds          , Dd          , Dd          , Hh          , Hh          , Ww          , Ww          , Gs^Ft       , Ww          , Gs          , Ww          , Wwr         , Hh          , Hh          
Md^Xm       , Md^Xm       , Md          , Md          , Md          , Md          , Dd          , Hd          , Ds          , Ds          , Dd          , Md^Xm       , Md          , Md^Xm       , Gs          , Wwr         , Wwf         , Ds          , Hd          , Md          , Md^Xm       , Md^Xm       , Hd          , Dd          , Dd          , Gs          , Hh          , Rd          , Gs          , Dd          , Ds          , Ds          , Gs          , Wwf         , Ww          , Ww          , Ww          , Wwf         , Wwf         , Wwr         , Gs^Vht      , Gs          
Md          , Md          , Md          , Hd          , Hd          , Ds          , Ds          , Ds          , Rd          , Rd          , Hd          , Md          , Md          , Md^Xm       , Gs          , Ww          , Ww          , Wwf         , Ds          , Hd          , Md          , Hd          , Hh          , Hh          , Hh          , Gs^Ft       , Hh          , Re          , Gs          , Dd          , Hh          , Gs^Ft       , Wwf         , Wwf         , Ww          , Gs^Ft       , Hh          , Ww          , Wwr         , Ww          , Ww          , Gs          
Hd          , Md          , Md          , Hd          , Hd          , Dd          , Dd          , Hd          , Dd          , Rd          , Dd          , Hd          , Hd          , Md          , Md          , Gs          , Ww          , Wwr         , Wwr         , Ds          , Hd          , Hd          , Hh          , Gs          , Gs          , Hh          , Gs          , Gs^Ft       , Gs          , Hh          , Wwr         , Gs          , Ww          , Ww          , Hh          , Gs          , Dd^Vdt      , Ds          , Ce          , Ce          , Ce          , Hd          
Md          , Md          , Md          , Hd          , Hd          , Dd          , Hd          , Hd          , Dd          , Ds          , Dd          , Dd          , Dd          , Hd          , Hd          , Ds          , Gs          , Ww          , Ww          , Ww          , Ww          , Dd          , Wwr         , Ww          , Ww          , Wwr         , Wwf         , Gs          , Ww          , Wwf         , Ww          , Ww          , Wwf         , Ww          , Gs          , Gs          , Gs          , Dd          , Ce          , 2 Ke        , Hd          , Hd          
Md^Xm       , Md^Xm       , Md          , Md          , Md          , Hd          , Hd          , Hd          , Hd          , Hd          , Dd          , Dd          , Rd          , Hd          , Dd          , Dd          , Gs          , Gs          , Ds          , Wwr         , Ww          , Ww          , Wwr         , Ww          , Ds          , Ww          , Wwf         , Ww          , Ww          , Wwf         , Ds^Fy       , Ds          , Ds          , Ds          , Dd^Vdt      , Ds          , Gs^Fy       , Dd          , Ce          , Hd          , Dd          , Dd          
Md^Xm       , Md^Xm       , Md          , Md          , Md          , Hd          , Dd          , Hd          , Hd          , Dd          , Ds          , Rd          , Rd          , Dd          , Dd          , Dd          , Dd          , Dd          , Dd          , Ww          , Wwr         , Ww          , Dd          , Dd          , Hd          , Ds          , Ds          , Wwf         , Gs          , Ds          , Ds          , Ds          , Ce          , Ce          , Ce          , Ds          , Dd          , Dd          , Dd          , Hd          , Dd          , Dd          
Md^Xm       , Md^Xm       , Md^Xm       , Md          , Hd          , Hd          , Rd          , Dd          , Ds          , Ds          , Rd          , Rd          , Hd          , Dd          , Ds          , Ds          , Rd          , Rd          , Dd          , Ww          , Ww          , Ds          , Ds          , Ds          , Hd          , Gs          , Gs          , Dd          , Ds          , Ds          , Rd          , Ds          , Ce          , 3 Ke        , Ce          , Ds          , Dd^Vdt      , Ds          , Rd          , Ds          , Ds          , Ds          
Md          , Md^Xm       , Md          , Md          , Hd          , Hd          , Dd          , Dd          , Ds          , Ds          , Ds          , Hd          , Md          , Dd          , Hd          , Hd          , Ds          , Rd          , Rd          , Dd          , Wwr         , Ww          , Ds          , Ds          , Ds          , Gs          , Dd          , Dd          , Rd          , Dd^Vdt      , Dd          , Ds          , Ds          , Ce          , Dd          , Ds          , Rd          , Ds          , Rd          , Ds^Fy       , Ds          , Ds          
Hd          , Md          , Md          , Hd          , Hd          , Dd          , Rd          , Dd          , Dd          , Dd          , Hd          , Hd          , Md          , Hd          , Hd          , Hd          , Ds          , Dd          , Dd          , Dd          , Ds          , Ww          , Wwr         , Ds          , Ds          , Hd          , Ds          , Dd          , Rd          , Dd          , Dd^Fy       , Rd          , Rd          , Ds          , Dd^Vdt      , Dd          , Ds          , Rd          , Ds          , Rd          , Rd          , Ds          
Hd          , Hd          , Hd          , Hd          , Ds          , Ds          , Ds          , Dd          , Ds          , Hd          , Md          , Md          , Md          , Hd          , Hd          , Hd          , Hd          , Dd          , Dd          , Dd          , Dd          , Dd          , Ds          , Wwr         , Wwr         , Ds          , Ds          , Dd          , Dd          , Dd          , Rd          , Dd          , Dd          , Dd          , Ds          , Dd          , Ds          , Ds          , Ds          , Ds          , Ds          , Rd          
