border_size=1
usage=map

Mm^Xm       , Mm^Xm       , Mm^Xm       , Mm^Xm       , Mm^Xm       , Mm^Xm       , Mm^Xm       , Mm^Xm       , Mm          , Mm          , Mm          , Mm          , Mm          , Mm          , Mm          , Mm          , Mm          , Mm          , Mm          , Mm          , Mm          , Mm          , Hh          , Hh          , Hh          , Gg          , Ggf         , Gg          , Rp          , Hh          , Hh          , Mm          , Mm          , Mm          , Mm          , Mm          , Mm          , Mm          , Mm          , Mm          , Mm          , Mm          
Mm^Xm       , Mm^Xm       , Mm^Xm       , Mm          , Mm          , Mm          , Mm          , Mm          , Mm          , Mm          , Hh          , Hh^Fp       , Gs^Fms      , Mm          , Mm          , Mm          , Mm          , Mm          , Mm          , Mm          , Mm          , Mm          , Mm          , Hh          , Hh^Fds      , Gs^Fds      , Gg          , Gs^Fds      , Rp          , Hh          , Gg^Ve       , Mm          , Hh          , Mm          , Mm          , Mm          , Mm^Xm       , Mm^Xm       , Mm          , Mm          , Mm^Xm       , Mm^Xm       
Mm^Xm       , Mm^Xm       , Mm^Xm       , Mm^Xm       , Mm^Xm       , Mm          , Mm          , Mm          , Mm          , Mm          , Hh^Fp       , Hh^Fp       , Cv          , Gs^Fms      , Gs^Fms      , Gs^Fp       , Hh          , Hh          , Mm          , Mm          , Mm          , Hh          , Gs^Ft       , Hh          , Gg^Ve       , Gs^Ft       , Gs^Fds      , Ggf         , Rp          , Hh          , Hh          , Mm          , Hh          , Hh          , Hh          , Mm          , Mm          , Mm^Xm       , Mm          , Mm          , Mm^Xm       , Mm^Xm       
Mm^Xm       , Mm^Xm       , Mm          , Mm          , Mm          , Mm          , Mm^Xm       , Mm^Xm       , Mm          , Mm          , Mm          , Hh          , Hh          , Gs^Fms      , Hh^Fp       , Gg^Fet      , Hh          , Hh          , Mm          , Cv          , Cv          , Hh          , Hh          , Hh^Fds      , Gs^Ft       , Gs^Ft       , Ggf         , Cv          , Re          , Gs^Fds      , Hh          , Mm          , Hh^Fds      , Hh^Fds      , Hh          , Gs^Ft       , Mm          , Mm          , Mm^Xm       , Mm^Xm       , Mm^Xm       , Mm^Xm       
Mm^Xm       , Mm          , Mm          , Mm          , Mm^Xm       , Mm^Xm       , Mm^Xm       , Mm          , Mm          , Mm^Xm       , Mm          , Mm          , Mm          , Hh          , Gs^Fms      , Hh^Fp       , Mm          , Mm          , Mm          , Cv          , Hh          , Gg^Fet      , Gs^Fds      , Hh^Fp       , Gs^Fds      , Gs^Fds      , Rp          , Re          , Hh          , Gs^Fp       , Cv          , Hh          , Hh^Fp       , Gs^Fms      , Gs^Fms      , Gs^Ft       , Hh          , Mm          , Mm^Xm       , Mm^Xm       , Mm^Xm       , Mm^Xm       
Mm^Xm       , Mm^Xm       , Mm          , Mm^Xm       , Mm^Xm       , Mm^Xm       , Mm^Xm       , Mm^Xm       , Mm          , Mm          , Mm          , Mm          , Mm          , Mm          , Mm          , Mm          , Mm          , Mm          , Mm          , Mm          , Hh          , Gs^Fp       , Gg^Ve       , Gs^Fds      , Gs^Fds      , Gs^Ft       , Hh          , Gs^Fp       , Hh          , Cv          , Hh          , Gg^Ve       , Gs^Fds      , Gs^Ft       , Gs^Fms      , Hh          , Hh          , Mm          , Mm          , Mm          , Mm^Xm       , Mm^Xm       
Mm^Xm       , Mm          , Mm          , Mm^Xm       , Mm^Xm       , Mm^Xm       , Mm^Xm       , Mm^Xm       , Mm          , Mm^Xm       , Mm^Xm       , Mm          , Mm^Xm       , Mm^Xm       , Mm^Xm       , Mm          , Mm          , Mm          , Mm          , Mm          , Mm          , Hh          , Ggf         , Ggf         , Gs^Fds      , Gs^Ft       , Gs^Fds      , Hh^Fp       , Gs^Fds      , Hh          , Gs^Fds      , Gs^Fds      , Hh          , Gs^Fms      , Gs^Ft       , Hh^Fds      , Mm          , Mm          , Mm^Xm       , Mm          , Mm^Xm       , Mm^Xm       
Mm^Xm       , Mm          , Mm          , Mm          , Mm          , Mm          , Mm          , Mm          , Mm          , Mm^Xm       , Mm^Xm       , Mm^Xm       , Mm^Xm       , Mm^Xm       , Mm^Xm       , Mm^Xm       , Mm^Xm       , Mm          , Mm          , Mm          , Mm          , Cv          , Hh^Fp       , Gs^Fms      , Gs^Fds      , Rp          , Gs^Fms      , Hh^Fp       , Mm          , Gs^Fds      , Mm          , Gs^Fds      , Gg^Fet      , Gs^Ft       , Mm          , Mm          , Mm^Xm       , Mm^Xm       , Mm          , Mm          , Mm^Xm       , Mm^Xm       
Mm^Xm       , Mm          , Mm^Xm       , Mm^Xm       , Mm^Xm       , Mm^Xm       , Mm^Xm       , Mm^Xm       , Mm          , Mm          , Mm          , Mm          , Mm          , Mm^Xm       , Mm          , Mm          , Mm          , Mm          , Mm          , Mm          , Hh          , Hh          , Gs^Ft       , Gs^Fms      , Rp          , Rp          , Gs^Fms      , Hh          , Mm          , Cv          , Mm          , Gs^Fds      , Gs^Fp       , Gs^Ft       , Gs^Fp       , Mm          , Mm          , Mm          , Mm          , Mm^Xm       , Mm^Xm       , Mm^Xm       
Mm^Xm       , Mm^Xm       , Mm^Xm       , Mm          , Mm^Xm       , Mm^Xm       , Mm          , Mm          , Mm          , Mm          , Cv          , Mm          , Mm          , Mm          , Mm          , Mm          , Gs^Ft       , Mm          , Hh          , Hh          , Rp          , Rp          , Gs^Ft       , Gs^Fds      , Gs^Fms      , Hh          , Gs^Ft       , Hh          , Mm          , Mm          , Mm          , Mm          , Mm          , Mm          , Gs^Fms      , Hh^Fds      , Hh          , Mm          , Mm          , Mm^Xm       , Mm^Xm       , Mm^Xm       
Mm^Xm       , Mm^Xm       , Mm          , Mm^Xm       , Mm          , Mm^Xm       , Mm          , Mm          , Gs^Fds      , Gs^Fds      , Cv          , Mm          , Mm          , Mm          , Mm          , Gs^Ft       , Gs^Ft       , Gs^Fds      , Rp          , Gs^Fds      , Gs^Fds      , Gs^Ft       , Mm          , Gs^Fms      , Gs^Fms      , Gs^Fms      , Mm^Xm       , Gg^Fet      , Hh          , Mm          , Mm          , Mm          , Mm          , Gs^Fp       , Mm          , Hh^Fds      , Hh          , Hh          , Mm          , Mm^Xm       , Mm^Xm       , Mm^Xm       
Wo          , Mm^Xm       , Mm^Xm       , Mm          , Mm^Xm       , Mm^Xm       , Mm^Xm       , Mm          , Gs^Fds      , Gs^Fds      , Gs^Fds      , Hh          , Gs^Fds      , Gg^Fet      , Gs^Fds      , Gs^Fds      , Gs^Ft       , Rp          , Gs^Fds      , Gs^Fds      , Cv          , Hh          , Mm^Xm       , Mm^Xm       , Mm^Xm       , Mm^Xm       , Mm^Xm       , Mm^Xm       , Mm^Xm       , Mm^Xm       , Mm^Xm       , Mm^Xm       , Mm^Xm       , Mm^Xm       , Mm^Xm       , Mm^Xm       , Mm^Xm       , Mm^Xm       , Mm^Xm       , Mm^Xm       , Mm^Xm       , Mm^Xm       
Wo          , Wo          , Wo          , Mm^Xm       , Mm^Xm       , Mm          , Mm^Xm       , Mm^Xm       , Mm          , Mm          , Gs^Fds      , Hh^Fds      , Gs^Ft       , Gs^Fds      , Gs^Fds      , Gs^Ft       , Gg^Ve       , Gs^Fds      , Gs^Fds      , Cv          , 1 Kv        , Cv          , Mm^Xm       , Mm^Xm       , Mm^Xm       , Mm^Xm       , Mm          , Mm          , Mm^Xm       , Mm^Xm       , Mm^Xm       , Mm^Xm       , Mm^Xm       , Mm^Xm       , Mm^Xm       , Mm^Xm       , Mm^Xm       , Mm^Xm       , Mm          , Mm^Xm       , Mm          , Mm          
Wo          , Wo          , Wo          , Mm          , Mm^Xm       , Mm          , Mm^Xm       , Mm^Xm       , Mm          , Mm          , Mm          , Gs^Ft       , Gs^Ft       , Gs^Fds      , Gs^Fds      , Gs^Fds      , Gs^Fds      , Rp          , Gs^Ft       , Cv          , Cv          , Cv          , Mm^Xm       , Mm          , Mm          , Mm          , Mm          , Mm          , Mm          , Mm^Xm       , Mm          , Mm          , Mm          , Mm          , Mm          , Mm          , Mm          , Mm          , Chr         , Mm          , Mm          , Mm^Xm       
Mm^Xm       , Wo          , Wo          , Wo          , Mm^Xm       , Mm^Xm       , Mm^Xm       , Mm^Xm       , Mm          , Mm          , Mm          , Cv          , Mm          , Hh          , Hh          , Gs^Ft       , Gs^Fds      , Rp          , Rp          , Hh          , Hh          , Gs^Fds      , Hh^Fds      , Mm          , Mm          , Mm^Xm       , Mm          , Mm          , Mm          , Mm          , Hh          , Mm          , Hh          , Mm          , Mm          , Mm          , Hh          , Hh          , Hh          , Mm          , Mm          , Mm^Xm       
Mm^Xm       , Mm^Xm       , Wo          , Ww          , Ww          , Mm^Xm       , Mm          , Mm^Xm       , Mm^Xm       , Mm          , Mm          , Mm          , Mm          , Cv          , Mm          , Gs^Ft       , Gs^Ft       , Gs^Ft       , Gs^Fds      , Rp          , Rp          , Gs^Ft       , Hh          , Mm          , Mm^Xm       , Mm          , Mm          , Hh          , Hh          , Mm          , Gs^Ft       , Gs          , Mm          , Hh          , Mm          , Mm          , Hh          , Mm          , Mm          , Hh          , Mm^Xm       , Mm^Xm       
Md^Xm       , Mm^Xm       , Mm^Xm       , Ww          , Ww          , Wwf         , Mm^Xm       , Mm^Xm       , Md^Xm       , Md^Xm       , Mm^Xm       , Mm^Xm       , Mm^Xm       , Mm          , Mm          , Mm^Xm       , Mm          , Hh          , Hh^Fds      , Gs^Ft       , Gs          , Re          , Re          , Mm          , Mm          , Mm          , Gs^Ft       , Hh          , Hd          , Gs^Ft       , Md          , Gs^Ft       , Hh          , Hh          , Mm          , Mm          , Gs^Ft       , Hh          , Hh          , Hh          , Mm^Xm       , Mm^Xm       
Md          , Md^Xm       , Mm^Xm       , Mm^Xm       , Ww          , Ww          , Mm          , Mm^Xm       , Md^Xm       , Mm^Xm       , Md^Xm       , Mm^Xm       , Md^Xm       , Mm^Xm       , Md^Xm       , Mm          , Md^Xm       , Hh          , Gg^Fet      , Gs^Ft       , Hh          , Re          , Re          , Gs          , Ds          , Chr         , Gs^Ft       , Gs^Ft       , Hd          , Md^Xm       , Ds          , Dd          , Hd          , Gs^Ft       , Hh          , Mm          , Gs^Ft       , Mm          , Hh          , Hh          , Hh          , Mm^Xm       
Md          , Md^Xm       , Hd          , Mm^Xm       , Ww          , Wwf         , Hh          , Hd          , Hd          , Md^Xm       , Md^Xm       , Md^Xm       , Md^Xm       , Md^Xm       , Md          , Md^Xm       , Md          , Hd          , Hh          , Hh          , Hh          , Gs          , Ds          , Rd          , Ds          , Ds          , Hd          , Hd          , Gs          , Dd^Vda      , Hh          , Dd          , Hd          , Rd          , Hd          , Gs^Ft       , Hd          , Hh          , Gs^Ft       , Gs^Ft       , Hd          , Hh          
Hd          , Md          , Hd          , Hh          , Wwf         , Wwf         , Ww          , Ds          , Ds          , Md          , Ds          , Md          , Md          , Md          , Hd          , Hd          , Hd          , Ds          , Ds          , Chr         , Ds          , Dd^Vda      , Ds          , Rd          , Hd          , Ds          , Ds          , Ds          , Rd          , Gs          , Hh          , Dd          , Dd          , Dd          , Hd          , Md          , Md          , Hd          , Gs^Ft       , Hd          , Md          , Md          
Ds          , Hd          , Md          , Hd          , Ds          , Ww          , Wwf         , Ww          , Ww          , Ds          , Ww          , Ds          , Ds          , Md          , Hd          , Hd          , Chr         , Md          , Hd          , Gs^Ft       , Hd          , Ds          , Rd          , Hd          , Ds          , Rd          , Hd          , Ds          , Dd          , Ds          , Md          , Md^Xm       , Rd          , Rd          , Dd          , Dd          , Dd          , Hd          , Md          , Rd          , Md^Xm       , Md^Xm       
Ds          , Hd          , Md          , Md          , Hd          , Ds          , Ds          , Wwf         , Ww          , Wwf         , Wwf         , Ww          , Ww          , Hd          , Md          , Md^Xm       , Hd          , Md          , Dd          , Hd          , Dd          , Dd          , Hd          , Rd          , Ds          , Rd          , Dd          , Dd          , Ds          , Hd          , Md^Xm       , Hd          , Hd          , Rd          , Hd          , Dd          , Md          , Dd          , Hd          , Md          , Md^Xm       , Md^Xm       
Hd          , Dd          , Md          , Md          , Md          , Dd          , Hd          , Md          , Md^Xm       , Hd          , Hd          , Wwf         , Ww          , Ds          , Dd          , Dd          , Dd          , Dd          , Hd          , Hd          , Dd^Vda      , Gs^Ft       , Ds          , Ds          , Rd          , Ds          , Ds          , Rd          , Dd          , Ds          , Md          , Hd          , Hd          , Hd          , Md          , Md^Xm       , Hd          , Hd          , Hd          , Md^Xm       , Hd          , Md^Xm       
Md          , Hd          , Md          , Dd          , Hd          , Dd          , Hd          , Md          , Md^Xm       , Md^Xm       , Ds          , Ww          , Wwf         , Ds          , Ds          , Dd          , Md          , Md^Xm       , Md^Xm       , Hd          , Ds          , Hd          , Dd          , Ds          , Rd          , Dd          , Ds          , Hd          , Gs          , Ds          , Gs^Ft       , Ds          , Dd          , Ds          , Gs          , Md^Xm       , Ds          , Ds          , Hd          , Hd          , Dd          , Dd          
Md          , Md          , Md^Xm       , Md          , Md          , Dd          , Dd          , Md          , Md^Xm       , Md^Xm       , Md          , Ww          , Ww          , Wwf         , Ww          , Ds          , Ds          , Hd          , Md^Xm       , Md          , Hd          , Ds          , Dd          , Hd          , Hd          , Hd          , Hd          , Dd          , Dd          , Gs          , Gs^Ft       , Dd          , Gs^Ft       , Dd          , Gs          , Ds          , Dd          , Dd          , Hd          , Hd          , Dd          , Dd          
Md          , Md^Xm       , Md^Xm       , Md^Xm       , Md          , Dd          , Ds          , Md          , Md          , Md          , Md^Xm       , Md          , Md          , Wwf         , Ww          , Ww          , Ww          , Hd          , Hd          , Dd          , Hd          , Hd          , Ds          , Dd          , Hd          , Hd          , Rd          , Hd          , Dd          , Ds          , Dd          , Dd          , Hh          , Wwf         , Wwf         , Gs^Ft       , Gs          , Dd          , Gs          , Gs          , Ww          , Ww          
Md^Xm       , Md^Xm       , Md          , Md^Xm       , Md^Xm       , Md          , Ds          , Hd          , Ds          , Dd          , Md^Xm       , Md^Xm       , Md^Xm       , Md          , Ds          , Wwf         , Wwf         , Ds          , Dd          , Dd          , Ds          , Ds          , Ds          , Dd          , Hd          , Rd          , Rd          , Dd          , Ds          , Dd          , Dd          , Hh          , Hh          , Ww          , Ww          , Gs^Ft       , Ww          , Gs          , Ww          , Wwf         , Hh          , Hh          
Md^Xm       , Md^Xm       , Md          , Md          , Md          , Md          , Dd          , Hd          , Ds          , Ds          , Dd          , Md^Xm       , Md          , Md^Xm       , Gs          , Wwf         , Wwf         , Ds          , Hd          , Md          , Md^Xm       , Md^Xm       , Hd          , Dd          , Dd          , Gs          , Hh          , Rd          , Gs          , Dd          , Ds          , Ds          , Gs          , Wwf         , Ww          , Ww          , Ww          , Wwf         , Wwf         , Ww          , Gs^Vht      , Gs          
Md          , Md          , Md          , Hd          , Hd          , Ds          , Ds          , Ds          , Rd          , Rd          , Hd          , Md          , Md          , Md^Xm       , Gs          , Ww          , Ww          , Wwf         , Ds          , Hd          , Md          , Hd          , Hh          , Hh          , Hh          , Gs^Ft       , Hh          , Re          , Gs          , Dd          , Hh          , Gs^Ft       , Wwf         , Wwf         , Ww          , Gs^Ft       , Hh          , Ww          , Wwf         , Ww          , Ww          , Gs          
Hd          , Md          , Md          , Hd          , Hd          , Dd          , Dd          , Hd          , Dd          , Rd          , Dd          , Hd          , Hd          , Md          , Md          , Gs          , Ww          , Wwf         , Wwf         , Ds          , Hd          , Hd          , Hh          , Gs          , Gs          , Hh          , Gs          , Gs^Ft       , Gs          , Hh          , Wwf         , Gs          , Ww          , Ww          , Hh          , Gs          , Dd^Vdt      , Ds          , Ce          , Ce          , Ce          , Hd          
Md          , Md          , Md          , Hd          , Hd          , Dd          , Hd          , Hd          , Dd          , Ds          , Dd          , Dd          , Dd          , Hd          , Hd          , Ds          , Gs          , Ww          , Ww          , Ww          , Ww          , Dd          , Wwf         , Ww          , Ww          , Wwf         , Wwf         , Gs          , Ww          , Wwf         , Ww          , Ww          , Wwf         , Ww          , Gs          , Gs          , Gs          , Dd          , Ce          , 2 Ke        , Hd          , Hd          
Md^Xm       , Md^Xm       , Md          , Md          , Md          , Hd          , Hd          , Hd          , Hd          , Hd          , Dd          , Dd          , Rd          , Hd          , Dd          , Dd          , Gs          , Gs          , Ds          , Wwf         , Ww          , Ww          , Wwf         , Ww          , Ds          , Ww          , Wwf         , Ww          , Ww          , Wwf         , Ds^Zi       , Ds          , Ds          , Ds          , Dd^Vdt      , Ds          , Gs^Zi       , Dd          , Ce          , Hd          , Dd          , Dd          
Md^Xm       , Md^Xm       , Md          , Md          , Md          , Hd          , Dd          , Hd          , Hd          , Dd          , Ds          , Rd          , Rd          , Dd          , Dd          , Dd          , Dd          , Dd          , Dd          , Ww          , Wwf         , Ww          , Dd          , Dd          , Hd          , Ds          , Ds          , Wwf         , Gs          , Ds          , Ds          , Ds          , Ce          , Ce          , Ce          , Ds          , Dd          , Dd          , Dd          , Hd          , Dd          , Dd          
Md^Xm       , Md^Xm       , Md^Xm       , Md          , Hd          , Hd          , Rd          , Dd          , Ds          , Ds          , Rd          , Rd          , Hd          , Dd          , Ds          , Ds          , Rd          , Rd          , Dd          , Ww          , Ww          , Ds          , Ds          , Ds          , Hd          , Gs          , Gs          , Dd          , Ds          , Ds          , Rd          , Ds          , Ce          , 3 Ke        , Ce          , Ds          , Dd^Vdt      , Ds          , Rd          , Ds          , Ds          , Ds          
Md          , Md^Xm       , Md          , Md          , Hd          , Hd          , Dd          , Dd          , Ds          , Ds          , Ds          , Hd          , Md          , Dd          , Hd          , Hd          , Ds          , Rd          , Rd          , Dd          , Wwf         , Ww          , Ds          , Ds          , Ds          , Gs          , Dd          , Dd          , Rd          , Dd^Vdt      , Dd          , Ds          , Ds          , Ce          , Dd          , Ds          , Rd          , Ds          , Rd          , Ds^Zi       , Ds          , Ds          
Hd          , Md          , Md          , Hd          , Hd          , Dd          , Rd          , Dd          , Dd          , Dd          , Hd          , Hd          , Md          , Hd          , Hd          , Hd          , Ds          , Dd          , Dd          , Dd          , Ds          , Ww          , Wwf         , Ds          , Ds          , Hd          , Ds          , Dd          , Rd          , Dd          , Dd^Zi       , Rd          , Rd          , Ds          , Dd^Vdt      , Dd          , Ds          , Rd          , Ds          , Rd          , Rd          , Ds          
Hd          , Hd          , Hd          , Hd          , Ds          , Ds          , Ds          , Dd          , Ds          , Hd          , Md          , Md          , Md          , Hd          , Hd          , Hd          , Hd          , Dd          , Dd          , Dd          , Dd          , Dd          , Ds          , Wwf         , Wwf         , Ds          , Ds          , Dd          , Dd          , Dd          , Rd          , Dd          , Dd          , Dd          , Ds          , Dd          , Ds          , Ds          , Ds          , Ds          , Ds          , Rd          
