border_size=1
usage=map

Mm^Xm       , Mm^Xm       , Mm^Xm       , Mm^Xm       , Mm^Xm       , Mm^Xm       , Mm^Xm       , Mm^Xm       , Mm          , Mm          , Mm          , Mm          , Mm          , Mm          , Mm          , Mm          , Mm          , Mm          , Mm          , Mm          , Mm          , Mm          , Hh          , Hh          , Hh          , Gg          , Ggf         , Gg          , Rp          , Hh          , Hh          , Mm          , Mm          , Mm          , Mm          , Mm          , Mm          , Mm          , Mm          , Mm          , Mm          , Mm          
Mm^Xm       , Mm^Xm       , Mm^Xm       , Mm          , Mm          , Mm          , Mm          , Mm          , Mm          , Mm          , Hh          , Gs^Fp       , Gs^Fp       , Mm          , Mm          , Mm          , Mm          , Mm          , Mm          , Mm          , Mm          , Mm          , Mm          , Hh          , Hh          , Gs^Fp       , Gg          , Gs^Fp       , Rp          , Hh          , Gg^Ve       , Mm          , Hh          , Mm          , Mm          , Mm          , Mm^Xm       , Mm^Xm       , Mm          , Mm          , Mm^Xm       , Mm^Xm       
Mm^Xm       , Mm^Xm       , Mm^Xm       , Mm^Xm       , Mm^Xm       , Mm          , Mm          , Mm          , Mm          , Mm          , Mm          , Hh          , Cv          , Gs^Fp       , Gs^Fp       , Gs^Fp       , Hh          , Hh          , Mm          , Mm          , Mm          , Hh          , Gs^Ft       , Hh          , Hh          , Gs^Ft       , Gs^Fp       , Ggf         , Rp          , Hh          , Hh          , Mm          , Hh          , Hh          , Hh          , Mm          , Mm          , Mm^Xm       , Mm          , Mm          , Mm^Xm       , Mm^Xm       
Mm^Xm       , Mm^Xm       , Mm          , Mm          , Mm          , Mm          , Mm^Xm       , Mm^Xm       , Mm          , Mm          , Mm          , Hh          , Hh          , Gg^Ve       , Hh          , Gg^Fet      , Hh          , Hh          , Mm          , Cv          , Cv          , Hh          , Hh          , Gs^Fp       , Gs^Ft       , Gs^Ft       , Ggf         , Cv          , Cv          , Gs^Fp       , Hh          , Mm          , Hh          , Gs^Fp       , Hh          , Gs^Ft       , Mm          , Mm          , Mm^Xm       , Mm^Xm       , Mm^Xm       , Mm^Xm       
Mm^Xm       , Mm          , Mm          , Mm          , Mm^Xm       , Mm^Xm       , Mm^Xm       , Mm          , Mm          , Mm^Xm       , Mm          , Mm          , Mm          , Hh          , Gs^Fp       , Hh          , Mm          , Mm          , Mm          , Cv          , Hh          , Gg^Fet      , Gs^Fp       , Gs^Fp       , Gs^Fp       , Gs^Fp       , Rp          , Rp          , Hh          , Gs^Fp       , Cv          , Hh          , Gs^Fp       , Gs^Fp       , Gs^Fp       , Gs^Ft       , Hh          , Mm          , Mm^Xm       , Mm^Xm       , Mm^Xm       , Mm^Xm       
Mm^Xm       , Mm^Xm       , Mm          , Mm^Xm       , Mm^Xm       , Mm^Xm       , Mm^Xm       , Mm^Xm       , Mm          , Mm          , Mm          , Mm          , Mm          , Mm          , Mm          , Mm          , Mm          , Mm          , Mm          , Mm          , Hh          , Gs^Fp       , Gg^Ve       , Gs^Fp       , Gs^Fp       , Gs^Ft       , Hh          , Gs^Fp       , Hh          , Cv          , Hh          , Gg^Ve       , Gs^Fp       , Gs^Ft       , Gs^Fp       , Hh          , Hh          , Mm          , Mm          , Mm          , Mm^Xm       , Mm^Xm       
Mm^Xm       , Mm          , Mm          , Mm^Xm       , Mm^Xm       , Mm^Xm       , Mm^Xm       , Mm^Xm       , Mm          , Mm^Xm       , Mm^Xm       , Mm          , Mm^Xm       , Mm^Xm       , Mm^Xm       , Mm          , Mm          , Mm          , Mm          , Mm          , Mm          , Hh          , Ggf         , Ggf         , Gs^Fp       , Gs^Ft       , Gs^Fp       , Hh          , Gs^Fp       , Hh          , Gs^Fp       , Gs^Fp       , Hh          , Gs^Fp       , Gs^Ft       , Hh          , Mm          , Mm          , Mm^Xm       , Mm          , Mm^Xm       , Mm^Xm       
Mm^Xm       , Mm          , Mm          , Mm          , Mm          , Mm          , Mm          , Mm          , Mm          , Mm^Xm       , Mm^Xm       , Mm^Xm       , Mm^Xm       , Mm^Xm       , Mm^Xm       , Mm^Xm       , Mm^Xm       , Mm          , Mm          , Mm          , Mm          , Cv          , Hh          , Gs^Fp       , Gs^Fp       , Rp          , Gs^Fp       , Hh          , Mm          , Gs^Fp       , Mm          , Gs^Fp       , Gg^Fet      , Gs^Ft       , Mm          , Mm          , Mm^Xm       , Mm^Xm       , Mm          , Mm          , Mm^Xm       , Mm^Xm       
Mm^Xm       , Mm          , Mm^Xm       , Mm^Xm       , Mm^Xm       , Mm^Xm       , Mm^Xm       , Mm^Xm       , Mm          , Mm          , Mm          , Mm          , Mm          , Mm^Xm       , Mm          , Mm          , Mm          , Mm          , Mm          , Mm          , Hh          , Hh          , Gs^Ft       , Gs^Fp       , Rp          , Rp          , Gs^Fp       , Hh          , Mm          , Cv          , Mm          , Gs^Fp       , Gs^Fp       , Gs^Ft       , Gs^Fp       , Mm          , Mm          , Mm          , Mm          , Mm^Xm       , Mm^Xm       , Mm^Xm       
Mm^Xm       , Mm^Xm       , Mm^Xm       , Mm          , Mm^Xm       , Mm^Xm       , Mm          , Mm          , Mm          , Mm          , Cv          , Mm          , Mm          , Mm          , Mm          , Mm          , Gs^Ft       , Mm          , Hh          , Hh          , Rp          , Rp          , Gs^Ft       , Gs^Fp       , Gs^Fp       , Hh          , Gs^Ft       , Hh          , Mm          , Mm          , Mm          , Mm          , Mm          , Mm          , Gs^Fp       , Mm          , Hh          , Mm          , Mm          , Mm^Xm       , Mm^Xm       , Mm^Xm       
Mm^Xm       , Mm^Xm       , Mm          , Mm^Xm       , Mm          , Mm^Xm       , Mm          , Mm          , Gs^Fp       , Gs^Fp       , Cv          , Mm          , Mm          , Mm          , Mm          , Gs^Ft       , Gs^Ft       , Gs^Fp       , Rp          , Gs^Fp       , Gs^Fp       , Gs^Ft       , Mm          , Gs^Fp       , Gs^Fp       , Gs^Fp       , Mm^Xm       , Gg^Fet      , Hh          , Mm          , Mm          , Mm          , Mm          , Gs^Fp       , Mm          , Hh          , Hh          , Hh          , Mm          , Mm^Xm       , Mm^Xm       , Mm^Xm       
Wo          , Mm^Xm       , Mm^Xm       , Mm          , Mm^Xm       , Mm^Xm       , Mm^Xm       , Mm          , Gs^Fp       , Gs^Fp       , Gs^Fp       , Hh          , Gs^Fp       , Gg^Fet      , Gs^Fp       , Gs^Fp       , Gs^Ft       , Rp          , Gs^Fp       , Gs^Fp       , Cv          , Hh          , Mm^Xm       , Mm^Xm       , Mm^Xm       , Mm^Xm       , Mm^Xm       , Mm^Xm       , Mm^Xm       , Mm^Xm       , Mm^Xm       , Mm^Xm       , Mm^Xm       , Mm^Xm       , Mm^Xm       , Mm^Xm       , Mm^Xm       , Mm^Xm       , Mm^Xm       , Mm^Xm       , Mm^Xm       , Mm^Xm       
Wo          , Wo          , Wo          , Mm^Xm       , Mm^Xm       , Mm          , Mm^Xm       , Mm^Xm       , Mm          , Mm          , Gs^Fp       , Hh          , Gs^Ft       , Gs^Fp       , Gs^Fp       , Gs^Ft       , Gg^Ve       , Gs^Fp       , Gs^Fp       , Cv          , 1 Kv        , Cv          , Mm^Xm       , Mm^Xm       , Mm^Xm       , Mm^Xm       , Mm          , Mm          , Mm^Xm       , Mm^Xm       , Mm^Xm       , Mm^Xm       , Mm^Xm       , Mm^Xm       , Mm^Xm       , Mm^Xm       , Mm^Xm       , Mm^Xm       , Mm          , Mm^Xm       , Mm          , Mm          
Wo          , Wo          , Wo          , Mm          , Mm^Xm       , Mm          , Mm^Xm       , Mm^Xm       , Mm          , Mm          , Mm          , Gs^Ft       , Gs^Ft       , Gs^Fp       , Gs^Fp       , Gs^Fp       , Gs^Fp       , Rp          , Gs^Ft       , Cv          , Cv          , Cv          , Mm^Xm       , Mm          , Mm          , Mm          , Mm          , Mm          , Mm          , Mm^Xm       , Mm          , Mm          , Mm          , Mm          , Mm          , Mm          , Mm          , Mm          , Chr         , Mm          , Mm          , Mm^Xm       
Mm^Xm       , Wo          , Wo          , Wo          , Mm^Xm       , Mm^Xm       , Mm^Xm       , Mm^Xm       , Mm          , Mm          , Mm          , Cv          , Mm          , Hh          , Hh          , Gs^Ft       , Gs^Fp       , Rp          , Rp          , Hh          , Hh          , Gs^Fp       , Hh          , Mm          , Mm          , Mm^Xm       , Mm          , Mm          , Mm          , Mm          , Mm          , Mm          , Mm          , Mm          , Mm          , Mm          , Hh          , Hh          , Hh          , Mm          , Mm          , Mm^Xm       
Mm^Xm       , Mm^Xm       , Wo          , Ww          , Ww          , Mm^Xm       , Mm          , Mm^Xm       , Mm^Xm       , Mm          , Mm          , Mm          , Mm          , Cv          , Mm          , Gs^Ft       , Gs^Ft       , Gs^Ft       , Gs^Fp       , Rp          , Rp          , Gs^Ft       , Hh          , Mm          , Mm^Xm       , Mm          , Mm          , Hh          , Hh          , Mm          , Gs^Ft       , Gs          , Mm          , Mm          , Mm          , Mm          , Hh          , Mm          , Mm          , Hh          , Mm^Xm       , Mm^Xm       
Md          , Md^Xm       , Md^Xm       , Ww          , Ww          , Wwf         , Md^Xm       , Md^Xm       , Md^Xm       , Md^Xm       , Mm^Xm       , Mm^Xm       , Mm^Xm       , Mm          , Mm          , Mm^Xm       , Mm          , Hh          , Hh          , Gs^Ft       , Hh          , Rr          , Dd          , Mm          , Mm          , Mm          , Gs^Ft       , Hh          , Hd          , Gs^Ft       , Md          , Gs^Ft       , Gs          , Mm          , Mm          , Mm          , Gs^Ft       , Hh          , Hh          , Hh          , Mm^Xm       , Mm^Xm       
Md          , Md^Xm       , Md          , Md^Xm       , Ww          , Ww          , Md          , Md^Xm       , Md^Xm       , Mm^Xm       , Md^Xm       , Mm^Xm       , Md^Xm       , Mm^Xm       , Md^Xm       , Mm          , Md^Xm       , Md          , Gg^Fet      , Gs^Ft       , Hh          , Rr          , Rr          , Md^Xm       , Md^Xm       , Chr         , Gs^Ft       , Gs^Ft       , Hd          , Hd          , Rd          , Gs          , Hd          , Gs^Ft       , Md^Xm       , Mm          , Gs^Ft       , Mm          , Hh          , Hh          , Hh          , Mm^Xm       
Md          , Md          , Hd          , Md          , Ww          , Wwf         , Ds          , Md          , Md          , Md^Xm       , Md^Xm       , Md^Xm       , Md^Xm       , Md^Xm       , Md          , Md^Xm       , Md          , Md          , Hd          , Hd          , Hd          , Hd          , Md          , Rr          , Ds          , Hd          , Hd          , Hd          , Rd          , Dd^Vda      , Rd          , Rd          , Hd          , Rd          , Hd          , Gs^Ft       , Hd          , Hh          , Gs^Ft       , Gs^Ft       , Hd          , Md          
Hd          , Md          , Hd          , Hd          , Wwf         , Wwf         , Ww          , Ds          , Ds          , Md          , Ds          , Md          , Md          , Md          , Md          , Md          , Md          , Hd          , Hd          , Chr         , Hd          , Dd^Vda      , Dd          , Rr          , Hd          , Ds          , Ds          , Hd          , Rd          , Rd          , Md          , Md          , Hd          , Dd          , Hd          , Md          , Md          , Hd          , Gs^Ft       , Hd          , Md          , Md          
Ds          , Hd          , Md          , Hd          , Ds          , Ww          , Wwf         , Ww          , Ww          , Ds          , Ww          , Ds          , Ds          , Md          , Md          , Md          , Chr         , Md          , Hd          , Gs^Ft       , Hd          , Hd          , Rd          , Hd          , Hd          , Rd          , Hd          , Md          , Rd          , Hd          , Md          , Md^Xm       , Rd          , Rd          , Dd          , Dd^Vda      , Dd          , Hd          , Md          , Rd          , Hd          , Md          
Ds          , Hd          , Md          , Md          , Hd          , Ds          , Ds          , Wwf         , Ww          , Wwf         , Ww          , Ww          , Ww          , Md^Xm       , Md          , Md          , Hd          , Md          , Md          , Hd          , Dd          , Dd          , Hd          , Rd          , Rr          , Rd          , Dd          , Dd^Vda      , Ds          , Hd          , Hd          , Md^Xm       , Md^Xm       , Rd          , Md          , Dd          , Md          , Dd          , Rd          , Md          , Hd          , Md          
Hd          , Dd          , Rd          , Md          , Md          , Dd          , Hd          , Md          , Md^Xm       , Hd          , Hd          , Wwf         , Ww          , Ds          , Md^Xm       , Md^Xm       , Md          , Hd          , Hd          , Hd          , Dd^Vda      , Gs^Ft       , Hd          , Dd          , Rr          , Hd          , Hd          , Rd          , Rd          , Ds          , Md          , Md          , Md          , Md          , Md          , Md          , Hd          , Rd          , Rd          , Hd          , Dd          , Dd          
Md          , Hd          , Hd          , Dd          , Hd          , Dd          , Hd          , Md          , Md^Xm       , Md^Xm       , Ds          , Ww          , Wwf         , Ds          , Ds          , Md^Xm       , Md          , Md          , Hd          , Hd          , Hd          , Hd          , Rd          , Dd          , Dd          , Rr          , Hd          , Hd          , Gs          , Ds          , Gs^Ft       , Ds          , Ds          , Ds          , Gs          , Hd          , Ds          , Ds          , Hd          , Hd          , Dd          , Dd          
Md          , Md          , Md          , Md          , Md          , Rd          , Rd          , Md          , Md^Xm       , Md^Xm       , Md          , Ww          , Ww          , Wwf         , Ww          , Ds          , Ds          , Md^Xm       , Md          , Md          , Hd          , Md          , Dd          , Hd          , Gs          , Rd          , Ds          , Dd          , Dd          , Gs          , Gs^Ft       , Hh          , Gs^Ft       , Hh          , Gs          , Ds          , Dd          , Dd^Vdt      , Hd          , Hd          , Dd          , Dd          
Md          , Hd          , Hd          , Md          , Md          , Rd          , Ds          , Md          , Md          , Md          , Md^Xm       , Md          , Md          , Wwf         , Ww          , Ww          , Ww          , Ds          , Md          , Md          , Md          , Md          , Ds          , Dd          , Gs          , Rd          , Rd          , Hd          , Dd          , Ds          , Ds          , Hh          , Hh          , Wwf         , Wwf         , Gs^Ft       , Gs          , Dd          , Gs          , Gs          , Wwf         , Ww          
Hd          , Hd          , Hd          , Hd          , Md          , Md          , Ds          , Hd          , Ds          , Dd          , Md^Xm       , Md^Xm       , Md^Xm       , Md          , Ds          , Wwf         , Wwf         , Ds          , Md^Xm       , Md          , Md          , Hd          , Ds          , Dd          , Hd          , Rd          , Rd          , Dd          , Ds          , Hh          , Dd^Vdt      , Hh          , Hh          , Ww          , Ww          , Gs^Ft       , Ww          , Gs          , Ww          , Wwf         , Hh          , Hh          
Hd          , Hd          , Hd          , Hd          , Md          , Md          , Md          , Hd          , Ds          , Ds          , Dd          , Md^Xm       , Md          , Md^Xm       , Ds          , Wwf         , Wwf         , Ds          , Dd          , Md          , Md          , Hd          , Md          , Dd          , Dd          , Gs          , Hh          , Rd          , Gs          , Hh          , Ds          , Ds          , Gs          , Wwf         , Ww          , Ww          , Ww          , Wwf         , Wwf         , Hh          , Dd^Vdt      , Gs          
Hd          , Hd          , Hd          , Hd          , Hd          , Ds          , Ds          , Ds          , Rd          , Rd          , Hd          , Md          , Md          , Md^Xm       , Ds          , Ww          , Ww          , Ww          , Ds          , Md          , Md          , Md          , Md          , Hh          , Hh          , Gs^Ft       , Hh          , Hh          , Gs          , Dd^Vdt      , Hh          , Gs^Ft       , Wwf         , Wwf         , Ww          , Gs^Ft       , Hh          , Ww          , Wwf         , Ww          , Ww          , Gs          
Hd          , Dd          , Md          , Hd          , Hd          , Dd          , Dd          , Hd          , Dd          , Rd          , Dd          , Hd          , Hd          , Md          , Md          , Ds          , Ww          , Wwf         , Wwf         , Ds          , Ds          , Md          , Gs          , Gs          , Gs          , Hh          , Gs          , Gs^Ft       , Gs          , Hh          , Wwf         , Gs          , Ww          , Ww          , Hh          , Gs          , Dd^Vdt      , Ds          , Ce          , Ce          , Ce          , Hd          
Md          , Md          , Md          , Hd          , Hd          , Dd          , Hd          , Hd          , Dd          , Ds          , Dd          , Dd          , Dd          , Hd          , Hd          , Ds          , Ds          , Ww          , Ww          , Ww          , Ww          , Dd          , Wwf         , Ww          , Ww          , Wwf         , Wwf         , Gs          , Ww          , Wwf         , Ww          , Ww          , Wwf         , Ww          , Gs          , Gs          , Dd          , Ds          , Ce          , 2 Ke        , Hd          , Hd          
Md          , Md          , Md          , Md          , Md          , Hd          , Hd          , Hd          , Hd          , Hd          , Dd          , Dd          , Rd          , Hd          , Dd          , Dd          , Dd          , Ds          , Ds          , Wwf         , Ww          , Ww          , Wwf         , Ww          , Ds          , Ww          , Wwf         , Ww          , Ww          , Wwf         , Gs          , Gs          , Ds          , Ds          , Dd^Vdt      , Rd          , Ds          , Dd          , Ce          , Hd          , Dd          , Dd          
Md          , Md          , Md          , Md          , Md          , Hd          , Dd          , Hd          , Hd          , Dd          , Ds          , Rd          , Rd          , Dd          , Dd          , Dd          , Dd          , Dd          , Dd          , Ww          , Wwf         , Ww          , Dd          , Dd          , Hd          , Dd          , Dd          , Wwf         , Rd          , Ds          , Ds          , Ds          , Ce          , Ce          , Ce          , Rd          , Dd          , Hd          , Hd          , Hd          , Dd          , Dd          
Ds          , Ds          , Ds          , Ds          , Rd          , Rd          , Rd          , Dd          , Ds          , Ds          , Rd          , Rd          , Hd          , Dd          , Ds          , Ds          , Rd          , Rd          , Dd          , Ww          , Ww          , Ds          , Ds          , Ds          , Hd          , Rd          , Rd          , Dd          , Dd          , Rd          , Ds          , Ds          , Ce          , 3 Ke        , Ce          , Rd          , Dd^Vdt      , Ds          , Rd          , Ds          , Ds          , Ds          
Ds          , Dd          , Dd          , Dd          , Rd          , Rd          , Dd          , Dd          , Ds          , Ds          , Ds          , Hd          , Md          , Dd          , Hd          , Hd          , Ds          , Rd          , Rd          , Dd          , Wwf         , Ww          , Ds          , Ds          , Ds          , Rd          , Dd          , Dd          , Rd          , Dd^Vdt      , Dd          , Ds          , Rd          , Ce          , Dd          , Ds          , Rd          , Ds          , Rd          , Ds          , Ds          , Ds          
Hd          , Dd          , Hd          , Dd          , Hd          , Dd          , Rd          , Dd          , Dd          , Dd          , Hd          , Hd          , Md          , Hd          , Hd          , Hd          , Ds          , Dd          , Dd          , Dd          , Ds          , Ww          , Wwf         , Ds          , Ds          , Hd          , Ds          , Dd          , Rd          , Dd          , Dd          , Rd          , Rd          , Dd          , Dd^Vdt      , Dd          , Ds          , Rd          , Ds          , Rd          , Rd          , Ds          
Hd          , Hd          , Hd          , Hd          , Ds          , Ds          , Ds          , Dd          , Ds          , Hd          , Md          , Md          , Md          , Hd          , Hd          , Hd          , Hd          , Dd          , Dd          , Dd          , Dd          , Dd          , Ds          , Wwf         , Wwf         , Ds          , Ds          , Dd          , Dd          , Dd          , Rd          , Dd          , Dd          , Dd          , Ds          , Dd          , Ds          , Ds          , Ds          , Ds          , Ds          , Rd          
