Mm^Xm, Mm^Xm, Mm^Xm, Mm, Mm, Mm, Hh, Hh, Hh, Hh, Hh^Fp, Gll^Fp, Gs^Fms, Gs^Fp, Rp, Gs^Fms, Gg^Es, Gs^Fms, Ww, Wo, Wo, Ww, Gs^Fms, Gg, Gg, Rp, Gs^Fms, Gs^Fms, Gs^Fms, Gs^Fms, Hh, Hh, Mm^Xm, Mm, Mm, Mm^Xm, Mm^Xm
Mm^Xm, Mm^Xm, Mm, Mm, Mm, Mm, Hh, Hh^Fp, Gs, Hh, Gg^Ve, Gll^Fp, Gs^Fet, Rp, Gg, Gs^Fms, Ww, Ww, Wo, Wo, Ww, Wwf, Gs^Fms, Gs^Fms, Gg, Rp, Gll^Fp, Gll^Fp, Gs^Fms, Gs, Gs^Fms, Hh, Mm, Mm, Mm^Xm, Mm^Xm, Mm
Mm, Mm, Mm, Hh^Fp, Gg^Ve, Hh, Gs, Gll^Fp, Rp, Gs, Gll^Fp, Gll^Fp, Rd, Rp, Wwf, Wwf, Ww, Wo, Ww, Ww, Wwf, Gll^Fp, Gll^Fp, Gll^Fp, Gs, Rp, Gs^Fds, Gll^Fp, Gll^Efm, Gs^Fms, Gs^Fms, Hh, Mm, Mm, Mm, Mm^Xm, Mm
Mm, Mm^Xm, Mm, Hh, Gs^Fp, Rp, Re, Rp, Gll^Fp, Gs, Gll^Fp, Gs^Fms, Rd, Gg^Fms, Wwf, Wwf, Wwf, Ww, Gg^Fet, Gg^Fds, Gg^Fds, Gs^Fds, Gs, Gs^Es, Gs, Rp, Gs, Gs^Fds, Gs, Gs^Es, Gg, Hh, Hh, Mm, Mm, Mm, Mm^Xm
Mm, Mm, Gll^Fp, Hh, Gs, Rp, Gs^Fp, Gs^Fet, Gll^Fp, Gll^Fp, Rp, Rd, Wwf, Wwf, Wo, Wwf, Gg, Gg, Gg^Fds, Gg^Fds, Gs^Fds, Gs^Fds, Gs, Gs^Ve, Gs, Rp, Gs^Fet, Gs, Gs, Gg, Gll^Fp, Gg, Hh, Hh, Hh, Mm, Mm
Hh, Hh, Gll^Fp, Gs^Fp, Gs, Rp, Gs, Gs, Gll^Fp, Rp, Gg^Fp, Gg^Fms, Ww, Ww, Wo, Ww, Ss, Gg, Gg, Gg^Fds, Gs, Gg^Fds, Ss, Gs^Fds, Rr, Rp, Gs, Gs^Es, Gg^Efm, Gll^Fp, Gg, Gs^Fms, Gs^Fms, Gs^Fms, Hh, Mm, Mm
Hh, Gll^Fp, Gs, Gs, Gs, Gll^Fp, Gs, Gll^Fp, Rd, Rd, Ww^Bsb\, Ww, Ww, Wo, Ww, Wo, Wo, Ss, Gg, Wwf, Cv, Wwf, Cv, Gs^Fp, Rr, Rr, Gs, Gs^Fds, Gs^Efm, Gg, Gll^Fp, Gs^Fms, Gg, Gs^Fms, Hh, Mm, Mm
Hh^Fp, Gs, Hh, Gs^Fp, Rp, Rp, Gg, Rp, Gg, Gs^Fms, Ww, Ww^Bsb\, Rp, Ww, Gs^Fp, Ww, Ss, Ww, Ww, Wwf, Wwf, Cv, 2 Kv, Cv, Rr, Rr, Gs, Gs^Fds, Gs^Fds, Gs^Fds, Gs^Fds, Gll^Fp, Hh, Hh, Mm, Mm, Mm^Xm
Hh^Fp, Gs, Gg^Fet, Rd, Gg^Ve, Gs^Fp, Gg, Gg, Wwf, Wwf, Wo, Ww, Cv, Gg^Ve, Gg^Fet, Gs^Fp, Gs^Fp, Ss, Wwf, Wwf, Wwf, Cv, Cv, Cv, Cv, Rp, Gg^Ve, Gs, Gs^Fds, Gll^Fp, Gll^Fp, Gg, Hh, Mm, Mm, Mm, Mm^Xm
Gll^Fp, Gs, Rp, Gll^Fp, Gll^Fp, Gs, Gs^Fp, Gs^Fp, Ww, Wo, Wo, Cv, 1 Kv, Cv, Rp, Gll^Fp, Gll^Fp, Gs^Fp, Gg, Ww, Rr, Cv, Rr, Rr, Rr, Gg, Gg, Gg, Gs, Gs^Fds, Gs, Gll^Fp, Hh, Hh, Mm, Mm^Xm, Mm^Xm
Gll^Fp, Rp, Gll^Fp, Gll^Fp, Gs, Gs, Gs, Ww^Es, Wo, Wo, Ww, Cv, Cv, Cv, Cv, Rp, Rp, Rr, Rr, Rr, Gs^Fds, Rr, Gg^Ve, Rr, Rr, Gs^Fds, Gll^Fp, Gg, Gg, Gs^Fds, Gs^Fds, Hh^Fp, Hh, Mm, Mm, Mm^Xm, Mm^Xm
Rp, Rp, Gs^Fp, Gs^Fp, Gs, Gs, Wwf, Ww, Wo, Ww, Gg^Ve, Rr, Rd, Gs^Fp, Rp, Rp, Gs^Fms, Gll^Fp, Rr, Rr, Gs^Fds, Gs^Fds, Gs^Fds, Gll^Fp, Gll^Fp, Rr, Rr, Gll^Fp, Gs^Fds, Gs^Fds, Gs^Fds, Hh, Mm, Mm^Xm, Mm, Mm^Xm, Mm
Hh, Hh^Fp, Hh, Gs, Gs, Gs^Fp, Ww, Wo, Ww, Ww, Rr, Rr, Gs^Fp, Gg, Rp, Gg^Ve, Gs^Fms, Gll^Fp, Gs^Fms, Rr, Gg^Efm, Gs^Fds, Gll^Fp, Gs^Fds, Gs^Fds, Rr, Rr, Gs, Gs^Fds, Gs^Fds, Hh, Hh, Mm, Mm^Xm, Mm, Mm, Mm
Hh, Gll^Fp, Gll^Fp, Gs, Wwf, Ww, Wo, Wo, Gs^Fp, Gs^Fds, Rr, Gs^Fp, Gg^Efm, Gg, Rp, Gs^Efm, Gs^Fms, Gs^Fp, Gs^Fp, Rr, Gg, Gg, Gg, Gll^Fp, Gll^Fp, Gs^Fds, Rr, Gs^Fds, Gg^Ve, Gg^Fet, Hh, Mm, Mm, Hh, Hh, Mm, Mm
Hh^Fp, Hh^Fp, Gs, Gs, Wwf, Ww, Ww, Ww, Gll^Fp, Gll^Fp, Rr, Gg^Fet, Rr, Rp, Gs, Gs^Fms, Gs^Fms, Gs, Gg, Rp, Rp, Gs^Fp, Gg^Ve, Gll^Fp, Gg, Gs^Fds, Gs^Fds, Rp, Rp, Gg, Gg, Mm, Mm, Mm, Hh, Mm, Mm
Hh, Hh, Wwf, Wwf, Wwf, Wwf, Gg, Gg^Ve, Gll^Fp, Gll^Fp, Rr, Rr, Gs^Fms, Gs^Fds, Gs, Gll^Fp, Gll^Fp, Gs, Gs^Fms, Gs^Fms, Gs^Fms, Rp, Gs^Fds, Gg^Fet, Gll^Fp, Gll^Fp, Rp, Rp, Rp, Hh, Gs^Fds, Gg, Hh^Fp, Hh, Mm, Mm, Mm^Xm
Ww, Ww, Ww, Wwf, Gg^Fet, Gg^Fp, Gs^Fds, Gs^Fms, Gs, Gs^Fds, Gs^Fms, Rr, Rr, Gs, Gll^Fp, Gll^Fp, Ww, Ww, Ww, Gs^Fds, Gs^Fms, Rp, Gs^Fds, Gll^Fp, Gs^Fms, Gs^Fms, Rp, Gll^Fp, Rp, Rp, Gs^Fp, Hh, Hh^Fp, Hh, Mm, Mm^Xm, Mm^Xm
Wo, Wo, Wwf, Wwf, Gg^Ve, Gg^Fp, Gll^Fp, Gs^Fds, Gs, Gs^Fds, Gs, Gg, Rr, Gll^Fp, Gs^Fet, Gll^Fp, Ww, Ww, Ww, Ww, Gs^Fds, Rp, Gs^Fds, Gg, Gs^Fms, Rp, Rp, Gll^Fp, Gs^Fds, Rp, Gs^Es, Gg^Ve, Gg, Hh, Mm, Mm, Mm
Ww, Ww, Gs, Gs, Hh, Gs^Fp, Gll^Fp, Gs^Fds, Gs^Fms, Gs^Fp, Gs, Gg, Rr, Gs^Fp, Gll^Fp, Gll^Fp, Gll^Fp, Ww, Ww, Ww, Gs^Fds, Gs^Fms, Gs^Fds, Gs^Fms, Rp, Rp, Gs^Fms, Gs^Fms, Gs^Fds, Rp, Gg, Gg, Hh^Fp, Hh, Mm^Xm, Mm, Mm
Hh, Hh, Hh, Hh, Hh, Hh, Gs, Gll^Fp, Gs, Gs^Fp, Gg, Gg, Rr, Gs, Gg, Gll^Fp, Gg^Ve, Gs^Fp, Wwf, Wwf, Gs^Fds, Rp, Gs^Fms, Gs^Fds, Gll^Fp, Gll^Fp, Gs^Fms, Gg^Fet, Gg^Fp, Rp, Hh, Hh, Hh, Mm, Mm, Mm, Mm^Xm
Hh, Hh, Gg^Ve, Gs^Fp, Hh, Hh, Hh, Gs, Gs^Fp, Gs^Fp, Gll^Fp, Gg^Fp, Rp, Gg, Gs^Fp, Gll^Fp, Ww, Gll^Fp, Wwf, Ww, Gs^Fms, Gll^Fp, Gs^Fms, Gs, Gs^Fds, Gll^Fp, Gg, Gg^Ve, Rp, Rp, Gg, Hh, Mm, Mm^Xm, Mm, Mm^Xm, Mm^Xm
Hh, Gs^Fp, Gg, Ww, Hh, Gg, Gg, Gs, Rp, Rp, Rp, Rp, Rp, Gs^Fp, Gg, Wwf, Ww, Ww, Wwf, Ww, Gg, Gll^Fp, Gs^Fp, Gs^Fms, Gs^Fms, Gll^Fp, Gll^Fp, Gg^Efm, Rp, Gg, Gg, Hh, Hh^Fms, Mm, Mm, Mm, Mm
Hh^Fp, Hh, Gs^Fp, Hh, Hh, Gg^Fet, Rd, Rp, Gs^Fp, Gg^Ve, Gs, Gg^Fp, Gg, Rp, Rd, Gg, Gg, Gg, Gg^Efm, Gg, Gg, Gll^Fp, Gs, Gs, Gs^Fms, Gs^Fms, Gll^Fp, Gg, Gs^Fms, Gs^Fms, Gs^Fms, Gs^Fms, Hh^Fms, Hh, Mm, Mm, Mm^Xm
Hh^Fp, Gs^Fp, Gs, Gs, Gs, Rd, Gs^Ecf, Gs^Fp, Gs, Gs, Gs, Gg, Gg, Gg, Gg^Efm, Gg, Gg, Gg, Gg, Gg^Efm, Gg, Gs^Fds, Gs, Gs, Gs^Fms, Gs^Fet, Rp, Rp, Gg, Gll^Fp, Gll^Fp, Gg^Ve, Hh, Hh, Mm, Mm^Xm, Mm^Xm
Hh, Hh, Gs^Ecf, Cer, Cer, Rd, Gs, Gs, Gs^Fp, Gs^Fp, Gs, Gg^Ve, Gg, Gg, Gg, Gg, Gg, Gg, Gg^Efm, Gg^Efm, Gg, Gs, Gg, Gs, Gg^Ve, Gg, Rp, Gg^Es, Gs^Fms, Gll^Fp, Gs^Fms, Hh, Mm, Mm, Mm^Xm, Mm^Xm, Mm^Xm
Hh, Hh, Gs, Cer, 3 Ke, Cer, Rd, Gs, Gs, Gs^Fp, Gs, Gs, Gg^Fp, Gg, Gg, Gg^Efm, Hh, Gg, Gg, Gg, Gg^Efm, Gg, Rp^Es, Gg, Gg, Gg, Gg, Gs^Fms, Gll^Fp, Gs^Fet, Gll^Fp, Mm, Mm, Mm, Mm, Mm, Mm^Xm
Mm, Gg^Ve, Gs^Fp, Gs, Gs^Ecf, Cer, Cer, Gs^Ecf, Gs^Fp, Gs, Gg, Gg, Gs, Gg, Hh, Gg, Gg, Hh, Gg, Gg, Gs^Fds, Gg^Efm, Gs^Fds, Rp, Gs, Gs, Gs, Gs^Fds, Gll^Fp, Gll^Fp, Gll^Fp, Mm, Mm^Xm, Mm, Mm, Mm, Mm
Mm^Xm, Hh, Hh, Gs^Fp, Gs, Cer, Rd, Gs, Gg, Gg, Hh^Fp, Gs^Fp, Gs, Hh, Mm, Mm^Xm, Mm, Hh, Hh, Hh, Gs, Gs^Fds, Gs, Gs, Gs, Gs^Ecf, Cer, Gs, Gg^Ecf, Gs^Fds, Hh, Mm, Mm, Mm, Mm, Mm, Mm
Mm^Xm, Mm, Mm, Hh, Gs^Fp, Gs, Rd, Gs^Fp, Gg^Ve, Hh, Gs, Gs, Cer, Gs, Hh, Mm, Hh, Hh, Gg^Ve, Hh^Fp, Gs^Fds, Gs^Es, Gs, Gs, Cer, Cer, 4 Ke, Cer, Gs, Gg, Mm, Mm, Mm, Mm, Mm^Xm, Mm, Mm^Xm
Md, Md, Md, Hh, Hh, Gs^Fp, Rd, Gs, Gs, Hh, Gs^Ecf, Cer, 5 Ke, Cer, Gs, Hh, Gs^Fds, Hh, Gg, Gs^Fds, Gs^Fds, Gs, Gg^Ve, Gs, Gs^Ecf, Cer, Cer, Cer, Gs, Hh, Mm, Mm, Mm, Mm^Xm, Mm^Xm, Mm^Xm, Mm^Xm
Md, Md, Md, Hh, Hh, Hh, Gs^Fds, Re, Re, Gs^Es, Gs, Cer, Cer, Cer, Gs^Ecf, Gs^Fds, Gll^Fp, Hh, Gs^Fds, Gg, Gg, Gg, Gs, Gs^Fds, Gs^Fds, Gs, Gs, Gs, Hh, Hh, Mm^Xm, Mm, Mm, Mm^Xm, Mm, Mm, Mm
Mm, Mm, Md, Hhd, Md, Hh, Mm, Hh, Gs^Fds, Rd, Rr, Gs, Gs^Es, Gs^Es, Gs, Gs^Fds, Gll^Fp, Gs^Fds, Gs^Fds, Gg, Gg, Gg, Gs, Gs^Fds, Gg^Ve, Hh, Gll^Fp, Hh, Hh, Mm, Mm, Mm, Mm, Mm^Xm, Mm^Xm, Mm, Mm^Xm
Mm^Xm, Md, Md, Md, Md, Md, Gs^Fds, Gs^Fds, Hh, Re, Rr, Gs^Ecf, Gs, Gs^Ve, Gs^Fds, Gs^Fds, Gs^Fds, Gll^Fp, Gg, Gg, Gs^Fp, Gs^Fds, Gs^Fds, Gg^Fet, Hh, Gs^Fp, Gll^Fp, Gs^Fds, Gs^Fds, Gll^Fp, Gll^Fp, Hh, Mm, Mm, Mm^Xm, Mm^Xm, Mm^Xm
Ww, Mm^Xm, Md, Md, Mm, Mm, Hh, Gg^Fet, Gs^Fds, Hh, Rr, Gs^Es, Gll^Fp, Gll^Fp, Gs, Gs^Fds, Gs^Fds, Gs^Fds, Gs, Gg, Hh, Gs^Fp, Hh, Gs^Fp, Hh, Gll^Fp, Gs^Fds, Gs^Fds, Gll^Fp, Gs^Fms, Gll^Fp, Hh, Mm, Mm, Mm, Mm^Xm, Mm^Xm
Wo, Ww, Mm, Hh, Hh, Hh, Gll^Fp, Gs^Fds, Rr, Rr, Gs, Gs, Hh, Gll^Fp, Gs, Gs^Fds, Gs^Fp, Gll^Fp, Gs^Fp, Hh, Hh^Fp, Hh, Hh, Hh, Hh, Gll^Fp, Gll^Fp, Gg, Gs^Es, Rp^Es, Gs^Fms, Hh, Mm, Mm, Mm, Mm^Xm, Mm^Xm
Wo, Wo, Ww, Mm, Mm, Gll^Fp, Gg^Es, Rr, Gs^Fds, Gs^Fds, Hh, Hh, Hh, Hh, Mm, Hh^Fp, Hh, Gs^Fp, Hh, Hh, Hh^Fp, Hh^Fp, Gs^Fds, Hh, Hh^Fp, Hh^Fp, Hh^Fp, Gs^Fds, Gs^Fds, Rp, Gs^Es, Hh, Hh, Mm, Mm, Mm, Md
Hhd, Wo, Wo, Mm^Xm, Mm, Gs^Fms, Rp, Rp^Es, Mm, Hh, Mm^Xm, Mm, Hh, Hh, Hh, Mm, Hh, Hh, Hh, Hh, Hh^Fp, Hh^Fp, Hh^Fp, Gs^Fms, Hh^Fp, Hh, Hh, Gll^Fp, Gs^Fds, Gs^Fds, Gll^Fp, Hh^Fms, Hh^Fms, Hh^Fp, Hh, Mm, Md
Hhd, Ww, Wo, Mm, Gs^Fms, Hh, Rp, Hh^Fms, Gs^Fp, Mm, Mm, Hh, Mm, Mm, Md, Md, Hh, Hh, Hh, Mm, Gs^Fds, Gs^Fds, Hh^Fms, Hh, Hh, Hh, Mm^Xm, Mm, Cv, Rp, Re, Gs^Fds, Gd^Fms, Gs^Fms, Hh, Mm, Md
Hhd, Ww, Ww, Ww, Wwf, Rp, Gs^Fms, Hh^Fds, Gs^Fp, Mm, Mm, Md^Xm, Md^Xm, Hh, Mm^Xm, Md, Md, Hh, Md, Mm, Gs^Fds, Gd^Fds, Hh, Hh^Fms, Hh, Gs^Fds, Hh, Gs^Fds, Cv, Rp, Gd^Es, Gs^Fms, Gd, Gs^Fms, Hh, Hh, Hh
Mm^Xm, Mm, Mm, Ww, Wwf, Wwf, Ww, Gs^Fds, Hh, Hh, Md^Xm, Md, Md, Md^Xm, Md, Md, Md, Md, Md, Mm, Gs^Fds, Gd, Gd^Es, Gs^Fp, Mm, Hh, Hhd, Hhd, Hhd, Gd, Rp, Rp, Hhd, Md, Md, Md, Md
Hhd, Hhd, Gs^Fp, Gs^Fp, Rp, Wwf, Ww, Ww, Wo, Hhd, Hhd, Hhd, Md, Md, Md, Md, Md, Md, Mm, Mm, Hh, Gd, Gs, Hh^Fp, Hhd, Hhd, Gd^Es, Hhd, Re, Gd, Hhd, Hh, Hh, Hh, Md, Md, Hhd
Hh, Hh, Gs^Fp, Gs^Fp, Rp, Gs, Gs, Wo, Wo, Mm, Md^Xm, Md, Md^Xm, Hhd, Hhd, Hhd, Md^Xm, Mm^Xm, Mm^Xm, Mm, Mm, Hh, Hh, Hh, Hh, Hhd, Gd, Re, Mm, Gd^Es, Hhd, Hhd, Hhd, Hh, Hh, Md, Hhd
