border_size=1
usage=map

Mm^Xm       , Mm^Xm       , Mm^Xm       , Mm          , Mm          , Mm          , Hh          , Hh          , Hh          , Hh          , Gs^Fp       , Gs^Ft       , Gs^Fp       , Gs^Fp       , Rp          , Gs^Fp       , Ggf         , Gs^Fp       , Ww          , Wo          , Wo          , Ww          , Gs^Fp       , Gg          , Gg          , Rp          , Gs^Fp       , Gs^Fp       , Gs^Fp       , Gs^Fp       , Hh          , Hh          , Mm^Xm       , Mm          , Mm          , Mm^Xm       , Mm^Xm       
Mm^Xm       , Mm^Xm       , Mm          , Mm          , Mm          , Mm          , Hh          , Hh          , Gs          , Hh          , Gg^Ve       , Gs^Ft       , Gs^Fet      , Rp          , Gg          , Gs^Fp       , Ww          , Ww          , Wo          , Wo          , Ww          , Wwr         , Gs^Fp       , Gs^Fp       , Ggf         , Rp          , Gs^Ft       , Gs^Ft       , Gs^Fp       , Gs          , Gs^Fp       , Hh          , Mm          , Mm          , Mm^Xm       , Mm^Xm       , Mm          
Mm          , Mm          , Mm          , Hh          , Hh          , Hh          , Gs^Ft       , Gs^Ft       , Rp          , Gs          , Gs^Ft       , Gs^Ft       , Rd          , Rp          , Wwr         , Wwf         , Ww          , Wo          , Ww          , Ww          , Wwr         , Gs^Ft       , Gs^Ft       , Gs^Ft       , Gs^Fp       , Rp          , Gs^Fp       , Gs^Ft       , Gs^Ft       , Gs^Fp       , Gs^Fp       , Hh          , Mm          , Mm          , Mm          , Mm^Xm       , Mm          
Mm          , Mm^Xm       , Mm          , Hh          , Gs^Ft       , Rp          , Re          , Rp          , Gs^Fp       , Gs          , Gs^Ft       , Gs^Fp       , Rd          , Ggf^Fp      , Wwr         , Wwf         , Wwr         , Ww          , Gg^Fet      , Gg^Fp       , Gg^Fp       , Gs^Fp       , Gs^Fp       , Gs^Fp       , Gs^Fp       , Rp          , Gs^Fp       , Gs^Fp       , Gs^Ft       , Gs          , Gs          , Hh          , Hh          , Mm          , Mm          , Mm          , Mm^Xm       
Mm          , Mm          , Gs^Ft       , Hh          , Ggf         , Rp          , Gg^Fp       , Gs^Fet      , Gs^Fp       , Gs^Ft       , Rp          , Rd          , Wwf         , Wwf         , Wo          , Wwf         , Ggf         , Gg          , Gg^Fp       , Gg^Fp       , Gg^Fp       , Gs^Fp       , Gg^Fp       , Gg^Ve       , Gs^Fp       , Rp          , Gs^Fet      , Gs^Fp       , Gs^Fp       , Gs^Ft       , Gs^Ft       , Ggf         , Hh          , Hh          , Hh          , Mm          , Mm          
Hh          , Hh          , Gs^Ft       , Gs^Ft       , Gs^Ft       , Rp          , Gg          , Gg^Fp       , Gs^Ft       , Rp          , Gg^Fp       , Gg^Fxw      , Ww          , Ww          , Wo          , Ww          , Ss          , Ggf         , Ggf         , Gg^Fp       , Gg          , Gg^Fp       , Ss          , Gg^Fp       , Rp          , Rp          , Gs          , Gs^Fp       , Ggf         , Gs^Ft       , Gs          , Gs^Fp       , Gs^Fp       , Gs^Fp       , Hh          , Mm          , Mm          
Hh          , Gs^Ft       , Ggf         , Gs^Fp       , Gs^Ft       , Gs^Ft       , Gg          , Gg^Fp       , Rd          , Rd          , Ww^Bw\      , Ww          , Ww          , Wo          , Ww          , Wo          , Wo          , Ss          , Ggf         , Wwr         , Cv          , Wwr         , Cv          , Gs^Fp       , Gs          , Gs^Fp       , Gs^Fp       , Gs^Fp       , Gs^Fp       , Gg          , Gs^Ft       , Gs^Fp       , Ggf         , Gs^Fp       , Hh          , Mm          , Mm          
Hh          , Hh          , Hh          , Gs^Fp       , Rp          , Rp          , Gg          , Rp          , Gg          , Gg^Fp       , Ww          , Ww^Bw\      , Rp          , Ww          , Gs^Fp       , Ww          , Ss          , Ww          , Ww          , Wwf         , Wwr         , Cv          , 2 Kv        , Cv          , Gs          , Gs^Fp       , Gs^Fp       , Gs^Fp       , Gs^Fp       , Gs^Fp       , Gs^Fp       , Gs^Ft       , Hh          , Hh          , Mm          , Mm          , Mm^Xm       
Gs^Fp       , Hh          , Gg^Fet      , Rd          , Gg^Ve       , Gs^Fp       , Gg          , Ggf         , Wwr         , Wwr         , Wo          , Ww          , Cv          , Gg^Ve       , Gg^Fet      , Gs^Fp       , Gs^Fp       , Ss          , Wwf         , Wwf         , Wwr         , Cv          , Cv          , Cv          , Cv          , Gg          , Gg^Ve       , Gs          , Gs^Fp       , Gs^Ft       , Gs^Ft       , Ggf         , Hh          , Mm          , Mm          , Mm          , Mm^Xm       
Gs^Fp       , Gs^Fp       , Rp          , Gs^Ft       , Gs^Ft       , Gs^Fp       , Gs^Fp       , Gs^Fp       , Ww          , Wo          , Wo          , Cv          , 1 Kv        , Cv          , Rp          , Gs^Ft       , Gs^Ft       , Gs^Fp       , Gg          , Ww          , Rp          , Cv          , Gg          , Rp          , Rp          , Gg          , Gg          , Gg          , Gs          , Gs^Fp       , Gs          , Gs^Ft       , Hh          , Hh          , Mm          , Mm^Xm       , Mm^Xm       
Gs^Fp       , Rp          , Gs^Fp       , Gs^Fp       , Gs^Ft       , Gs^Ft       , Gs^Fp       , Ww          , Wo          , Wo          , Ww          , Cv          , Cv          , Cv          , Cv          , Rp          , Rp          , Rp          , Rp          , Rp          , Gs^Fp       , Gs^Fp       , Gg^Ve       , Gs^Fp       , Rp          , Gs^Fp       , Gs^Ft       , Gg          , Gg          , Gs^Fp       , Gs^Fp       , Gs          , Hh          , Mm          , Mm          , Mm^Xm       , Mm^Xm       
Rp          , Rp          , Gs^Ft       , Gs^Ft       , Gs^Ft       , Gs^Ft       , Wwr         , Ww          , Wo          , Ww          , Gg^Ve       , Rp          , Rd          , Gs^Fp       , Gs^Fp       , Gs^Fp       , Gs^Fp       , Gs^Ft       , Rp          , Gg          , Gs^Fp       , Gs^Fp       , Gs^Fp       , Gs^Ft       , Gs^Ft       , Rp          , Gs          , Gs^Ft       , Gs^Fp       , Gs^Fp       , Gs^Fp       , Hh          , Mm          , Mm^Xm       , Mm          , Mm^Xm       , Mm          
Hh          , Hh          , Hh          , Gs^Fp       , Ggf         , Gs^Fp       , Ww          , Wo          , Ww          , Ww          , Rp          , Rp          , Gs^Fp       , Gg          , Ggf         , Gg^Ve       , Gs^Fp       , Gs^Ft       , Gs^Fp       , Rp          , Gg          , Gs^Fp       , Gs^Ft       , Gs^Fp       , Gs^Fp       , Gs^Fp       , Rp          , Gs          , Gs^Fp       , Gs^Fp       , Hh          , Hh          , Mm          , Mm^Xm       , Mm          , Mm          , Mm          
Hh          , Gs^Fp       , Gs^Fp       , Gs^Fp       , Wwr         , Ww          , Wo          , Wo          , Gs^Fp       , Gs^Fp       , Rp          , Gs^Fp       , Ggf         , Gg          , Gs^Fp       , Gs          , Gs^Fp       , Gs^Fp       , Gs^Fp       , Rp          , Gg          , Gg          , Gg          , Gs^Ft       , Gs^Ft       , Gs^Fp       , Rp          , Gs^Fp       , Gg^Ve       , Gg^Fet      , Hh          , Mm          , Mm          , Hh          , Hh          , Mm          , Mm          
Hh          , Hh          , Ggf         , Gg          , Wwf         , Ww          , Ww          , Ww          , Gs^Ft       , Gs^Ft       , Rp          , Gg^Fet      , Gg          , Gg          , Gs          , Gs^Fp       , Gs^Fp       , Gs          , Gg          , Rp          , Rp          , Gs^Fp       , Gg^Ve       , Gs^Ft       , Ggf         , Gs^Fp       , Gs^Fp       , Gs^Fp       , Ggf         , Ggf         , Gg          , Mm          , Mm          , Mm          , Hh          , Mm          , Mm          
Hh          , Hh          , Wwr         , Wwr         , Wwf         , Wwr         , Ggf         , Gg^Ve       , Gs^Ft       , Gs^Ft       , Gg^Fp       , Gg^Fp       , Gg^Fp       , Ggf^Fxr     , Gs          , Gs^Ft       , Gs^Ft       , Gs          , Gs^Fp       , Gs^Fp       , Gs^Fp       , Rp          , Gs^Fp       , Gg^Fet      , Gs^Ft       , Gs^Ft       , Gs^Ft       , Rp          , Rp          , Hh          , Gs^Fp       , Gg          , Hh          , Hh          , Mm          , Mm          , Mm^Xm       
Ww          , Ww          , Ww          , Wwf         , Gg^Fet      , Gg^Fp       , Gs^Fp       , Gs^Fp       , Gs^Fp       , Gs^Fp       , Gg^Fp       , Rp          , Rp          , Gs          , Gs^Ft       , Gs^Ft       , Ww          , Ww          , Ww          , Gs^Fp       , Gs^Fp       , Rp          , Gs^Fp       , Gs^Ft       , Gs^Fp       , Gs^Fp       , Gs^Ft       , Gs^Ft       , Rp          , Gg^Fp       , Gs^Fp       , Hh          , Hh          , Hh          , Mm          , Mm^Xm       , Mm^Xm       
Wo          , Wo          , Wwr         , Wwf         , Gg^Ve       , Gg^Fp       , Gs^Ft       , Gs^Fp       , Gs^Fp       , Gs^Fp       , Gs^Fp       , Gg^Fp       , Rp          , Gs^Ft       , Gs^Fet      , Gs^Ft       , Ww          , Wo          , Wo          , Ww          , Gs^Fp       , Rp          , Gs^Fp       , Gg          , Gs^Fp       , Gs^Ft       , Gs^Ft       , Gs^Ft       , Gg^Fp       , Gg^Fp       , Gs          , Gg^Ve       , Ggf         , Hh          , Mm          , Mm          , Mm          
Ww          , Ww          , Gs^Ft       , Gs^Ft       , Gs          , Gs^Fp       , Gs^Ft       , Gs^Fp       , Gs^Fp       , Gs^Ft       , Ggf         , Gg          , Rp          , Gs^Fp       , Gs^Ft       , Gs^Ft       , Gs^Ft       , Ww          , Ww          , Ww          , Gs^Fp       , Gs^Fp       , Gs^Fp       , Gs^Fp       , Gs^Fp       , Gs^Fp       , Gs^Fp       , Gs^Fp       , Gg^Fp       , Gg^Fp       , Gg          , Ggf         , Hh          , Hh          , Mm^Xm       , Mm          , Mm          
Hh          , Hh          , Hh          , Gs^Ft       , Gs^Fp       , Gs          , Gs          , Gs^Ft       , Gs          , Gs^Ft       , Gg          , Gg          , Rp          , Gs          , Gg          , Gs^Ft       , Gg^Ve       , Gs^Fp       , Wwr         , Wwf         , Gs^Fp       , Gg          , Gs^Fp       , Gs^Fp       , Gs^Ft       , Gs^Ft       , Gs^Fp       , Gg^Fet      , Gg^Fp       , Rp          , Hh          , Hh          , Hh          , Mm          , Mm          , Mm          , Mm^Xm       
Hh          , Hh          , Gg^Ve       , Gs^Ft       , Gs^Fp       , Gs^Fp       , Gg          , Gs          , Gs^Fp       , Gs^Ft       , Gs^Ft       , Gg^Fp       , Rp          , Gg          , Gs^Fp       , Gs^Ft       , Ww          , Gs^Ft       , Wwf         , Wwr         , Gs^Fp       , Gs^Ft       , Gs^Fp       , Gs^Fp       , Gs^Fp       , Gs^Ft       , Gg          , Gg^Ve       , Rp          , Rp          , Gg          , Hh          , Mm          , Mm^Xm       , Mm          , Mm^Xm       , Mm^Xm       
Hh          , Gg          , Ggf         , Gs          , Gs^Fp       , Ggf         , Ggf         , Gs          , Rp          , Rp          , Rp          , Rp          , Rp          , Gs^Fp       , Gg          , Wwf         , Ww          , Wwr         , Wwf         , Ww          , Ggf         , Gs^Ft       , Gs^Ft       , Gs^Fp       , Gs^Fp       , Gs^Ft       , Gs^Ft       , Gg          , Rp          , Gg          , Ggf         , Hh          , Hh          , Mm          , Mm          , Mm          , Mm          
Hh          , Hh          , Gs^Ft       , Gs^Ft       , Gs^Fp       , Gg^Fet      , Rd          , Rp          , Gs^Ft       , Gg^Ve       , Gg^Ft       , Gg^Ft       , Ggf         , Rp          , Rd          , Gg          , Ggf         , Gg          , Ggf         , Gg          , Gg          , Gs^Ft       , Gs^Fp       , Gs^Fp       , Gs^Fp       , Gs^Fp       , Gs^Ft       , Gg          , Gs^Fp       , Gs^Fp       , Gs^Fp       , Gs^Fp       , Hh          , Hh          , Mm          , Mm          , Mm^Xm       
Hh          , Gs^Fp       , Gs          , Gs          , Gs          , Rd          , Gs^Fy       , Gs^Fp       , Gs^Fp       , Gs^Ft       , Gg^Ft       , Ggf         , Gg          , Ggf         , Gg          , Ggf         , Ggf         , Gg          , Ggf         , Ggf         , Ggf         , Gs^Fxo      , Hh          , Gs^Fp       , Gs^Fp       , Gs^Fet      , Rp          , Rp          , Gg          , Gs^Ft       , Gs^Ft       , Gg^Ve       , Hh          , Hh          , Mm          , Mm^Xm       , Mm^Xm       
Hh          , Hh          , Gs^Fy       , Ce          , Ce          , Rd          , Gs          , Gs          , Gs          , Gs^Ft       , Gg^Ft       , Gg^Ve       , Gg          , Ggf         , Gg          , Ggf         , Gg          , Ggf         , Gg          , Ggf         , Ggf         , Gg          , Ggf         , Gs^Fp       , Gg^Ve       , Gg          , Rp          , Gg          , Gs^Fp       , Gs^Ft       , Gs^Fp       , Hh          , Mm          , Mm          , Mm^Xm       , Mm^Xm       , Mm^Xm       
Hh          , Hh          , Gs          , Ce          , 3 Ke        , Ce          , Rd          , Gs          , Gs          , Gs          , Gs          , Gg^Fp       , Gg^Fp       , Ggf         , Gg          , Gg          , Hh          , Gg          , Ggf         , Gg          , Gg          , Gg          , Rp          , Gg          , Gg          , Gg          , Gg          , Gs^Fp       , Gs^Ft       , Gs^Fet      , Gs^Ft       , Mm          , Mm          , Mm          , Mm          , Mm          , Mm^Xm       
Mm          , Hh          , Gs^Fp       , Gs          , Gs^Fy       , Ce          , Ce          , Gs^Fy       , Gs^Fp       , Gs          , Gg          , Ggf         , Gs          , Gg          , Hh          , Ggf         , Ggf         , Hh          , Gg          , Gg          , Gs^Fp       , Ggf         , Gs^Fp       , Rp          , Gs          , Gs          , Gs          , Gs^Fp       , Gs^Ft       , Gs^Fp       , Gs^Ft       , Mm          , Mm^Xm       , Mm          , Mm          , Mm          , Mm          
Mm^Xm       , Hh          , Hh          , Gs^Fp       , Gs          , Ce          , Rd          , Gs          , Gg          , Gg          , Hh          , Gs^Fp       , Gs          , Hh          , Mm          , Mm^Xm       , Mm          , Hh          , Hh          , Hh          , Gs          , Gs^Fp       , Gs          , Gs          , Gs          , Gs^Fy       , Ce          , Gs          , Gg^Fy       , Gs^Fp       , Hh          , Mm          , Mm          , Mm          , Mm          , Mm          , Mm          
Mm^Xm       , Mm          , Mm          , Hh          , Gs^Fp       , Gs          , Rd          , Gs^Fp       , Gg^Ve       , Hh          , Gs          , Gs          , Ce          , Gs          , Hh          , Mm          , Hh          , Hh          , Gg^Ve       , Hh          , Gs^Fp       , Gs          , Gs          , Gs          , Ce          , Ce          , 4 Ke        , Ce          , Gs          , Ggf         , Mm          , Mm          , Mm          , Mm          , Mm^Xm       , Mm          , Mm^Xm       
Mm^Xm       , Mm          , Mm^Xm       , Hh          , Hh          , Gs^Fp       , Rd          , Gs          , Gs          , Hh          , Gs^Fy       , Ce          , 5 Ke        , Ce          , Gs          , Hh          , Gs^Fp       , Hh          , Ggf         , Gs^Fp       , Gs^Fp       , Gs          , Gs          , Gs          , Gs^Fy       , Ce          , Ce          , Ce          , Gs          , Hh          , Mm          , Mm          , Mm          , Mm^Xm       , Mm^Xm       , Mm^Xm       , Mm^Xm       
Mm          , Mm^Xm       , Mm^Xm       , Mm^Xm       , Mm          , Hh          , Gs^Fp       , Re          , Re          , Gs          , Gs          , Ce          , Ce          , Ce          , Gs^Fy       , Gs^Fp       , Gs^Ft       , Hh          , Gg^Fp       , Gg          , Gg^Fxo      , Ggf         , Gs          , Gs^Fp       , Gs^Fp       , Gs          , Gs          , Gs          , Hh          , Hh          , Mm^Xm       , Mm          , Mm          , Mm^Xm       , Mm          , Mm          , Mm          
Mm          , Mm          , Mm          , Mm          , Hh          , Hh          , Mm          , Hh          , Gs^Fp       , Rd          , Rp          , Gs          , Gs          , Gs          , Gs          , Gs^Fp       , Gs^Ft       , Ggf         , Gg^Fp       , Gg          , Gg          , Gg          , Gs          , Gs^Fp       , Gg^Ve       , Hh          , Gs^Ft       , Hh          , Hh          , Mm          , Mm          , Mm          , Mm          , Mm^Xm       , Mm^Xm       , Mm          , Mm^Xm       
Mm^Xm       , Mm^Xm       , Mm          , Mm          , Mm          , Mm          , Gs^Fp       , Gs^Fp       , Hh          , Re          , Rp          , Gs^Fy       , Gs          , Gs          , Gs^Fp       , Gs^Fp       , Gs          , Gs^Ft       , Gg          , Ggf         , Gs^Ft       , Gs^Fp       , Gs^Fp       , Gg^Fet      , Hh          , Gs^Ft       , Gs^Ft       , Gs^Fp       , Gs^Fp       , Gs^Ft       , Gs^Ft       , Hh          , Mm          , Mm          , Mm^Xm       , Mm^Xm       , Mm^Xm       
Ww          , Mm^Xm       , Mm          , Mm          , Mm          , Mm          , Hh          , Gg^Fet      , Gs^Fp       , Hh          , Rp          , Gs          , Gs^Ft       , Gs^Ft       , Gs          , Gs^Fp       , Gs^Fp       , Gs^Fp       , Gs          , Gg          , Hh          , Gs^Ft       , Hh          , Gs^Ft       , Hh          , Gs^Ft       , Gs^Fp       , Gs^Fp       , Gs^Ft       , Gs^Fp       , Gs^Ft       , Hh          , Mm          , Mm          , Mm          , Mm^Xm       , Mm^Xm       
Wo          , Ww          , Mm          , Hh          , Hh          , Hh          , Gs^Ft       , Gs^Fp       , Rp          , Rp          , Gs          , Gs          , Hh          , Gs^Ft       , Gs          , Gs^Fp       , Gs^Ft       , Gs^Ft       , Gs^Ft       , Hh          , Mm          , Hh          , Hh          , Hh          , Hh          , Gs^Ft       , Gs^Ft       , Ggf         , Gs          , Rp          , Gs^Fp       , Hh          , Mm          , Mm          , Mm          , Mm^Xm       , Mm^Xm       
Wo          , Wo          , Ww          , Mm          , Mm          , Gs^Ft       , Ggf         , Rp          , Gs^Fp       , Gs^Fp       , Hh          , Hh          , Hh          , Hh          , Mm          , Hh          , Hh          , Gs^Ft       , Mm^Xm       , Hh          , Mm          , Mm          , Gs^Fp       , Hh          , Mm^Xm       , Mm          , Mm          , Gs^Fp       , Gs^Fp       , Rp          , Gs          , Hh          , Hh          , Mm          , Mm          , Mm          , Mm^Xm       
Mm^Xm       , Wo          , Wo          , Mm^Xm       , Mm          , Gs^Fp       , Rp          , Rp          , Mm          , Hh          , Mm^Xm       , Mm          , Hh          , Hh          , Hh          , Mm          , Mm^Xm       , Mm^Xm       , Mm          , Mm          , Hh          , Mm          , Gs^Fp       , Gs^Fp       , Mm          , Hh          , Hh          , Gs^Ft       , Gs^Fp       , Gs^Fp       , Gs^Ft       , Gg^Ve       , Hh          , Hh          , Hh          , Mm          , Mm          
Mm^Xm       , Ww          , Wo          , Mm          , Gs^Fp       , Hh          , Rp          , Hh          , Gs^Fp       , Mm          , Mm          , Hh          , Mm          , Mm          , Mm          , Mm^Xm       , Md^Xm       , Mm^Xm       , Mm          , Mm          , Gs^Fp       , Gs^Fp       , Gs^Fp       , Gs^Fp       , Gs^Fp       , Hh          , Mm^Xm       , Mm          , Cv          , Rp          , Re          , Gs^Fp       , Gs^Fp       , Gs^Fp       , Hh          , Mm          , Md^Xm       
Mm^Xm       , Ww          , Ww          , Ww          , Wwr         , Rp          , Gs^Fp       , Hh          , Gs^Fp       , Mm          , Mm          , Md^Xm       , Md^Xm       , Hh          , Mm^Xm       , Md^Xm       , Md^Xm       , Mm^Xm       , Mm^Xm       , Mm          , Gs^Fp       , Gs^Fp       , Hh          , Gs^Fp       , Hh          , Gs^Fp       , Mm^Xm       , Gs^Fp       , Cv          , Rp          , Gs^Fp       , Gs^Fp       , Gs^Fp       , Gs^Fp       , Hh          , Mm          , Md^Xm       
Mm^Xm       , Mm          , Mm          , Ww          , Wwf         , Wwf         , Ww          , Gs          , Hh          , Hh          , Md^Xm       , Md          , Md          , Md^Xm       , Md^Xm       , Md^Xm       , Md          , Md^Xm       , Mm^Xm       , Mm          , Gs^Fp       , Gg^Fet      , Gs          , Gs^Fp       , Mm          , Mm^Xm       , Mm          , Gs^Fp       , Gs          , Gs^Fp       , Rp          , Rp          , Cv          , Hh          , Md^Xm       , Md^Xm       , Md          
Mm          , Mm          , Gs^Fp       , Gs^Fp       , Rp          , Wwr         , Ww          , Ww          , Wo          , Mm          , Md^Xm       , Md          , Md          , Md          , Md          , Md          , Md^Xm       , Md^Xm       , Mm          , Mm          , Hh          , Gs^Fp       , Gs          , Hh          , Mm          , Mm          , Gs^Fp       , Gs^Fp       , Re          , Gs^Fp       , Cv          , Cv          , Cv          , Mm^Xm       , Md^Xm       , Md          , Md^Xm       
Hh          , Hh          , Gs^Fp       , Gs^Fp       , Rp          , Gs          , Gs          , Wo          , Wo          , Mm          , Md^Xm       , Md          , Md^Xm       , Md^Xm       , Md^Xm       , Md          , Md^Xm       , Mm^Xm       , Mm^Xm       , Mm          , Mm          , Hh          , Hh          , Hh          , Hh          , Gs^Fp       , Gs^Fp       , Re          , Mm          , Gs^Fp       , Mm          , Mm          , Md^Xm       , Md^Xm       , Md          , Md          , Md^Xm       
