border_size=1
usage=map

Mm^Xm       , Mm^Xm       , Mm^Xm       , Mm          , Mm          , Mm          , Hh          , Hh          , Hh          , Hh          , Hh^Fp       , Gs^Ft       , Gs^Fms      , Gs^Fp       , Rp          , Gs^Fms      , Ggf         , Gs^Fms      , Ww          , Wo          , Wo          , Ww          , Gs^Fms      , Gg          , Gg          , Rp          , Gs^Fms      , Gs^Fms      , Gs^Fms      , Gs^Fms      , Hh          , Hh          , Mm^Xm       , Mm          , Mm          , Mm^Xm       , Mm^Xm       
Mm^Xm       , Mm^Xm       , Mm          , Mm          , Mm          , Mm          , Hh          , Hh^Fp       , Gs          , Hh          , Gg^Ve       , Gs^Ft       , Gs^Fet      , Rp          , Gg          , Gs^Fms      , Ww          , Ww          , Wo          , Wo          , Ww          , Wwf         , Gs^Fms      , Gs^Fms      , Ggf         , Rp          , Gs^Ft       , Gs^Ft       , Gs^Fms      , Gs          , Gs^Fms      , Hh          , Mm          , Mm          , Mm^Xm       , Mm^Xm       , Mm          
Mm          , Mm          , Mm          , Hh^Fp       , Gg^Ve       , Hh          , Gs^Ft       , Gs^Ft       , Rp          , Gs          , Gs^Ft       , Gs^Ft       , Rd          , Rp          , Wwf         , Wwf         , Ww          , Wo          , Ww          , Ww          , Wwf         , Gs^Ft       , Gs^Ft       , Gs^Ft       , Gs^Fds      , Rp          , Gs^Fds      , Gs^Ft       , Gs^Ft       , Gs^Fms      , Gs^Fms      , Hh          , Mm          , Mm          , Mm          , Mm^Xm       , Mm          
Mm          , Mm^Xm       , Mm          , Hh          , Gs^Ft       , Rp          , Re          , Rp          , Gs^Fms      , Gs          , Gs^Ft       , Gs^Fms      , Rd          , Ggf^Fms     , Wwf         , Wwf         , Wwf         , Ww          , Gg^Fet      , Gg^Fds      , Gg^Fds      , Gs^Fds      , Gs^Fds      , Gs^Fds      , Gs^Fds      , Rp          , Gs^Fds      , Gs^Fds      , Gs^Ft       , Gs          , Gs          , Hh          , Hh          , Mm          , Mm          , Mm          , Mm^Xm       
Mm          , Mm          , Gs^Ft       , Hh          , Ggf         , Rp          , Gg^Fp       , Gs^Fet      , Gs^Fms      , Gs^Ft       , Rp          , Rd          , Wwf         , Wwf         , Wo          , Wwf         , Ggf         , Gg          , Gg^Fds      , Gg^Fds      , Gg^Fds      , Gs^Fds      , Gg^Fds      , Gg^Ve       , Gs^Fds      , Rp          , Gs^Fet      , Gs^Fds      , Gs^Fds      , Gs^Ft       , Gs^Ft       , Ggf         , Hh          , Hh          , Hh          , Mm          , Mm          
Hh          , Hh          , Gs^Ft       , Gs^Ft       , Gs^Ft       , Rp          , Gg          , Gg^Fms      , Gs^Ft       , Rp          , Gg^Fp       , Gg^Fms      , Ww          , Ww          , Wo          , Ww          , Ss          , Ggf         , Ggf         , Gg^Fds      , Gg          , Gg^Fds      , Ss          , Gg^Fds      , Rp          , Rp          , Gs          , Gs^Fds      , Ggf         , Gs^Ft       , Gs          , Gs^Fms      , Gs^Fms      , Gs^Fms      , Hh          , Mm          , Mm          
Hh          , Gs^Ft       , Ggf         , Gs^Fp       , Gs^Ft       , Gs^Ft       , Gg          , Gg^Fms      , Rd          , Rd          , Ww^Bw\      , Ww          , Ww          , Wo          , Ww          , Wo          , Wo          , Ss          , Ggf         , Wwf         , Cv          , Wwf         , Cv          , Gs^Fp       , Gs          , Gs^Fds      , Gs^Fds      , Gs^Fds      , Gs^Fds      , Gg          , Gs^Ft       , Gs^Fms      , Ggf         , Gs^Fms      , Hh          , Mm          , Mm          
Hh^Fp       , Hh          , Hh          , Gs^Fp       , Rp          , Rp          , Gg          , Rp          , Gg          , Gs^Fms      , Ww          , Ww^Bw\      , Rp          , Ww          , Gs^Fp       , Ww          , Ss          , Ww          , Ww          , Wwf         , Wwf         , Cv          , 2 Kv        , Cv          , Gs          , Gs^Fds      , Gs^Fds      , Gs^Fds      , Gs^Fds      , Gs^Fds      , Gs^Fds      , Gs^Ft       , Hh          , Hh          , Mm          , Mm          , Mm^Xm       
Hh^Fp       , Hh          , Gg^Fet      , Rd          , Gg^Ve       , Gs^Fp       , Gg          , Ggf         , Wwf         , Wwf         , Wo          , Ww          , Cv          , Gg^Ve       , Gg^Fet      , Gs^Fp       , Gs^Fp       , Ss          , Wwf         , Wwf         , Wwf         , Cv          , Cv          , Cv          , Cv          , Gg          , Gg^Ve       , Gs          , Gs^Fds      , Gs^Ft       , Gs^Ft       , Ggf         , Hh          , Mm          , Mm          , Mm          , Mm^Xm       
Gs^Fp       , Gs^Fp       , Rp          , Gs^Ft       , Gs^Ft       , Gs^Fp       , Gs^Fp       , Gs^Fp       , Ww          , Wo          , Wo          , Cv          , 1 Kv        , Cv          , Rp          , Gs^Ft       , Gs^Ft       , Gs^Fp       , Gg          , Ww          , Rp          , Cv          , Gg          , Rp          , Rp          , Gg          , Gg          , Gg          , Gs          , Gs^Fds      , Gs          , Gs^Ft       , Hh          , Hh          , Mm          , Mm^Xm       , Mm^Xm       
Gs^Fp       , Rp          , Gs^Fms      , Gs^Fp       , Gs^Ft       , Gs^Ft       , Gs^Fp       , Ww          , Wo          , Wo          , Ww          , Cv          , Cv          , Cv          , Cv          , Rp          , Rp          , Rp          , Rp          , Rp          , Gs^Fds      , Gs^Fds      , Gg^Ve       , Gs^Fds      , Rp          , Gs^Fds      , Gs^Ft       , Gg          , Gg          , Gs^Fds      , Gs^Fds      , Hh^Fp       , Hh          , Mm          , Mm          , Mm^Xm       , Mm^Xm       
Rp          , Rp          , Gs^Ft       , Gs^Ft       , Gs^Ft       , Gs^Ft       , Wwf         , Ww          , Wo          , Ww          , Gg^Ve       , Rp          , Rd          , Gs^Fp       , Gs^Fms      , Gs^Fms      , Gs^Fms      , Gs^Ft       , Rp          , Gg          , Gs^Fds      , Gs^Fds      , Gs^Fds      , Gs^Ft       , Gs^Ft       , Rp          , Gs          , Gs^Ft       , Gs^Fds      , Gs^Fds      , Gs^Fds      , Hh          , Mm          , Mm^Xm       , Mm          , Mm^Xm       , Mm          
Hh          , Hh^Fp       , Hh          , Gs^Fp       , Ggf         , Gs^Fp       , Ww          , Wo          , Ww          , Ww          , Rp          , Rp          , Gs^Fp       , Gg          , Ggf         , Gg^Ve       , Gs^Fms      , Gs^Ft       , Gs^Fms      , Rp          , Gg          , Gs^Fds      , Gs^Ft       , Gs^Fds      , Gs^Fds      , Gs^Fds      , Rp          , Gs          , Gs^Fds      , Gs^Fds      , Hh          , Hh          , Mm          , Mm^Xm       , Mm          , Mm          , Mm          
Hh          , Gs^Fp       , Gs^Fp       , Gs^Fp       , Wwf         , Ww          , Wo          , Wo          , Gs^Fp       , Gs^Fds      , Rp          , Gs^Fp       , Ggf         , Gg          , Gs^Fp       , Gs          , Gs^Fms      , Gs^Fp       , Gs^Fp       , Rp          , Gg          , Gg          , Gg          , Gs^Ft       , Gs^Ft       , Gs^Fds      , Rp          , Gs^Fds      , Gg^Ve       , Gg^Fet      , Hh          , Mm          , Mm          , Hh          , Hh          , Mm          , Mm          
Hh^Fp       , Hh^Fp       , Ggf         , Gg          , Wwf         , Ww          , Ww          , Ww          , Gs^Ft       , Gs^Ft       , Rp          , Gg^Fet      , Gg          , Gg          , Gs          , Gs^Fms      , Gs^Fms      , Gs          , Gg          , Rp          , Rp          , Gs^Fp       , Gg^Ve       , Gs^Ft       , Ggf         , Gs^Fds      , Gs^Fds      , Gs^Fds      , Ggf         , Ggf         , Gg          , Mm          , Mm          , Mm          , Hh          , Mm          , Mm          
Hh          , Hh          , Wwf         , Wwf         , Wwf         , Wwf         , Ggf         , Gg^Ve       , Gs^Ft       , Gs^Ft       , Gs^Fds      , Gs^Fms      , Gs^Fms      , Gs^Fds      , Gs          , Gs^Ft       , Gs^Ft       , Gs          , Gs^Fms      , Gs^Fms      , Gs^Fms      , Rp          , Gs^Fds      , Gg^Fet      , Gs^Ft       , Gs^Ft       , Gs^Ft       , Rp          , Rp          , Hh          , Gs^Fds      , Gg          , Hh^Fp       , Hh          , Mm          , Mm          , Mm^Xm       
Ww          , Ww          , Ww          , Wwf         , Gg^Fet      , Gg^Fp       , Gs^Fds      , Gs^Fms      , Gs^Fds      , Gs^Fds      , Gs^Fms      , Rp          , Rp          , Gs          , Gs^Ft       , Gs^Ft       , Ww          , Ww          , Ww          , Gs^Fds      , Gs^Fms      , Rp          , Gs^Fds      , Gs^Ft       , Gs^Fms      , Gs^Fms      , Gs^Ft       , Gs^Ft       , Rp          , Gg^Fp       , Gs^Fp       , Hh          , Hh^Fp       , Hh          , Mm          , Mm^Xm       , Mm^Xm       
Wo          , Wo          , Wwf         , Wwf         , Gg^Ve       , Gg^Fp       , Gs^Ft       , Gs^Fds      , Gs^Fms      , Gs^Fds      , Gs^Fms      , Gg^Fp       , Rp          , Gs^Ft       , Gs^Fet      , Gs^Ft       , Ww          , Wo          , Wo          , Ww          , Gs^Fds      , Rp          , Gs^Fds      , Gg          , Gs^Fms      , Gs^Ft       , Gs^Ft       , Gs^Ft       , Gs^Fds      , Gs^Fds      , Gs          , Gg^Ve       , Ggf         , Hh          , Mm          , Mm          , Mm          
Ww          , Ww          , Gs          , Gs          , Hh          , Gs^Fp       , Gs^Ft       , Gs^Fds      , Gs^Fms      , Gs^Ft       , Ggf         , Gg          , Rp          , Gs^Fp       , Gs^Ft       , Gs^Ft       , Gs^Ft       , Ww          , Ww          , Ww          , Gs^Fds      , Gs^Fms      , Gs^Fds      , Gs^Fms      , Gs^Fds      , Gs^Fms      , Gs^Fms      , Gs^Fms      , Gs^Fds      , Gg^Fp       , Gg          , Ggf         , Hh^Fp       , Hh          , Mm^Xm       , Mm          , Mm          
Hh          , Hh          , Hh          , Hh          , Hh          , Hh          , Gs          , Gs^Ft       , Gs          , Gs^Ft       , Gg          , Gg          , Rp          , Gs          , Gg          , Gs^Ft       , Gg^Ve       , Gs^Fp       , Wwf         , Wwf         , Gs^Fds      , Gg          , Gs^Fms      , Gs^Fds      , Gs^Ft       , Gs^Ft       , Gs^Fms      , Gg^Fet      , Gg^Fp       , Rp          , Hh          , Hh          , Hh          , Mm          , Mm          , Mm          , Mm^Xm       
Hh          , Hh          , Gg^Ve       , Gs^Ft       , Hh          , Hh          , Hh          , Gs          , Gs^Fp       , Gs^Ft       , Gs^Ft       , Gg^Fp       , Rp          , Gg          , Gs^Fp       , Gs^Ft       , Ww          , Gs^Ft       , Wwf         , Ww          , Gs^Fms      , Gs^Ft       , Gs^Fms      , Gs^Fms      , Gs^Fds      , Gs^Ft       , Gg          , Gg^Ve       , Rp          , Rp          , Gg          , Hh          , Mm          , Mm^Xm       , Mm          , Mm^Xm       , Mm^Xm       
Hh          , Gs^Ft       , Ggf         , Ww          , Hh          , Ggf         , Ggf         , Gs          , Rp          , Rp          , Rp          , Rp          , Rp          , Gs^Fp       , Gg          , Wwf         , Ww          , Ww          , Wwf         , Ww          , Ggf         , Gs^Ft       , Gs^Ft       , Gs^Fms      , Gs^Fms      , Gs^Ft       , Gs^Ft       , Gg          , Rp          , Gg          , Ggf         , Hh          , Hh^Fms      , Mm          , Mm          , Mm          , Mm          
Hh^Fp       , Hh          , Gs^Ft       , Hh          , Hh          , Gg^Fet      , Rd          , Rp          , Gs^Ft       , Gg^Ve       , Gs          , Gg^Ft       , Ggf         , Rp          , Rd          , Gg          , Ggf         , Gg          , Ggf         , Gg          , Gg          , Gs^Ft       , Gs^Fms      , Gs^Fds      , Gs^Fms      , Gs^Fms      , Gs^Ft       , Gg          , Gs^Fms      , Gs^Fms      , Gs^Fms      , Gs^Fms      , Hh^Fms      , Hh          , Mm          , Mm          , Mm^Xm       
Hh^Fp       , Gs^Fp       , Gs          , Gs          , Gs          , Rd          , Gs^Zi       , Gs^Fp       , Gs          , Gs          , Gs          , Ggf         , Gg          , Ggf         , Gg          , Ggf         , Ggf         , Gg          , Ggf         , Ggf         , Ggf         , Gs^Fds      , Hh          , Gs^Fds      , Gs^Fms      , Gs^Fet      , Rp          , Rp          , Gg          , Gs^Ft       , Gs^Ft       , Gg^Ve       , Hh          , Hh          , Mm          , Mm^Xm       , Mm^Xm       
Hh          , Hh          , Gs^Zi       , Ce          , Ce          , Rd          , Gs          , Gs          , Gs^Ft       , Gs^Ft       , Gs          , Gg^Ve       , Gg          , Ggf         , Gg          , Ggf         , Gg          , Ggf         , Gg          , Ggf         , Ggf         , Gg          , Ggf         , Gs^Fms      , Gg^Ve       , Gg          , Rp          , Gg          , Gs^Fms      , Gs^Ft       , Gs^Fms      , Hh          , Mm          , Mm          , Mm^Xm       , Mm^Xm       , Mm^Xm       
Hh          , Hh          , Gs          , Ce          , 3 Ke        , Ce          , Rd          , Gs          , Gs          , Gs^Ft       , Gs          , Gs          , Gg^Fp       , Ggf         , Gg          , Gg          , Hh          , Gg          , Ggf         , Gg          , Gg          , Gg          , Rp          , Gg          , Gg          , Gg          , Gg          , Gs^Fms      , Gs^Ft       , Gs^Fet      , Gs^Ft       , Mm          , Mm          , Mm          , Mm          , Mm          , Mm^Xm       
Mm          , Gg^Ve       , Gs^Fp       , Gs          , Gs^Zi       , Ce          , Ce          , Gs^Zi       , Gs^Fp       , Gs          , Gg          , Ggf         , Gs          , Gg          , Hh          , Ggf         , Ggf         , Hh          , Gg          , Gg          , Gs^Fds      , Ggf         , Gs^Fds      , Rp          , Gs          , Gs          , Gs          , Gs^Fds      , Gs^Ft       , Gs^Fms      , Gs^Ft       , Mm          , Mm^Xm       , Mm          , Mm          , Mm          , Mm          
Mm^Xm       , Hh          , Hh          , Gs^Fp       , Gs          , Ce          , Rd          , Gs          , Gg          , Gg          , Hh^Fp       , Gs^Fp       , Gs          , Hh          , Mm          , Mm^Xm       , Mm          , Hh          , Hh          , Hh          , Gs          , Gs^Fds      , Gs          , Gs          , Gs          , Gs^Zi       , Ce          , Gs          , Gg^Zi       , Gs^Fds      , Hh          , Mm          , Mm          , Mm          , Mm          , Mm          , Mm          
Mm^Xm       , Mm          , Mm          , Hh          , Gs^Fp       , Gs          , Rd          , Gs^Fp       , Gg^Ve       , Hh          , Gs          , Gs          , Ce          , Gs          , Hh          , Mm          , Hh          , Hh          , Gg^Ve       , Hh^Fp       , Gs^Fds      , Gs          , Gs          , Gs          , Ce          , Ce          , 4 Ke        , Ce          , Gs          , Ggf         , Mm          , Mm          , Mm          , Mm          , Mm^Xm       , Mm          , Mm^Xm       
Mm^Xm       , Mm          , Mm^Xm       , Hh          , Hh          , Gs^Fp       , Rd          , Gs          , Gs          , Hh          , Gs^Zi       , Ce          , 5 Ke        , Ce          , Gs          , Hh          , Gs^Fds      , Hh          , Ggf         , Gs^Fds      , Gs^Fds      , Gs          , Gg^Ve       , Gs          , Gs^Zi       , Ce          , Ce          , Ce          , Gs          , Hh          , Mm          , Mm          , Mm          , Mm^Xm       , Mm^Xm       , Mm^Xm       , Mm^Xm       
Mm          , Mm^Xm       , Mm^Xm       , Mm^Xm       , Mm          , Hh          , Gs^Fds      , Re          , Re          , Gs          , Gs          , Ce          , Ce          , Ce          , Gs^Zi       , Gs^Fds      , Gs^Ft       , Hh          , Gs^Fds      , Gg          , Gg          , Ggf         , Gs          , Gs^Fds      , Gs^Fds      , Gs          , Gs          , Gs          , Hh          , Hh          , Mm^Xm       , Mm          , Mm          , Mm^Xm       , Mm          , Mm          , Mm          
Mm          , Mm          , Mm          , Mm          , Hh          , Hh          , Mm          , Hh          , Gs^Fds      , Rd          , Rp          , Gs          , Gs          , Gs          , Gs          , Gs^Fds      , Gs^Ft       , Gs^Fds      , Gs^Fds      , Gg          , Gg          , Gg          , Gs          , Gs^Fds      , Gg^Ve       , Hh          , Gs^Ft       , Hh          , Hh          , Mm          , Mm          , Mm          , Mm          , Mm^Xm       , Mm^Xm       , Mm          , Mm^Xm       
Mm^Xm       , Mm^Xm       , Mm          , Mm          , Mm          , Mm          , Gs^Fds      , Gs^Fds      , Hh          , Re          , Rp          , Gs^Zi       , Gs          , Gg^Ve       , Gs^Fds      , Gs^Fds      , Gs^Fds      , Gs^Ft       , Gg          , Ggf         , Gs^Ft       , Gs^Fds      , Gs^Fds      , Gg^Fet      , Hh          , Gs^Ft       , Gs^Ft       , Gs^Fds      , Gs^Fds      , Gs^Ft       , Gs^Ft       , Hh          , Mm          , Mm          , Mm^Xm       , Mm^Xm       , Mm^Xm       
Ww          , Mm^Xm       , Mm          , Mm          , Mm          , Mm          , Hh          , Gg^Fet      , Gs^Fds      , Hh          , Rp          , Gs          , Gs^Ft       , Gs^Ft       , Gs          , Gs^Fds      , Gs^Fds      , Gs^Fds      , Gs          , Gg          , Hh          , Gs^Ft       , Hh          , Gs^Ft       , Hh          , Gs^Ft       , Gs^Fds      , Gs^Fds      , Gs^Ft       , Gs^Fms      , Gs^Ft       , Hh          , Mm          , Mm          , Mm          , Mm^Xm       , Mm^Xm       
Wo          , Ww          , Mm          , Hh          , Hh          , Hh          , Gs^Ft       , Gs^Fds      , Rp          , Rp          , Gs          , Gs          , Hh          , Gs^Ft       , Gs          , Gs^Fds      , Gs^Ft       , Gs^Ft       , Gs^Ft       , Hh          , Mm          , Hh          , Hh          , Hh          , Hh          , Gs^Ft       , Gs^Ft       , Ggf         , Gs          , Rp          , Gs^Fms      , Hh          , Mm          , Mm          , Mm          , Mm^Xm       , Mm^Xm       
Wo          , Wo          , Ww          , Mm          , Mm          , Gs^Ft       , Ggf         , Rp          , Gs^Fds      , Gs^Fds      , Hh          , Hh          , Hh          , Hh          , Mm          , Hh^Fp       , Hh          , Gs^Ft       , Mm^Xm       , Hh          , Mm          , Mm          , Gs^Fds      , Hh          , Mm^Xm       , Mm          , Mm          , Gs^Fds      , Gs^Fds      , Rp          , Gs          , Hh          , Hh          , Mm          , Mm          , Mm          , Mm^Xm       
Mm^Xm       , Wo          , Wo          , Mm^Xm       , Mm          , Gs^Fms      , Rp          , Rp          , Mm          , Hh          , Mm^Xm       , Mm          , Hh          , Hh          , Hh          , Mm          , Mm^Xm       , Mm^Xm       , Mm          , Mm          , Hh          , Mm          , Gs^Fms      , Gs^Fms      , Mm          , Hh          , Hh          , Gs^Ft       , Gs^Fds      , Gs^Fds      , Gs^Ft       , Hh^Fms      , Hh^Fms      , Hh^Fp       , Hh          , Mm          , Mm          
Mm^Xm       , Ww          , Wo          , Mm          , Gs^Fms      , Hh          , Rp          , Hh^Fms      , Gs^Fp       , Mm          , Mm          , Hh          , Mm          , Mm          , Mm          , Mm^Xm       , Md^Xm       , Mm^Xm       , Mm          , Mm          , Gs^Fds      , Gs^Fds      , Hh^Fms      , Gs^Fms      , Gs^Fds      , Hh          , Mm^Xm       , Mm          , Cv          , Rp          , Re          , Gs^Fds      , Gs^Fms      , Gs^Fms      , Hh          , Mm          , Md^Xm       
Mm^Xm       , Ww          , Ww          , Ww          , Wwf         , Rp          , Gs^Fms      , Hh^Fds      , Gs^Fp       , Mm          , Mm          , Md^Xm       , Md^Xm       , Hh          , Mm^Xm       , Md^Xm       , Md^Xm       , Mm^Xm       , Mm^Xm       , Mm          , Gs^Fds      , Gs^Fds      , Hh          , Hh^Fms      , Hh          , Gs^Fds      , Mm^Xm       , Gs^Fds      , Cv          , Rp          , Gs^Fms      , Gs^Fms      , Gs^Fds      , Gs^Fms      , Hh          , Mm          , Md^Xm       
Mm^Xm       , Mm          , Mm          , Ww          , Wwf         , Wwf         , Ww          , Gs^Fds      , Hh          , Hh          , Md^Xm       , Md          , Md          , Md^Xm       , Md^Xm       , Md^Xm       , Md          , Md^Xm       , Mm^Xm       , Mm          , Gs^Fds      , Gg^Fet      , Gs          , Gs^Fp       , Mm          , Mm^Xm       , Mm          , Gs^Fds      , Gs          , Gs^Fds      , Rp          , Rp          , Cv          , Hh          , Md^Xm       , Md^Xm       , Md          
Mm          , Mm          , Gs^Fp       , Gs^Fp       , Rp          , Wwf         , Ww          , Ww          , Wo          , Mm          , Md^Xm       , Md          , Md          , Md          , Md          , Md          , Md^Xm       , Md^Xm       , Mm          , Mm          , Hh          , Gs^Fds      , Gs          , Hh^Fp       , Mm          , Mm          , Gs^Fds      , Gs^Fds      , Re          , Gs^Fds      , Cv          , Cv          , Cv          , Mm^Xm       , Md^Xm       , Md          , Md^Xm       
Hh          , Hh          , Gs^Fp       , Gs^Fp       , Rp          , Gs          , Gs          , Wo          , Wo          , Mm          , Md^Xm       , Md          , Md^Xm       , Md^Xm       , Md^Xm       , Md          , Md^Xm       , Mm^Xm       , Mm^Xm       , Mm          , Mm          , Hh          , Hh          , Hh          , Hh          , Gs^Fds      , Gs^Fds      , Re          , Mm          , Gs^Fds      , Mm          , Mm          , Md^Xm       , Md^Xm       , Md          , Md          , Md^Xm       
