Xu, Xu, Xu, Xu, Xu, Xu, Xu, Xu, Xu, Xu, Xu, Xu, Xu, Xu, Xu, Xu, Xu, Xu, Xu, Xu, Xu, Xu, Xu, Xu, Xu, Xu, Xu, Xu, Xu, Xu, Wog, Wog, Wog, Xu, Xu, Xu, Xu, Xu, Xu, Xu, Xu, Xu, Xu, Xu, Xu, Xu, Xu, Xu, Xu, Xu
Xu, Xu, Xu, Xu, Xu, Xu, Xu, Xu, Xu, Xu, Xu, Xu, Xu, Xu, Xu, Xu, Xu, Xu, Xu, Xu, Uh^Ii, Xu, Uh, Xu, Xu, Xu, Xu, Xu, Wog, Wog, Wog, Wog, Xu, Xu, Xu, Xu, Xu, Xu, Xu, Xu, Xu, Xu, Xu, Xu, Xu, Xu, Xu, Xu, Xu, Xu
Xu, Xu, Xu, Xu, Xu, Xu, Xu, Xu, Xu, Xu, Xu, Xu, Xu, Xu, Xu, Xu, Xu, Xu, Wwf^Es, Wwg, Uu^Ii, Uh, Uu, Xu, Xu, Xu, Xu, Xuc, Wog, Wog, Wog, Xu, Xu, Xu, Xu, Xu, Xu, Xu, Xu, Xu, Xu, Xu, Xu, Xu, Xu, Xu, Xu, Xu, Xu, Xu
Xu, Xu, Xu, Xu, Xu, Xu, Xu, Xu, Xu, Xu, Xu, Xu, Xu, Xu, Xu, Xu, Xu, Wwf, Wwf, Wwf, Wwg, Uu^Em, Uh, Xu, Xuc, Xuc, Wog, Wog, Wog, Wog, Xuc, Xu, Xu, Xu, Xu, Xu, Xu, Xu, Xu, Xu, Xu, Xu, Xu, Xu, Xu, Xu, Xu, Xu, Xu, Xu
Xu, Xu, Xu, Xu, Xu, Xu, Xu, Xu, Xu, Xu, Xu, Xu, Xu, Xu, Xu, Xu, Xu, Wwf^Es, Wwf, Wwf, Xu, Xu, Xu, Xu, Wwrg, Wwg, Wwrg, Wwg, Uh, Uh, Uh, Xuc, Xu, Xu, Xu, Xu, Xu, Xu, Xu, Xu, Xu, Xu, Xu, Xu, Xu, Xu, Xu, Xu, Xu, Xu
Xu, Xu, Xu, Xu, Xu, Xu, Xu, Xu, Xu, Xu, Xu, Xu, Xu, Xu, Xu, Xu, Xu, Wwf, Wwf, Xu, Xu, Xu, Xuc, Wwrg, Wwg, Wwg, Uu^Ii, Uh^Ii, Tb^Tf, Xu, Uh, Xuc, Xu, Xu, Xu, Xu, Xu, Xu, Xu, Xu, Xu, Xu, Xu, Xu, Xu, Xu, Xu, Xu, Xu, Xu
Xu, Xu, Xu, Xu, Xu, Xu, Xu, Xu, Xu, Xu, Xu, Xu, Xu, Xu, Xu, Xu, Xu, Xu, Uu^Ii, Wwf, Wwf^Es, Xu, Wwf^Es, Wwg, Uh^Ii, Uh^Ii, Cud, Urb, Re^Tf, Uu^Em, Xuc, Xu, Xu, Xu, Xu, Xu, Xu, Xu, Xu, Xu, Xu, Xu, Xu, Xu, Xu, Xu, Xu, Xu, Xu, Xu
Xu, Xu, Xu, Xu, Xu, Xu, Xu, Xu, Xu, Xu, Xu, Xu, Xu, Xu, Xu, Xu, Xu, Xu, Xu, Xu, Xu, Wwf^Es, Wwg, Wwg, Uh^Ii, Cud, 2 Kud, Cud, Urb, Uue^Tf, Xuc, Xuc, Qxu, Xu, Xuc, Xu, Xu, Xu, Xu, Xu, Xu, Xu, Xu, Xu, Xu, Xu, Xu, Xu, Xu, Xu
Xu, Xu, Xu, Xu, Xu, Xu, Xu, Xu, Xu, Xu, Xu, Xu, Xu, Xu, Xu, Xu, Xu, Xu, Xu, Xu, Xu, Wog, Wog, Xu, Uu^Ii, Cud, Cud, Cud, Urb, Re, Re^Tf, Qxu, Rd, Uu^Vud, Uu^Ii, Xuc, Xuc, Xu, Qxu, Xu, Xu, Xu, Xu, Xu, Xu, Xu, Xu, Xu, Xu, Xu
Xu, Xu, Xu, Xu, Xu, Xu, Xu, Xu, Xu, Xu, Xu, Xu, Xu, Xu, Xu, Xu, Xu, Xu, Xu, Xu, Wwg, Wog, Rd, Xu, Uu^Vu, Urb, Urb, Urb, Re^Tf, Rd, Re, Rd, Uu, Re, Rd, Cud, Qxu, Qxu, Qxu, Xu, Xu, Xu, Xu, Xu, Xu, Xu, Xu, Xu, Xu, Xu
Xu, Xu, Xu, Xu, Xu, Xu, Xu, Xu, Xu, Xu, Xu, Xu, Xu, Xu, Xu, Xu, Xu, Xu, Xu, Wwg, Wwf, Rd, Re^Tf, Xu, Uu^Tf, Urb, Uu^Em, Tb^Tf, Uu^Em, Uu, Tb^Tf, Uu^Tf, Qxu, Qxu, Rd, Qxu, Qxu, Qxu, Qxu, Qxu, Qxu, Xu, Xu, Xu, Xu, Xu, Xu, Xu, Xu, Xu
Xu, Xu, Xu, Xu, Xu, Xu, Xu, Xu, Xu, Xu, Xu, Xu, Xu, Xu, Xu, Xu, Xu, Xu, Wwrg, Wwf, Rd, Re^Tf, Xu, Xu, Uh, Urb, Uh, Qxu, Qxu, Qxu, Qxu, Qxu, Qxu, Uu^Tf, Re, Qxu, Qxu, Qxu, Xu, Qxu, Qxu, Xu, Xu, Xu, Xu, Xu, Xu, Xu, Xu, Xu
Xu, Xu, Xu, Xu, Xu, Xu, Xu, Xu, Xu, Xu, Xu, Xu, Xu, Xu, Xu, Xu, Xu, Wwf, Wwg, Uu^Tf, Re^Em, Re^Tf, Xu, Xu, Uu^Tf, Urb, Urb, Qxu, Qxu, Qxu, Re, Cud, Rd, Rd, Uu^Ii, Qxu, Qxu, Xu, Xu, Qxu, Qxu, Xu, Xu, Xu, Xu, Xu, Xu, Xu, Xu, Xu
Wog, Wog, Wog, Wog, Wog, Wog, Wog^Xo, Xu, Xu, Xu, Xu, Xu, Xu, Xu, Wwg, Wog, Wog, Wwf, Uu^Tf, Rd^Em, Re^Em, Uue^Tf, Xu, Uh, Uh, Uu^Es, Urb, Urb, Re, Rr, Uu, Re, Uu, Uu, Qxu, Qxu, Qxu, Qxu, Qxu, Qxu, Qxu, Xu, Xu, Xu, Xu, Xu, Xu, Xu, Xu, Xu
Xu, Xu, Xu, Xu, Xu, Xu, Xu, Wog, Xu, Xu, Xu, Xu, Wwf, Wwg, Wwf, Wwg, Xu, Xu, Rd^Em, Rd^Em, Re^Emf, Xu, Xu, Xuc, Uh, Uh, Urb, Qxu, Qxu, Urb, Qxu, Xuc, Xuc, Xu, Xu, Qxu, Xu, Qxu, Qxu, Qxu, Xu, Xu, Xu, Xu, Xu, Xu, Xu, Xu, Xu, Xu
Xu, Xu, Xu, Xu, Xu, Xu, Xu, Wwg, Uh, Uh, Uh, Xu, Xu, Wwf, Wwg, Wwrg, Xu, Rd, Re^Tf, Uue^Tf, Xu, Xu, Xu, Xuc, Xu, Rr, Uu^Ii, Uh^Ii, Qxu, Urb, Qxu, Qxu, Xuc, Xu, Xu, Xu, Xu, Xu, Xu, Xu, Xu, Xu, Xu, Xu, Xu, Xu, Xu, Xu, Xu, Xu
Xu, Xu, Xu, Xu, Xu, Xu, Wwg, Wwrg, Uu^Em, Tb^Tf, Tb^Emf, Uu^Em, Xu, Xu, Wwrg, Wwf, Wwf, Xu, Xu, Xu, Xu, Xu, Cud, Xuc, Rr, Rr, Uu^Ii, Uh^Ii, Qxu, Urb, Qxu, Qxu, Qxu, Xu, Xu, Xu, Xu, Xu, Xu, Xu, Xu, Xu, Xu, Xu, Xu, Xu, Xu, Xu, Xu, Xu
Xu, Xu, Xu, Xu, Xu, Xu, Xu, Xu, Uu, Urb, Tb^Tf, Urb, Xu, Xu, Wwg, Wwg, Wwf, Uu, Xu, Xu, Xu, Xu, Xu, Uu^Es, Rr, Urb, Uu, Qxu, Uu^Em, Cud, Qxu, Qxu, Qxu, Xu, Xu, Xu, Xu, Xu, Xu, Xu, Xu, Xu, Xu, Xu, Xu, Xu, Xu, Xu, Xu, Xu
Xu, Xu, Xu, Xu, Wwrg, Wwg, Uu^Ii, Xu, Xu, Urb, Uu^Tf, Uu^Tf, Xu, Xu, Wwf, Wwrg, Uu, Uu, Xu, Xu, Xu, Xu, Uu^Tf, Uh, Urb, Urb, Urb, Uu^Vu, Uu^Es, Qxu, Cud, Qxu, Qxu, Qxu, Xu, Xu, Xu, Xu, Xu, Xu, Xu, Xu, Xu, Xu, Xu, Xu, Xu, Xu, Xu, Xu
Xu, Xu, Xu, Xu, Wwg, Xu, Uh, Uh^Ii, Uh, Xu, Uh, Uh, Xu, Xu, Wwf, Wwf, Xu, Xu, Xu, Xu, Xu, Xuc, Rr, Rr, Uu, Rd, Uh, Urb, Rd, Uu^Em, Uu, Qxu, Qxu, Xu, Xu, Xu, Xu, Xu, Xu, Xu, Xu, Xu, Xu, Xu, Xu, Xu, Xu, Xu, Xu, Xu
Xu, Xu, Xu, Xu, Wwrg, Xu, Cud, Uu^Tf, Uh, Xu, Xuc, Xuc, Xu, Xu, Wwf, Wwg, Xu, Xu, Cte, Xu, Re, Rd, Re, Rd, Xu, Re, Xu, Uu^Tf, Uh, Re, Qxu, Qxu, Qxu, Xu, Xu, Xu, Qxu, Xu, Xu, Xu, Xu, Xu, Xu, Xu, Xu, Xu, Xu, Xu, Xu, Xu
Xu, Xu, Wwrg, Wwg, Uu^Vud, Xu, Xuc, Re^Em, Rr, Xu, Urb, Uu^Vu, Xu, Wwg, Wwg, Xu, Uu, Uu^Tf, Urb, Urb, Rd, Rr, Xu, Xu, Xu, Cud, Xu, Xu, Xu, Ur, Ur, Qxu, Xu, Xu, Qxu, Qxu, Qxu, Xu, Xu, Xu, Xu, Xu, Xu, Xu, Xu, Xu, Xu, Xu, Xu, Xu
Xu, Xu, Wwg, Uu, Uh, Uu^Em, Rr, Rr, Uu^Em, Urb, Cud, Uu^Em, Wwf, Wwf, Rd, Rr, Uu^Ii, Rd, Uu^Tf, Uu, Uh, Uu^Tf, Xu, Xu, Xu, Xu, Xu, Xu, Xu, Xu, Ur, Cud, Xu, Xu, Tb^Tf, Qxu, Qxu, Xu, Xu, Xu, Xu, Xu, Xu, Xu, Xu, Xu, Xu, Xu, Xu, Xu
Xu, Xu, Xu, Wwrg, Urb, Uh, Urb, Urb, Tb^Tf, Kud, Xu, Xu, Wwg, Wwf, Xu, Re, Xu, Cte, Xu, Xu, Xu, Xu, Xu, Xu, Uu^Em, Urb, Uu^Em, Xu, Xu, Xu, Xu, Ur, Ur, Uu, Uu^Em, Qxu, Qxu, Qxu, Qxu, Qxu, Xu, Xu, Xu, Xu, Xu, Xu, Xu, Xu, Xu, Xu
Xu, Xu, Wwg, Wwrg, Uh, Uu^Em, Urb, Uu^Ii, Uu^Tf, Cud, Xu, Wog, Wog, Wwg, Xu, Xu, Cte, Xu, Uh, Xu, Cte, Xu, Xu, Xu, Uu^Em, Urb^Es, Uu^Es, Xu, Xu, Xu, Uu^Em, Ur^Es, Ur^Es, Ur, Uu^Es, Tb^Tf, Qxu, Qxu, Qxu, Xu, Xu, Xu, Xu, Xu, Xu, Xu, Xu, Xu, Xu, Xu
Xu, Xu, Wwg, Uu^Tf, Tb^Tf, Xuc, Uu^Tf, Rr, Xu, Xu, Wog, Wog, Wwg, Wwg, Xu, Cte, Uu, Uu^Em, Uh, Tb^Tf, Uh, Cte, Xu, Xu, Xu, Uu^Es, Xu, Xu, Xu, Xu, Uu^Em, Uu^Vu, Ur, Ur, Uu^Em, Uu^Em, Qxu, Qxu, Xu, Xu, Xu, Xu, Xu, Xu, Xu, Xu, Xu, Xu, Xu, Xu
Xu, Xu, Wwg, Uh, Xu, Xuc, Cud, Rd, Uu, Wwg^Es, Wwg, Wwg, Wwf, Xu, Uu^Em, Cte, Uu, Uu^Vu, Uu^Em, Uh, Uu^Tf, Uh, Uh, Uh^Ii, Uh, Xu, Xu, Xu, Xu, Qxu, Qxu, Uu^Tf, Ur^Es, Ur, Tb^Tf, Uu^Es, Qxu, Qxu, Xu, Xu, Qxu, Xu, Xu, Xu, Xu, Xu, Xu, Xu, Xu, Xu
Xu, Xu, Xu, Wwg, Xu, Xuc, Xuc, Uh, Wwf^Es, Wwf, Wwf^Es, Uu^Ii, Wwf, Uu^Ii, Urb, Urb, Rr, Uu^Em, Urb, Urb, Qxu, Rd, Uue^Ii, Uh^Ii, Uh, Cte, Uu^Tf, Tb^Tf, Xu, Xu, Qxu, Tb^Tf, Uu^Em, Uu^Vu, Uu^Tf, Qxu, Qxu, Qxu, Xu, Qxu, Qxu, Qxu, Qxu, Xu, Xu, Xu, Xu, Xu, Xu, Xu
Xu, Xu, Xu, Wwrg, Wwg, Xu, Xu, Xu, Wwg, Wwg, Wwf, Wwf, Wwf, Urb, Qxu, Qxu, Qxu, Rr, Urb, Uu^Em, Qxu, Re, Rd^Ii, Uue^Ii, Urb, Urb, Urb, Re^Tf, Xuc, Xu, Xu, Qxu, Qxu, Uu^Em, Qxu, Qxu, Qxu^Xo, Xu, Qxu, Qxu, Qxu, Qxu, Qxu, Xu, Xu, Xu, Xu, Xu, Xu, Xu
Xu, Xu, Xu, Xu, Xu, Wwrg, Xu, Wwf^Es, Wwg, Xu, Cud, Uu^Ii, Uu, Wwf, Qxu, Qxu, Qxu, Uu^Vud, Urb, Qxu, Qxu, Re, Qxu^Ii, Urb^Ii, Uu^Ii, Uu^Tf, Uu^Tf, Rd^Em, Rd, Xuc, Xu, Qxu, Qxu, Qxu, Qxu^Xo, Qxu^Xo, Qxu, Qxu, Urb, Urb, Qxu, Qxu, Qxu, Xu, Xu, Xu, Xu, Xu, Xu, Xu
Xu, Xu, Xu, Xu, Xu, Wwrg, Wwg, Wwf, Wwf, Xu, Xu, Urb, Rr, Qxu, Qxu, Qxu, Cte, Qxu, Uh^Ii, Urb, Urb, Qxu, Urb, Urb^Ii, Cte, Xuc, Qxu, Uu^Em, Re^Em, Re^Em, Re^Tf, Xu, Xu, Qxu, Qxu^Xo, Qxu, Uu, Qxu, Urb, Qxu, Qxu, Qxu, Xu, Xu, Xu, Xu, Xu, Xu, Xu, Xu
Xu, Xu, Xu, Xu, Xu, Xu, Wwg, Wwf, Wwf, Xu, Xu, Uu^Tf, Uu, Rr, Urb, Cte, Cte, Qxu^Ii, Uh, Rr, Rd, Qxu, Rr, Uu^Tf, Xuc, Xuc, Qxu, Qxu, Xu, Re, Re^Em, Cte, Xu, Xu, Xu, Xu, Xu, Uu, Urb, Qxu, Qxu, Qxu, Xu, Xu, Xu, Xu, Xu, Xu, Xu, Xu
Xu, Xu, Xu, Xu, Xu, Wwg, Wog, Wwf, Xu, Xu, Xu, Xu, Xu, Uh^Ii, Re, Rd, Re, Qxu, Qxu, Rr, Urb, Rr, Xu, Xu, Qxu, Qxu, Qxu, Qxu, Xu, Xu, Rd^Em, Re^Tf, Uh, Cte, Uu, Xu, Urb, Xu, Qxu, Qxu, Xu, Xu, Xu, Xu, Xu, Xu, Xu, Xu, Xu, Xu
Xu, Xu, Xu, Xu, Xu, Wwg, Wog, Wwg, Xu, Xu, Xu, Xu, Xu, Xu, Xu, Uh, Rd, Qxu, Urb, Rd, Urb, Rr, Rr, Uu, Cte, Qxu, Qxu, Qxu, Xu, Xuc, Urb, Re, Uh, Uu^Tf, Cte, Urb, Xu, Xu, Qxu, Qxu, Xu, Xu, Xu, Xu, Xu, Xu, Xu, Xu, Xu, Xu
Xu, Xu, Xu, Xu, Xu, Wwg, Wog^Xo, Wog^Xo, Xu, Xu, Xu, Xu, Xu, Xu, Xu, Uh, Uu, Urb, Xu, Uh, Uu^Tf, Urb, Rr, Uu^Ii, Cte, Kte, Qxu^Ii, Qxu^Ii, Re, Uu^Tf, Rd, Rd, Rd, Rd^Emf, Rd, Uue^Ii, Uue^Ii, Xu, Xuc, Xu, Xu, Xu, Xu, Xu, Xu, Xu, Xu, Xu, Xu, Xu
Xu, Xu, Xu, Xu, Xu, Xu, Wwg, Wog, Wog, Xu, Xu, Wwf, Uu, Ur, Ur, Xu, Xu, Xu, Xu, Uh, Xu, Uu, Uu, Rd, Uue^Ii, Uue^Ii, Rd, Uue^Ii, Xu, Uu, Re, Uu^Ii, Uh^Ii, Re^Tf, Re^Tf, Rd^Es, Uue^Ii, Uue^Tf, Uue, Xuc, Xuc, Xu, Xu, Xu, Xu, Xu, Xu, Xu, Xu, Xu
Xu, Xu, Xu, Xu, Xu, Xu, Xu, Wog, Wog^Xo, Wog^Xo, Wwg, Wwrg, Uu, Ur, Wwf, Ur, Ur, Ur, Xu, Xu, Xu, Xu, Xu, Re, Xu, Rd, Uue^Ii, Xu, Xu, Xu, Cte, Uu^Ii, Uh^Ii, Uh^Ii, Uue^Vud, Re, Rd, Uue^Emf, Cte, Cte, Xuc, Xu, Xu, Xu, Xu, Xu, Xu, Xu, Xu, Xu
Xu, Xu, Xu, Xu, Xu, Xu, Xu, Wog, Wog^Xo, Wog, Wog, Wwg, Wwg, Wwf, Ur, Ur, Xu, Xu, Xu, Xu, Xu, Xu, Xu, Xu, Xu, Xu, Xu, Xu, Xu, Xu, Xu, Cte, Uh, Uh^Ii, Uue, Uue, Re^Es, Uue, Cte, Kte, Cte, Xuc, Xu, Xu, Xu, Xu, Xu, Xu, Xu, Xu
Xu, Xu, Xu, Xu, Xu, Xu, Wog, Wog, Wog, Wog^Xo, Wwg, Wwg, Uu, Ur, Ur, Xu, Xu, Xu, Xu, Xu, Xu, Xu, Xu, Xu, Xu, Xu, Xu, Xu, Xu, Xu, Xu, Xu, Uu, Uh, Uue^Tf, Uue, Uue, Rd, Uu, Cte, Uh, Xu, Xu, Xu, Xu, Xu, Xu, Xu, Xu, Xu
Xu, Xu, Xu, Xu, Xu, Xu, Wog, Wog, Wog^Xo, Wog^Xo, Wwg, Wwrg, Uu, Ur, Uu, Xu, Xu, Xu, Xu, Xu, Xu, Xu, Xu, Xu, Xu, Xu, Xu, Xu, Xu, Xu, Xu, Xu, Xu, Tb^Tf, Qxu, Uue^Tf, Uue^Tf, Ur, Ur, Uu^Vu, Xuc, Xu, Xu, Xu, Xu, Xu, Xu, Xu, Xu, Xu
Xu, Xu, Xu, Xu, Wwg, Wog, Wog, Wog, Wog^Xo, Wog, Xu, Wwrg, Wwf, Uu, Xu, Xu, Xu, Xu, Xu, Xu, Xu, Xu, Xu, Xu, Xu, Xu, Xu, Xu, Xu, Xu, Tb^Tf, Xu, Xu, Xu, Qxu, Qxu, Uu^Em, Uu, Uu, Ur, Qxu, Qxu, Qxu, Xu, Qxu, Xu, Xu, Xu, Xu, Xu
Xu, Xu, Wwg, Wwg, Wog, Wog, Wog, Wog, Xu, Xu, Wog, Xu, Xu, Xu, Xu, Xu, Xu, Xu, Xu, Xu, Xu, Xu, Xu, Xu, Xu, Xu, Uu^Tf, Uue, Uue^Tf, Uue^Emf, Tb^Tf, Uu^Tf, Uu^Em, Xuc, Uu^Tf, Uu^Tf, Ur, Uu^Em, Ur, Ur, Qxu, Qxu, Qxu, Qxu, Xu, Xu, Xu, Xu, Xu, Xu
Xu, Xu, Wwg, Wwg, Wog, Wog, Wwg, Xu, Xu, Xu, Wog, Xu, Xu, Xu, Xu, Xu, Xu, Xu, Xu, Xu, Re^Tf, Uh, Uu^Em, Uh, Uu^Em, Uu^Tf, Uu, Uue^Em, Uue, Uue^Em, Uu^Tf, Uu, Uu, Uu, Ur, Ur, Uu, Ur, Uu^Vu, Qxu, Qxu, Qxu, Qxu, Qxu, Xu, Xu, Xu, Xu, Xu, Xu
Wwg, Wwg, Wog, Wog, Wwg, Wwg, Xu, Xu, Xu, Xu, Xu, Wog^Xo, Wog, Xu, Xu, Xu, Uh, Xu, Uh, Uh, Tb^Tf, Uu^Em, Uu, Uh, Uu^Em, Uu, Uu^Es, Uu^Es, Ur, Ur, Ur, Ur, Ur^Es, Ur, Uu^Em, Uu, Uu^Es, Uu, Qxu, Qxu, Qxu, Qxu, Xu, Xu, Xu, Xu, Xu, Xu, Xu, Xu
Wog, Wog, Wog, Wog, Wwg, Xu, Xu, Xu, Xu, Xu, Xu, Xu, Wog, Xu, Uh, Uh, Uu, Tb^Tf, Uu, Uh, Uu, Uu^Em, Ur, Ur, Ur, Ur, Ur, Ur^Em, Uu^Em, Uu^Es, Tb^Tf, Uu^Vud, Uu, Uu, Uu^Tf, Uu^Em, Xu, Uu, Uu^Tf, Qxu, Qxu, Qxu, Xu, Xu, Xu, Xu, Xu, Xu, Xu, Xu
Wog, Wog, Wwg, Wwg, Xu, Xu, Xu, Xu, Xu, Xu, Xu, Xu, Uh, Uu^Tf, Uh, Uu^Tf, Uh, Tb^Tf, Ur, Ur, Ur, Ur, Uu, Uu, Uu^Vu, Uu^Em, Uu^Em, Uu^Em, Uh, Uu^Tf, Xu, Uu^Tf, Xu, Qxu, Qxu, Xu, Xu, Uu^Vud, Xu, Xu, Xu, Xu, Xu, Xu, Xu, Xu, Xu, Xu, Xu, Xu
Wwg, Wwg, Uu, Xu, Xu, Xu, Xu, Xu, Xu, Xu, Uu^Tf, Re^Tf, Re^Emf, Uue^Tf, Uue, Uu^Em, Ur, Ur, Uu^Em, Uu, Uu^Em, Uu, Uh, Uu^Em, Uh, Uh, Uh, Uu^Emf, Uh, Uh, Xu, Xu, Xu, Qxu, Qxu, Qxu, Qxu, Xu, Xu, Xu, Xu, Xu, Xu, Xu, Xu, Xu, Xu, Xu, Xu, Xu
Xu, Xu, Xu, Xu, Xu, Xu, Xu, Xu, Xu, Xu, Uh, Re^Em, Ce, Ce, Uue, Uue^Vu, Ur, Uu, Uu^Em, Uh, Uh, Xu, Xu, Uh, Xu, Xu, Xu, Re^Tf, Xu, Xu, Xu, Xu, Xu, Xu, Xu, Xu, Xu, Qxu, Xu, Xu, Xu, Xu, Xu, Xu, Xu, Xu, Xu, Xu, Xu, Xu
Xu, Xu, Xu, Xu, Xu, Xu, Xu, Xu, Xu, Uh, Re^Em, Ce, 1 Ke, Ce, Ce, Ur, Uu, Uu^Em, Uh, Xu, Xu, Xu, Xu, Xu, Xu, Xu, Xu, Xu, Xu, Xu, Xu, Xu, Xu, Xu, Xu, Xu, Xu, Xu, Xu, Xu, Xu, Xu, Xu, Xu, Xu, Xu, Xu, Xu, Xu, Xu
Xu, Xu, Xu, Xu, Xu, Xu, Xu, Xu, Xu, Uu^Tf, Re^Emf, Uue^Em, Ce, Ce, Uue, Ur, Uu^Vud, Uu^Tf, Tb^Tf, Xu, Xu, Xu, Xu, Xu, Xu, Xu, Xu, Xu, Xu, Xu, Xu, Xu, Xu, Xu, Xu, Xu, Xu, Xu, Xu, Xu, Xu, Xu, Xu, Xu, Xu, Xu, Xu, Xu, Xu, Xu
Xu, Xu, Xu, Xu, Xu, Xu, Xu, Xu, Uu^Tf, Uu^Em, Uu^Tf, Re^Em, Uue^Em, Uue^Em, Ur, Ur, Uh, Uu^Tf, Xu, Xuc, Xu, Xu, Xu, Xu, Xu, Xu, Xu, Xu, Xu, Xu, Xu, Xu, Xu, Xu, Xu, Xu, Xu, Xu, Xu, Xu, Xu, Xu, Xu, Xu, Xu, Xu, Xu, Xu, Xu, Xu
Xu, Xu, Xu, Xu, Xu, Xu, Xu, Xu, Uh, Uh, Uh, Uh, Ur, Ur, Uh, Uu, Xu, Xu, Xu, Xu, Xu, Xu, Xu, Xu, Xu, Xu, Xu, Xu, Xu, Xu, Xu, Xu, Xu, Xu, Xu, Xu, Xu, Xu, Xu, Xu, Xu, Xu, Xu, Xu, Xu, Xu, Xu, Xu, Xu, Xu
