Xu, Xu, Xu, Xu, Xu, Xu, Xu, Xu, Xu, Xu, Xu, Xu, Xu, Xu, Xu, Xu, Xu, Xu, Xu, Xu, Xu, Xu, Xu, Xu, Xu, Xu, Xu, Xu, Xu, Xu, Wog, Wog, Wog, Xu, Xu, Xu, Xu, Xu, Xu, Xu, Xu, Xu, Xu, Xu, Xu, Xu, Xu, Xu, Xu, Xu
Xu, Xu, Xu, Xu, Xu, Xu, Xu, Xu, Xu, Xu, Xu, Xu, Xu, Xu, Xu, Xu, Xu, Xu, Xu, Xu, Uh^Ii, Xu, Uh, Xu, Xu, Xu, Xu, Xu, Wog, Wog, Wog, Wog, Xu, Xu, Xu, Xu, Xu, Xu, Xu, Xu, Xu, Xu, Xu, Xu, Xu, Xu, Xu, Xu, Xu, Xu
Xu, Xu, Xu, Xu, Xu, Xu, Xu, Xu, Xu, Xu, Xu, Xu, Xu, Xu, Xu, Xu, Xu, Xu, Wwf^Es, Wwg, Uu^Ii, Uh, Uu, Xu, Xu, Xu, Xu, Xuc, Wog, Wog, Wog, Xu, Xu, Xu, Xu, Xu, Xu, Xu, Xu, Xu, Xu, Xu, Xu, Xu, Xu, Xu, Xu, Xu, Xu, Xu
Xu, Xu, Xu, Xu, Xu, Xu, Xu, Xu, Xu, Xu, Xu, Xu, Xu, Xu, Xu, Xu, Xu, Wwf, Wwf, Wwf, Wwg, Uu^Em, Uh, Xu, Xuc, Xuc, Wog, Wog, Wog, Wog, Xuc, Xu, Xu, Xu, Xu, Xu, Xu, Xu, Xu, Xu, Xu, Xu, Xu, Xu, Xu, Xu, Xu, Xu, Xu, Xu
Xu, Xu, Xu, Xu, Xu, Xu, Xu, Xu, Xu, Xu, Xu, Xu, Xu, Xu, Xu, Xu, Xu, Wwf^Es, Wwf, Wwf, Xu, Xu, Xu, Xu, Wwrg, Wwg, Wwrg, Wwg, Uh, Uh, Uh, Xuc, Xu, Xu, Xu, Xu, Xu, Xu, Xu, Xu, Xu, Xu, Xu, Xu, Xu, Xu, Xu, Xu, Xu, Xu
Xu, Xu, Xu, Xu, Xu, Xu, Xu, Xu, Xu, Xu, Xu, Xu, Xu, Xu, Xu, Xu, Xu, Wwf, Wwf, Xu, Xu, Xu, Xuc, Wwrg, Wwg, Wwg, Uu^Ii, Uh^Ii, Uu^Uf, Xu, Uh, Xuc, Xu, Xu, Xu, Xu, Xu, Xu, Xu, Xu, Xu, Xu, Xu, Xu, Xu, Xu, Xu, Xu, Xu, Xu
Xu, Xu, Xu, Xu, Xu, Xu, Xu, Xu, Xu, Xu, Xu, Xu, Xu, Xu, Xu, Xu, Xu, Xu, Uu^Ii, Wwf, Wwf^Es, Xu, Wwf^Es, Wwg, Uh^Ii, Uh^Ii, Cud, Urb, Re^Uf, Uu^Em, Xuc, Xu, Xu, Xu, Xu, Xu, Xu, Xu, Xu, Xu, Xu, Xu, Xu, Xu, Xu, Xu, Xu, Xu, Xu, Xu
Xu, Xu, Xu, Xu, Xu, Xu, Xu, Xu, Xu, Xu, Xu, Xu, Xu, Xu, Xu, Xu, Xu, Xu, Xu, Xu, Xu, Wwf^Es, Wwg, Wwg, Uh^Ii, Cud, 2 Kud, Cud, Urb, Uue^Uf, Xuc, Xuc, Qxu, Xu, Xuc, Xu, Xu, Xu, Xu, Xu, Xu, Xu, Xu, Xu, Xu, Xu, Xu, Xu, Xu, Xu
Xu, Xu, Xu, Xu, Xu, Xu, Xu, Xu, Xu, Xu, Xu, Xu, Xu, Xu, Xu, Xu, Xu, Xu, Xu, Xu, Xu, Wog, Wog, Xu, Uu^Ii, Cud, Cud, Cud, Urb, Re, Re^Uf, Qxu, Rd, Uu^Vud, Uu^Ii, Xuc, Xuc, Xu, Qxu, Xu, Xu, Xu, Xu, Xu, Xu, Xu, Xu, Xu, Xu, Xu
Xu, Xu, Xu, Xu, Xu, Xu, Xu, Xu, Xu, Xu, Xu, Xu, Xu, Xu, Xu, Xu, Xu, Xu, Xu, Xu, Wwg, Wog, Rd, Xu, Uu^Vu, Urb, Urb, Urb, Re^Uf, Rd, Re, Rd, Uu, Re, Rd, Cud, Qxu, Qxu, Qxu, Xu, Xu, Xu, Xu, Xu, Xu, Xu, Xu, Xu, Xu, Xu
Xu, Xu, Xu, Xu, Xu, Xu, Xu, Xu, Xu, Xu, Xu, Xu, Xu, Xu, Xu, Xu, Xu, Xu, Xu, Wwg, Wwf, Rd, Re^Uf, Xu, Uu^Uf, Urb, Uu^Em, Uu^Uf, Uu^Em, Uu, Uu^Uf, Uu^Uf, Qxu, Qxu, Rd, Qxu, Qxu, Qxu, Qxu, Qxu, Qxu, Xu, Xu, Xu, Xu, Xu, Xu, Xu, Xu, Xu
Xu, Xu, Xu, Xu, Xu, Xu, Xu, Xu, Xu, Xu, Xu, Xu, Xu, Xu, Xu, Xu, Xu, Xu, Wwrg, Wwf, Rd, Re^Uf, Xu, Xu, Uh, Urb, Uh, Qxu, Qxu, Qxu, Qxu, Qxu, Qxu, Uu^Uf, Re, Qxu, Qxu, Qxu, Xu, Qxu, Qxu, Xu, Xu, Xu, Xu, Xu, Xu, Xu, Xu, Xu
Xu, Xu, Xu, Xu, Xu, Xu, Xu, Xu, Xu, Xu, Xu, Xu, Xu, Xu, Xu, Xu, Xu, Wwf, Wwg, Uu^Uf, Re^Em, Re^Uf, Xu, Xu, Uu^Uf, Urb, Urb, Qxu, Qxu, Qxu, Re, Cud, Rd, Rd, Uu^Ii, Qxu, Qxu, Xu, Xu, Qxu, Qxu, Xu, Xu, Xu, Xu, Xu, Xu, Xu, Xu, Xu
Wog, Wog, Wog, Wog, Wog, Wog, Wog^Xo, Xu, Xu, Xu, Xu, Xu, Xu, Xu, Wwg, Wog, Wog, Wwf, Uu^Uf, Rd^Em, Re^Em, Uue^Uf, Xu, Uh, Uh, Uu^Es, Urb, Urb, Re, Rr, Uu, Re, Uu, Uu, Qxu, Qxu, Qxu, Qxu, Qxu, Qxu, Qxu, Xu, Xu, Xu, Xu, Xu, Xu, Xu, Xu, Xu
Xu, Xu, Xu, Xu, Xu, Xu, Xu, Wog, Xu, Xu, Xu, Xu, Wwf, Wwg, Wwf, Wwg, Xu, Xu, Rd^Em, Rd^Em, Re^Emf, Xu, Xu, Xuc, Uh, Uh, Urb, Qxu, Qxu, Urb, Qxu, Xuc, Xuc, Xu, Xu, Qxu, Xu, Qxu, Qxu, Qxu, Xu, Xu, Xu, Xu, Xu, Xu, Xu, Xu, Xu, Xu
Xu, Xu, Xu, Xu, Xu, Xu, Xu, Wwg, Uh, Uh, Uh, Xu, Xu, Wwf, Wwg, Wwrg, Xu, Rd, Re^Uf, Uue^Uf, Xu, Xu, Xu, Xuc, Xu, Rr, Uu^Ii, Uh^Ii, Qxu, Urb, Qxu, Qxu, Xuc, Xu, Xu, Xu, Xu, Xu, Xu, Xu, Xu, Xu, Xu, Xu, Xu, Xu, Xu, Xu, Xu, Xu
Xu, Xu, Xu, Xu, Xu, Xu, Wwg, Wwrg, Uu^Em, Uu^Uf, Uu^Emf, Uu^Em, Xu, Xu, Wwrg, Wwf, Wwf, Xu, Xu, Xu, Xu, Xu, Cud, Xuc, Rr, Rr, Uu^Ii, Uh^Ii, Qxu, Urb, Qxu, Qxu, Qxu, Xu, Xu, Xu, Xu, Xu, Xu, Xu, Xu, Xu, Xu, Xu, Xu, Xu, Xu, Xu, Xu, Xu
Xu, Xu, Xu, Xu, Xu, Xu, Xu, Xu, Uu, Urb, Uu^Uf, Urb, Xu, Xu, Wwg, Wwg, Wwf, Uu, Xu, Xu, Xu, Xu, Xu, Uu^Es, Rr, Urb, Uu, Qxu, Uu^Em, Cud, Qxu, Qxu, Qxu, Xu, Xu, Xu, Xu, Xu, Xu, Xu, Xu, Xu, Xu, Xu, Xu, Xu, Xu, Xu, Xu, Xu
Xu, Xu, Xu, Xu, Wwrg, Wwg, Uu^Ii, Xu, Xu, Urb, Uu^Uf, Uu^Uf, Xu, Xu, Wwf, Wwrg, Uu, Uu, Xu, Xu, Xu, Xu, Uu^Uf, Uh, Urb, Urb, Urb, Uu^Vu, Uu^Es, Qxu, Cud, Qxu, Qxu, Qxu, Xu, Xu, Xu, Xu, Xu, Xu, Xu, Xu, Xu, Xu, Xu, Xu, Xu, Xu, Xu, Xu
Xu, Xu, Xu, Xu, Wwg, Xu, Uh, Uh^Ii, Uh, Xu, Uh, Uh, Xu, Xu, Wwf, Wwf, Xu, Xu, Xu, Xu, Xu, Xuc, Rr, Rr, Uu, Rd, Uh, Urb, Rd, Uu^Em, Uu, Qxu, Qxu, Xu, Xu, Xu, Xu, Xu, Xu, Xu, Xu, Xu, Xu, Xu, Xu, Xu, Xu, Xu, Xu, Xu
Xu, Xu, Xu, Xu, Wwrg, Xu, Cud, Uu^Uf, Uh, Xu, Xuc, Xuc, Xu, Xu, Wwf, Wwg, Xu, Xu, Cte, Xu, Re, Rd, Re, Rd, Xu, Re, Xu, Uu^Uf, Uh, Re, Qxu, Qxu, Qxu, Xu, Xu, Xu, Qxu, Xu, Xu, Xu, Xu, Xu, Xu, Xu, Xu, Xu, Xu, Xu, Xu, Xu
Xu, Xu, Wwrg, Wwg, Uu^Vud, Xu, Xuc, Re^Em, Rr, Xu, Urb, Uu^Vu, Xu, Wwg, Wwg, Xu, Uu, Uu^Uf, Urb, Urb, Rd, Rr, Xu, Xu, Xu, Cud, Xu, Xu, Xu, Ur, Ur, Qxu, Xu, Xu, Qxu, Qxu, Qxu, Xu, Xu, Xu, Xu, Xu, Xu, Xu, Xu, Xu, Xu, Xu, Xu, Xu
Xu, Xu, Wwg, Uu, Uh, Uu^Em, Rr, Rr, Uu^Em, Urb, Cud, Uu^Em, Wwf, Wwf, Rd, Rr, Uu^Ii, Rd, Uu^Uf, Uu, Uh, Uu^Uf, Xu, Xu, Xu, Xu, Xu, Xu, Xu, Xu, Ur, Cud, Xu, Xu, Uu^Uf, Qxu, Qxu, Xu, Xu, Xu, Xu, Xu, Xu, Xu, Xu, Xu, Xu, Xu, Xu, Xu
Xu, Xu, Xu, Wwrg, Urb, Uh, Urb, Urb, Uu^Uf, Kud, Xu, Xu, Wwg, Wwf, Xu, Re, Xu, Cte, Xu, Xu, Xu, Xu, Xu, Xu, Uu^Em, Urb, Uu^Em, Xu, Xu, Xu, Xu, Ur, Ur, Uu, Uu^Em, Qxu, Qxu, Qxu, Qxu, Qxu, Xu, Xu, Xu, Xu, Xu, Xu, Xu, Xu, Xu, Xu
Xu, Xu, Wwg, Wwrg, Uh, Uu^Em, Urb, Uu^Ii, Uu^Uf, Cud, Xu, Wog, Wog, Wwg, Xu, Xu, Cte, Xu, Uh, Xu, Cte, Xu, Xu, Xu, Uu^Em, Urb^Es, Uu^Es, Xu, Xu, Xu, Uu^Em, Ur^Es, Ur^Es, Ur, Uu^Es, Uu^Uf, Qxu, Qxu, Qxu, Xu, Xu, Xu, Xu, Xu, Xu, Xu, Xu, Xu, Xu, Xu
Xu, Xu, Wwg, Uu^Uf, Uu^Uf, Xuc, Uu^Uf, Rr, Xu, Xu, Wog, Wog, Wwg, Wwg, Xu, Cte, Uu, Uu^Em, Uh, Uu^Uf, Uh, Cte, Xu, Xu, Xu, Uu^Es, Xu, Xu, Xu, Xu, Uu^Em, Uu^Vu, Ur, Ur, Uu^Em, Uu^Em, Qxu, Qxu, Xu, Xu, Xu, Xu, Xu, Xu, Xu, Xu, Xu, Xu, Xu, Xu
Xu, Xu, Wwg, Uh, Xu, Xuc, Cud, Rd, Uu, Wwg^Es, Wwg, Wwg, Wwf, Xu, Uu^Em, Cte, Uu, Uu^Vu, Uu^Em, Uh, Uu^Uf, Uh, Uh, Uh^Ii, Uh, Xu, Xu, Xu, Xu, Qxu, Qxu, Uu^Uf, Ur^Es, Ur, Uu^Uf, Uu^Es, Qxu, Qxu, Xu, Xu, Qxu, Xu, Xu, Xu, Xu, Xu, Xu, Xu, Xu, Xu
Xu, Xu, Xu, Wwg, Xu, Xuc, Xuc, Uh, Wwf^Es, Wwf, Wwf^Es, Uu^Ii, Wwf, Uu^Ii, Urb, Urb, Rr, Uu^Em, Urb, Urb, Qxu, Rd, Uue^Ii, Uh^Ii, Uh, Cte, Uu^Uf, Uu^Uf, Xu, Xu, Qxu, Uu^Uf, Uu^Em, Uu^Vu, Uu^Uf, Qxu, Qxu, Qxu, Xu, Qxu, Qxu, Qxu, Qxu, Xu, Xu, Xu, Xu, Xu, Xu, Xu
Xu, Xu, Xu, Wwrg, Wwg, Xu, Xu, Xu, Wwg, Wwg, Wwf, Wwf, Wwf, Urb, Qxu, Qxu, Qxu, Rr, Urb, Uu^Em, Qxu, Re, Rd^Ii, Uue^Ii, Urb, Urb, Urb, Re^Uf, Xuc, Xu, Xu, Qxu, Qxu, Uu^Em, Qxu, Qxu, Qxu^Xo, Xu, Qxu, Qxu, Qxu, Qxu, Qxu, Xu, Xu, Xu, Xu, Xu, Xu, Xu
Xu, Xu, Xu, Xu, Xu, Wwrg, Xu, Wwf^Es, Wwg, Xu, Cud, Uu^Ii, Uu, Wwf, Qxu, Qxu, Qxu, Uu^Vud, Urb, Qxu, Qxu, Re, Qxu^Ii, Urb^Ii, Uu^Ii, Uu^Uf, Uu^Uf, Rd^Em, Rd, Xuc, Xu, Qxu, Qxu, Qxu, Qxu^Xo, Qxu^Xo, Qxu, Qxu, Urb, Urb, Qxu, Qxu, Qxu, Xu, Xu, Xu, Xu, Xu, Xu, Xu
Xu, Xu, Xu, Xu, Xu, Wwrg, Wwg, Wwf, Wwf, Xu, Xu, Urb, Rr, Qxu, Qxu, Qxu, Cte, Qxu, Uh^Ii, Urb, Urb, Qxu, Urb, Urb^Ii, Cte, Xuc, Qxu, Uu^Em, Re^Em, Re^Em, Re^Uf, Xu, Xu, Qxu, Qxu^Xo, Qxu, Uu, Qxu, Urb, Qxu, Qxu, Qxu, Xu, Xu, Xu, Xu, Xu, Xu, Xu, Xu
Xu, Xu, Xu, Xu, Xu, Xu, Wwg, Wwf, Wwf, Xu, Xu, Uu^Uf, Uu, Rr, Urb, Cte, Cte, Qxu^Ii, Uh, Rr, Rd, Qxu, Rr, Uu^Uf, Xuc, Xuc, Qxu, Qxu, Xu, Re, Re^Em, Cte, Xu, Xu, Xu, Xu, Xu, Uu, Urb, Qxu, Qxu, Qxu, Xu, Xu, Xu, Xu, Xu, Xu, Xu, Xu
Xu, Xu, Xu, Xu, Xu, Wwg, Wog, Wwf, Xu, Xu, Xu, Xu, Xu, Uh^Ii, Re, Rd, Re, Qxu, Qxu, Rr, Urb, Rr, Xu, Xu, Qxu, Qxu, Qxu, Qxu, Xu, Xu, Rd^Em, Re^Uf, Uh, Cte, Uu, Xu, Urb, Xu, Qxu, Qxu, Xu, Xu, Xu, Xu, Xu, Xu, Xu, Xu, Xu, Xu
Xu, Xu, Xu, Xu, Xu, Wwg, Wog, Wwg, Xu, Xu, Xu, Xu, Xu, Xu, Xu, Uh, Rd, Qxu, Urb, Rd, Urb, Rr, Rr, Uu, Cte, Qxu, Qxu, Qxu, Xu, Xuc, Urb, Re, Uh, Uu^Uf, Cte, Urb, Xu, Xu, Qxu, Qxu, Xu, Xu, Xu, Xu, Xu, Xu, Xu, Xu, Xu, Xu
Xu, Xu, Xu, Xu, Xu, Wwg, Wog^Xo, Wog^Xo, Xu, Xu, Xu, Xu, Xu, Xu, Xu, Uh, Uu, Urb, Xu, Uh, Uu^Uf, Urb, Rr, Uu^Ii, Cte, Kte, Qxu^Ii, Qxu^Ii, Re, Uu^Uf, Rd, Rd, Rd, Rd^Emf, Rd, Uue^Ii, Uue^Ii, Xu, Xuc, Xu, Xu, Xu, Xu, Xu, Xu, Xu, Xu, Xu, Xu, Xu
Xu, Xu, Xu, Xu, Xu, Xu, Wwg, Wog, Wog, Xu, Xu, Wwf, Uu, Ur, Ur, Xu, Xu, Xu, Xu, Uh, Xu, Uu, Uu, Rd, Uue^Ii, Uue^Ii, Rd, Uue^Ii, Xu, Uu, Re, Uu^Ii, Uh^Ii, Re^Uf, Re^Uf, Rd^Es, Uue^Ii, Uue^Uf, Uue, Xuc, Xuc, Xu, Xu, Xu, Xu, Xu, Xu, Xu, Xu, Xu
Xu, Xu, Xu, Xu, Xu, Xu, Xu, Wog, Wog^Xo, Wog^Xo, Wwg, Wwrg, Uu, Ur, Wwf, Ur, Ur, Ur, Xu, Xu, Xu, Xu, Xu, Re, Xu, Rd, Uue^Ii, Xu, Xu, Xu, Cte, Uu^Ii, Uh^Ii, Uh^Ii, Uue^Vud, Re, Rd, Uue^Emf, Cte, Cte, Xuc, Xu, Xu, Xu, Xu, Xu, Xu, Xu, Xu, Xu
Xu, Xu, Xu, Xu, Xu, Xu, Xu, Wog, Wog^Xo, Wog, Wog, Wwg, Wwg, Wwf, Ur, Ur, Xu, Xu, Xu, Xu, Xu, Xu, Xu, Xu, Xu, Xu, Xu, Xu, Xu, Xu, Xu, Cte, Uh, Uh^Ii, Uue, Uue, Re^Es, Uue, Cte, Kte, Cte, Xuc, Xu, Xu, Xu, Xu, Xu, Xu, Xu, Xu
Xu, Xu, Xu, Xu, Xu, Xu, Wog, Wog, Wog, Wog^Xo, Wwg, Wwg, Uu, Ur, Ur, Xu, Xu, Xu, Xu, Xu, Xu, Xu, Xu, Xu, Xu, Xu, Xu, Xu, Xu, Xu, Xu, Xu, Uu, Uh, Uue^Uf, Uue, Uue, Rd, Uu, Cte, Uh, Xu, Xu, Xu, Xu, Xu, Xu, Xu, Xu, Xu
Xu, Xu, Xu, Xu, Xu, Xu, Wog, Wog, Wog^Xo, Wog^Xo, Wwg, Wwrg, Uu, Ur, Uu, Xu, Xu, Xu, Xu, Xu, Xu, Xu, Xu, Xu, Xu, Xu, Xu, Xu, Xu, Xu, Xu, Xu, Xu, Uu^Uf, Qxu, Uue^Uf, Uue^Uf, Ur, Ur, Uu^Vu, Xuc, Xu, Xu, Xu, Xu, Xu, Xu, Xu, Xu, Xu
Xu, Xu, Xu, Xu, Wwg, Wog, Wog, Wog, Wog^Xo, Wog, Xu, Wwrg, Wwf, Uu, Xu, Xu, Xu, Xu, Xu, Xu, Xu, Xu, Xu, Xu, Xu, Xu, Xu, Xu, Xu, Xu, Uu^Uf, Xu, Xu, Xu, Qxu, Qxu, Uu^Em, Uu, Uu, Ur, Qxu, Qxu, Qxu, Xu, Qxu, Xu, Xu, Xu, Xu, Xu
Xu, Xu, Wwg, Wwg, Wog, Wog, Wog, Wog, Xu, Xu, Wog, Xu, Xu, Xu, Xu, Xu, Xu, Xu, Xu, Xu, Xu, Xu, Xu, Xu, Xu, Xu, Uu^Uf, Uue, Uue^Uf, Uue^Emf, Uu^Uf, Uu^Uf, Uu^Em, Xuc, Uu^Uf, Uu^Uf, Ur, Uu^Em, Ur, Ur, Qxu, Qxu, Qxu, Qxu, Xu, Xu, Xu, Xu, Xu, Xu
Xu, Xu, Wwg, Wwg, Wog, Wog, Wwg, Xu, Xu, Xu, Wog, Xu, Xu, Xu, Xu, Xu, Xu, Xu, Xu, Xu, Re^Uf, Uh, Uu^Em, Uh, Uu^Em, Uu^Uf, Uu, Uue^Em, Uue, Uue^Em, Uu^Uf, Uu, Uu, Uu, Ur, Ur, Uu, Ur, Uu^Vu, Qxu, Qxu, Qxu, Qxu, Qxu, Xu, Xu, Xu, Xu, Xu, Xu
Wwg, Wwg, Wog, Wog, Wwg, Wwg, Xu, Xu, Xu, Xu, Xu, Wog^Xo, Wog, Xu, Xu, Xu, Uh, Xu, Uh, Uh, Uu^Uf, Uu^Em, Uu, Uh, Uu^Em, Uu, Uu^Es, Uu^Es, Ur, Ur, Ur, Ur, Ur^Es, Ur, Uu^Em, Uu, Uu^Es, Uu, Qxu, Qxu, Qxu, Qxu, Xu, Xu, Xu, Xu, Xu, Xu, Xu, Xu
Wog, Wog, Wog, Wog, Wwg, Xu, Xu, Xu, Xu, Xu, Xu, Xu, Wog, Xu, Uh, Uh, Uu, Uu^Uf, Uu, Uh, Uu, Uu^Em, Ur, Ur, Ur, Ur, Ur, Ur^Em, Uu^Em, Uu^Es, Uu^Uf, Uu^Vud, Uu, Uu, Uu^Uf, Uu^Em, Xu, Uu, Uu^Uf, Qxu, Qxu, Qxu, Xu, Xu, Xu, Xu, Xu, Xu, Xu, Xu
Wog, Wog, Wwg, Wwg, Xu, Xu, Xu, Xu, Xu, Xu, Xu, Xu, Uh, Uu^Uf, Uh, Uu^Uf, Uh, Uu^Uf, Ur, Ur, Ur, Ur, Uu, Uu, Uu^Vu, Uu^Em, Uu^Em, Uu^Em, Uh, Uu^Uf, Xu, Uu^Uf, Xu, Qxu, Qxu, Xu, Xu, Uu^Vud, Xu, Xu, Xu, Xu, Xu, Xu, Xu, Xu, Xu, Xu, Xu, Xu
Wwg, Wwg, Uu, Xu, Xu, Xu, Xu, Xu, Xu, Xu, Uu^Uf, Re^Uf, Re^Emf, Uue^Uf, Uue, Uu^Em, Ur, Ur, Uu^Em, Uu, Uu^Em, Uu, Uh, Uu^Em, Uh, Uh, Uh, Uu^Emf, Uh, Uh, Xu, Xu, Xu, Qxu, Qxu, Qxu, Qxu, Xu, Xu, Xu, Xu, Xu, Xu, Xu, Xu, Xu, Xu, Xu, Xu, Xu
Xu, Xu, Xu, Xu, Xu, Xu, Xu, Xu, Xu, Xu, Uh, Re^Em, Ce, Ce, Uue, Uue^Vu, Ur, Uu, Uu^Em, Uh, Uh, Xu, Xu, Uh, Xu, Xu, Xu, Re^Uf, Xu, Xu, Xu, Xu, Xu, Xu, Xu, Xu, Xu, Qxu, Xu, Xu, Xu, Xu, Xu, Xu, Xu, Xu, Xu, Xu, Xu, Xu
Xu, Xu, Xu, Xu, Xu, Xu, Xu, Xu, Xu, Uh, Re^Em, Ce, 1 Ke, Ce, Ce, Ur, Uu, Uu^Em, Uh, Xu, Xu, Xu, Xu, Xu, Xu, Xu, Xu, Xu, Xu, Xu, Xu, Xu, Xu, Xu, Xu, Xu, Xu, Xu, Xu, Xu, Xu, Xu, Xu, Xu, Xu, Xu, Xu, Xu, Xu, Xu
Xu, Xu, Xu, Xu, Xu, Xu, Xu, Xu, Xu, Uu^Uf, Re^Emf, Uue^Em, Ce, Ce, Uue, Ur, Uu^Vud, Uu^Uf, Uu^Uf, Xu, Xu, Xu, Xu, Xu, Xu, Xu, Xu, Xu, Xu, Xu, Xu, Xu, Xu, Xu, Xu, Xu, Xu, Xu, Xu, Xu, Xu, Xu, Xu, Xu, Xu, Xu, Xu, Xu, Xu, Xu
Xu, Xu, Xu, Xu, Xu, Xu, Xu, Xu, Uu^Uf, Uu^Em, Uu^Uf, Re^Em, Uue^Em, Uue^Em, Ur, Ur, Uh, Uu^Uf, Xu, Xuc, Xu, Xu, Xu, Xu, Xu, Xu, Xu, Xu, Xu, Xu, Xu, Xu, Xu, Xu, Xu, Xu, Xu, Xu, Xu, Xu, Xu, Xu, Xu, Xu, Xu, Xu, Xu, Xu, Xu, Xu
Xu, Xu, Xu, Xu, Xu, Xu, Xu, Xu, Uh, Uh, Uh, Uh, Ur, Ur, Uh, Uu, Xu, Xu, Xu, Xu, Xu, Xu, Xu, Xu, Xu, Xu, Xu, Xu, Xu, Xu, Xu, Xu, Xu, Xu, Xu, Xu, Xu, Xu, Xu, Xu, Xu, Xu, Xu, Xu, Xu, Xu, Xu, Xu, Xu, Xu
