border_size=1
usage=map

Dd, Dd, Dd^Es, Dd, Dd, Dd, Dd, Dd, Dd^Eff, Dd, Dd, Dd, Dd, Ds, Ds, Wot, Wot, Wot, Wwt, Wot, Wot, Wot, Wot, Ds, Ds, Dd, Dd, Dd, Dd, Ds, Ds, Dd, Hd, Hd, Md, Md^Xm, Md^Xm, Md^Xm, Md, Hhd, Hhd, Hd, Hd, Dd, Dd, Hd, Hd, Hd, Hd, Dd, Hd, Md, Md^Xm, Md, Hd, Hd, Dd, Dd, Dd, Hd, Hd, Dd, Dd, Hd, Hd, Hd, Dd, Hd, Dd, Hd, Hd, Hd, Hhd, Md^Xm, Md^Xm, Md^Xm, Md^Xm, Md^Xm, Md, Md^Xm, Hd, Dd, Dd, Dd, Dd, Dd, Dd, Dd, Hd, Dd, Ds, Dd, Hd, Hd, Hd, Dd, Dd, Dd, Hd, Dd, Dd, Dd
Rd, Dd, Rd, Dd, Dd^Eff, Dd, Dd^Eff, Dd^Eff, Dd, Ce, Dd, Dd^Vdt, Dd, Dd, Ds, Ds, Wwt, Wwt, Ds, Wwt, Wot, Wot, Wwt, Ds, Ds, Dd, Dd, Ce, Dd, Ds, Dd, Dd, Hd, Hd, Md, Md^Xm, Md^Xm, Md, Md, Hhd, Hd, Hd, Dd, Hd, Hd, Hd, Dd, Dd, Md, Hd, Hd, Md, Md^Xm, Md, Hd, Hd, Dd, Ds, Dd, Dd, Dd, Dd, Dd, Dd, Hd, Hd, Dd, Dd^Xo, Hd, Hd, Dd, Hd, Hd, Md, Md, Md^Xm, Md^Xm, Md^Xm, Md, Hd, Hd, Hd, Dd, Dd, Dd, Dd, Hd, Hd, Dd, Ds^Edp, Rd, Dd^Dr, Dd, Dd, Cdr, Dd, Ds, Hd, Dd, Dd, Hd, Dd
Dd, Rd, Dd, Rd, Rd, Dd^Eff, Rd, Dd, Dd, Dd, Rd, Rd, Dd, Ce, Ce, Dd, Wwf, Ds, Dd^Vdt, Wwt, Dd, Wwt, Ds, Ds, Dd, Dd, Dd, Dd, Dd, Dd, Hd, Hd, Hd, Hd, Md, Md^Xm, Md, Md^Xm, Hhd, Hhd, Hhd, Hd, Hd, Hd, Hd, Hd, Hd, Dd, Md, Hd, Md^Xm, Md^Xm, Hd, Hd, Dd, Dd, Dd, Dd, Ds, Ds, Dd, Ds, Ds, Dd, Dd, Hd, Dd, Dd^Xo, Hd, Hd, Dd, Hd, Hd, Md, Md, Md^Xm, Md^Xm, Hhd, Hhd, Hd, Hd, Dd, Dd, Dd, Dd, Hd, Hd, Dd, Cdr, Ds, Rd, Dd, Cdr, Kdr, Hd, Hd, Rd, Hd, Cdr, Dd, Hd, Dd
Dd, Dd, Dd, Dd, Dd, Rd, Dd, Rd, Rd, Rd, Rd, Dd^Vda, Ds, Ce, Wwt, Wwt, Ds, Dd, Rd, Dd, Dd, Dd, Dd, Dd, Ce, Dd, Dd, Ds, Dd, Hd, Hd, Hd, Hd, Hd, Hhd, Hhd, Md, Md^Xm, Md^Xm, Md, Md, Hhd, Md, Hhd, Md, Md, Md, Md, Md^Xm, Md^Xm, Hhd, Md, Hd, Hd, Dd, Dd, Ds, Dd, Dd, Dd, Ds, Ds, Dd, Dd, Dd, Dd, Dd^Dc, Dd^Xo, Dd, Dd, Dd, Dd, Hd, Md, Md, Md^Xm, Md, Hhd, Hd, Dd, Dd, Hd, Dd, Dd, Ds, Ds, Ds, Ds, Ds, Ds, Ds^Es, Dd, Dd, Dd, Hd, Dd, Rd, Ds, Dd, Cdr, Dd, Hd
Dd, Dd, Dd, Dd^Eff, Dd^Eff, Rd, Dd^Vdt, Dd, Rd, Dd, Dd, Rd, Ds, Wwf, Ds, Ds, Dd, Ce, Rd, Dd, Ce, Dd, Dd, Dd, Dd, Dd, Ds, Ds, Dd, Hd, Hd, Md, Md, Hd, Hd, Hd, Hd, Hd, Md, Md^Xm, Md^Xm, Md, Md, Md, Md, Md, Md, Md, Md^Xm, Hhd, Hd, Hd, Hd, Dd, Dd, Dd, Ds, Dd, Dd, Ds, Dd, Dd, Dd, Ds, Dd, Dd, Dd, Dd^Xo, Ds, Ds, Dd, Hd, Md, Md, Hhd, Hhd, Md, Md, Hd, Dd, Dd, Hd, Dd, Dd, Dd, Ds, Ds^Dr, Ds^Es, Ds, Ds, Dd, Dd, Dd, Dd^Vda, Ds, Dd, Dd, Rd, Dd, Cdr, Hd, Hd
Dd, Dd, Dd^Eff, Dd^Eff, Dd, Dd, Dd, Dd^Edpp, Dd, Rd, Ce, Dd, Wwf, Wwf, Ds, Ds, Dd, Ce, Rd, Dd, Dd, Dd, Dd, Dd, Dd^Edpp, Dd^Edpp, Ds, Ds, Ds, Dd, Hd, Md, Hhd, Hhd, Hd, Dd, Dd, Hd, Hd, Md, Md^Xm, Md, Md^Xm, Md^Xm, Md^Xm, Md^Xm, Md^Xm, Md^Xm, Md, Hd, Dd, Hd, Dd, Dd, Dd, Ds, Dd, Dd, Dd, Dd, Ds, Dd, Dd, Dd, Hd, Dd, Dd, Ds^Xo, Dd, Ds, Dd, Hd, Dd, Dd, Hd, Md, Dd, Hd, Dd, Dd, Dd, Dd, Dd, Dd, Dd, Ds^Es, Ds, Dd, Hd, Ds, Rd, Cdr, Dd, Ds, Ds, Cdr, Cdr, Dd, Dd, Ds, Hd, Dd
Hd, Dd, Dd, Ds, Ce, Ce, Dd, Dd, Dd, Ce, 4 Ket, Ce, Rd, Ds, Dd, Rd, Rd, Rd, Dd^Vda, Dd, Dd^Edpp, Dd, Dd, Dd, Dd^Edpp, Dd, Ds, Dd, Dd, Dd, Hd, Md, Hhd, Hd, Dd, Dd, Hd, Hd, Hd, Md, Md^Xm, Md^Xm, Md, Hhd, Hhd, Hhd, Md, Md, Hhd, Dd, Hd, Hd, Dd, Dd, Dd, Dd, Dd, Dd, Dd, Dd, Dd, Dd, Hd, Dd, Hd, Hd, Dd, Dd^Xo, Dd, Ds, Dd, Dd, Dd, Hd, Hd, Md, Dd, Dd, Dd, Dd, Hd, Dd, Dd, Dd, Dd, Dd, Ds, Hd, Ds, Dd, Rd, Dd, Hd, Hd, Dd, Dd, Dd, Dd, Hd, Hd, Hd, Hd
Hd, Dd, Ds, Ds, Dd, Ce, Dd, Dd, Rd, Ce, Ce, Ce, Rd, Dd, Dd, Rd, Rd, Rd, Dd, Dd, Dd, Dd, Dd^Eff, Dd, Dd^Eff, Ds^Eff, Ds, Dd, Hd, Hd, Dd, Hd, Hd, Hd, Dd, Dd, Hd, Hd, Hd, Md^Xm, Md, Md, Hhd, Md, Hd, Hhd, Hd, Md, Dd, Dd, Dd, Hd, Dd, Dd, Dd, Dd, Dd, Dd, Dd, Dd^Dc, Dd, Dd, Dd, Hd, Hd, Hd, Dd, Ds^Xo, Dd, Dd, Dd, Ds, Dd, Hd, Dd, Dd, Dd, Dd, Dd, Dd, Hd, Hd, Hd, Dd, Dd, Ds, Ds, Ds, Dd, Rd, Dd, Hd, Hd, Ds, Dd, Dd, Dd, Rd, Dd, Hd, Dd, Dd
Hd, Dd, Dd, Ds, Dd, Dd, Dd, Dd^Vda, Dd, Dd, Dd, Dd, Dd, Dd, Ce, Dd, Dd, Rd, Rd, Dd, Dd, Dd^Eff, Dd^Es, Dd^Eff, Dd, Ds, Ds, Dd, Dd, Dd, Dd, Dd, Dd, Hd, Hd, Hd, Hd, Hd, Md, Md^Xm, Md, Hhd, Hhd, Dd, Dd, Hd, Dd, Hd, Dd, Dd, Dd, Dd, Rd, Rd, Re, Rd, Dd, Rd, Dd, Dd, Rd, Dd, Co, Dd, Dd, Hd, Dd, Dd^Xo, Hd, Dd, Dd, Dd, Ds, Dd, Ds^Es, Dd, Dd, Dd^Dc, Dd, Dd, Dd, Hd, Hd, Dd, Dd^Edpp, Dd, Dd, Dd, Dd^Es, Dd, Dd, Hd, Ds, Dd, Dd^Edp, Cdr, Ds, Ds^Dr, Ds, Hd, Dd, Dd
Hd, Hd, Dd, Ds^Es, Dd, Ds^Edpp, Ds^Edpp, Dd, Dd, Dd, Dd, Dd, Ce, Ce, Dd, Dd, Dd, Dd, Dd, Rd, Rd, Dd, Dd, Dd, Ds, Ds, Dd, Dd, Dd, Ds, Ds, Dd, Dd, Hd, Hd, Hd, Hd, Md, Md^Xm, Md^Xm, Md, Md, Hd, Hd, Dd, Dd, Dd, Dd, Dd, Rd, Rd, Dd, Dd, Dd, Dd, Dd, Dd, Dd, Dd, Rd, Rd, Rd, Rd, Dd, Dd, Dd, Hd, Hd^Xo, Dd, Dd, Dd, Ds, Dd, Dd, Dd, Ds, Ds, Ds, Dd, Dd, Dd, Dd, Hd, Dd, Dd^Edpp, Dd^Edpp, Dd^Edpp, Dd^Edpp, Rd, Rd, Dd^Edpp, Dd, Ds, Dd, Dd, Dd, Ds, Ds^Es, Dd, Dd, Dd, Dd
Dd, Dd, Dd, Dd, Hd, Dd, Ds, Dd, Dd, Ce, Ce, Ce, Dd, Dd, Dd, Dd, Dd^Eff, Dd^Eff, Dd, Rd, Dd, Rd, Dd, Dd, Dd, Dd, Dd, Dd, Ds, Ds, Ds, Dd, Hd, Dd, Hd, Hd, Md, Md, Md^Xm, Md, Hd, Hd, Dd, Dd, Ds, Dd, Ds, Ds, Rd, Rr, Dd, Dd, Dd, Dd, Ds, Dd, Dd, Dd, Dd, Dd, Hd, Rd, Rd, Dd, Dd, Dd, Hd, Hd^Xo, Dd, Dd, Dd, Ds, Dd, Hd, Hd, Dd, Ds, Ds, Dd, Dd, Hd, Hd, Dd, Dd, Dd^Edpp, Dd^Es, Dd^Edpp, Rd, Dd^Edpp, Dd^Edpp, Dd, Ds, Dd, Dd, Dd, Rd, Ds, Ds^Edp, Dd, Dd, Hd, Hd
Hd, Dd, Dd, Hd, Dd^Edpp, Dd, Dd, Ds, Dd, Dd, Dd, Dd, Dd^Eff, Dd^Eff, Dd, Dd, Dd, Dd, Dd, Dd^Vdt, Dd, Dd, Dd, Rd, Rd, Dd, Dd, Cdr, Ds, Ds, Dd, Dd, Dd, Hd, Md, Hd, Hd, Md^Xm, Hhd, Hhd, Hd, Dd, Dd, Dd, Ds, Ds^Edp, Ds, Ds, Ds, Dd, Dd, Dd^Dc, Dd, Dd, Ds, Ds, Dd, Dd, Dd, Dd, Hd, Rd, Rd, Dd, Rd, Hd, Dd, Hd^Xo, Hd^Xo, Dd^Xo, Dd^Xo, Dd^Xo, Dd^Xo, Dd^Xo, Dd^Xo, Dd^Xo, Ds^Xo, Ds^Xo, Dd^Xo, Hd^Xo, Dd^Xo, Dd^Xo, Dd^Xo, Dd^Xo, Rd^Xo, Dd^Xo, Dd^Xo, Rd^Xo, Dd^Xo, Dd^Xo, Hd^Xo, Ds^Xo, Dd^Xo, Dd^Xo, Hd^Xo, Ds^Xo, Dd^Xo, Dd^Xo, Dd^Xo, Hd^Xo, Hd^Xo, Hd
Hd, Dd, Dd, Dd, Dd, Dd, Hd, Dd, Hd, Dd, Hd, Dd, Dd, Hd, Dd, Dd, Dd, Hd, Dd, Dd, Dd, Dd, Dd^Es, Ds, Rd, Rd, Dd, Dd, Ds, Dd, Dd, Dd, Hd, Hd, Md, Md, Md^Xm, Md^Xm, Hhd, Hd, Hd, Dd, Ds, Ds^Es, Dd^Edpp, Rd, Ds, Rd, Ds, Ds, Ds, Dd, Dd, Dd, Ds, Dd, Dd, Dd, Dd, Dd, Hd, Rd, Co, Dd, Rd, Dd, Dd, Dd^Xo, Dd, Dd, Ds, Dd, Dd, Ds, Dd, Dd, Ds, Ds, Ds, Ds, Ds, Dd, Gd, Dd, Rd, Rd, Dd, Dd, Hd, Dd, Dd, Hd, Hd, Dd, Dd, Dd, Hd, Dd, Hd, Dd, Dd, Hd
Hd, Hd, Dd, Hd, Dd, Dd, Hd, Hd, Hd, Dd, Hd, Hd, Dd, Hd, Hd, Dd, Hd, Hd, Hd, Dd, Dd, Dd, Dd, Ds, Ds, Dd, Dd, Ds, Dd, Dd, Hd, Dd, Hd, Hd, Md, Md, Md^Xm, Md^Xm, Md, Hhd, Hd, Dd, Ds, Ds, Dd, Dd, Re, Rd, Dd, Dd, Rd, Dd, Dd, Ds, Dd, Dd, Dd, Dd, Dd, Hd, Dd, Dd, Dd, Dd, Rd, Rd, Rd, Dd^Xo, Dd, Dd, Dd, Dd, Gs^Vc, Ds, Ds, Ds, Wot, Ds, Ds, Ds, Wwf, Gs, Gs^Vo, Gs, Rd, Dd, Dd, Hd, Dd, Hd, Hd, Dd, Hd, Dd, Dd, Dd, Dd, Dd, Dd, Dd, Hd, Hd
Hd, Hd, Dd, Hd, Hd, Hd, Hd, Hd, Hd, Dd, Dd, Hd, Hd, Hd, Hd, Hd, Hd, Hd, Hd, Hd, Hd, Dd, Dd, Dd, Ds, Dd, Dd, Ds, Ds, Dd, Dd, Hd, Md, Md, Md^Xm, Md^Xm, Md, Md, Hhd, Hd, Hd, Dd, Ds, Dd, Rd, Re, Dd, Dd, Dd, Rd, Dd, Dd, Dd, Dd, Dd, Dd, Dd, Dd, Dd, Hd, Dd, Dd, Hd, Dd, Dd, Rd, Rd, Dd^Xo, Dd, Dd, Gd, Gs^Ft, Gs^Ft, Gs, Wwt^Bw\r, Wwt^Es, Wot, Wot, Wot^Es, Wwt, Wot, Wwt, Wwt, Gs^Ft, Gd^Ft, Dd, Ds, Dd, Dd, Dd, Hd, Hd, Hd, Dd, Hd, Dd, Dd, Hd, Hd, Dd, Hhd, Md
Md, Hhd, Hhd, Hd, Hd, Hd, Hhd, Hd, Hd, Hd, Hd, Hd, Hhd, Hd, Hd, Hd, Md, Md, Hhd, Hhd, Md, Hhd, Hhd, Dd, Dd, Dd, Dd, Rd, Rd, Dd, Dd, Md, Hd, Md^Xm, Md^Xm, Hhd, Hhd, Hhd, Hd, Hd, Dd, Dd, Dd, Dd, Re, Re, Dd, Ds^Edpp, Ds, Dd, Dd, Ds, Dd, Dd, Dd, Dd^Dc, Dd, Dd, Dd, Dd, Dd, Dd, Hd, Dd, Dd, Dd, Rd, Re^Xo, Rd, Dd, Gd^Ft, Gs^Ft, Wwf, Wwt, Wot, Wot, Wot, Wot, Wot, Wot, Wot, Wot, Wwt, Gs^Ft, Ds, Ds^Es, Dd, Dd, Dd, Dd, Hd, Hd, Hd, Hd, Hd, Hd, Hd, Hd, Hd, Hhd, Md, Md
Md, Md, Hhd, Md, Md, Md, Hhd, Md, Hhd, Hd, Md, Hhd, Hhd, Hhd, Hhd, Hhd, Md, Md, Md^Xm, Md, Md, Md, Hhd, Hd, Dd, Cdr, Dd, Dd, Ds, Ds, Dd, Hd, Hd, Md^Xm, Hhd, Hhd, Md, Hhd, Hd, Hd, Hd, Dd, Dd, Dd, Dd, Dd, Dd, Ds, Dd, Dd, Dd, Dd, Dd, Dd, Dd, Dd, Dd, Dd, Ds, Dd, Dd, Hd, Hd, Dd, Dd, Dd, Rd, Dd^Xo, Dd, Dd, Gd, Gs, Wwf^Es, Wwt, Wot, Wot, Wot, Wot, Co, Wot, Wot, Wot, Wwf, Ds, Ds, Ds^Edpp, Ds, Ds, Hd, Dd, Hd, Hd, Hd, Hd, Hd, Hd, Hd, Hhd, Hd, Hd, Hd, Md
Md, Md, Md, Md, Md, Hhd, Md, Md, Md, Hhd, Md, Md, Md, Hhd, Md, Md, Md, Md, Md^Xm, Md^Xm, Md^Xm, Md, Hhd, Hd, Dd, Dd, Dd, Dd, Ds, Ds, Dd, Hd, Dd, Md^Xm, Md^Xm, Hhd, Md, Hhd, Hhd, Hhd, Hd, Dd, Dd, Rd, Dd, Dd, Dd, Ds^Es, Dd, Dd, Dd, Dd, Hd, Dd, Dd, Dd, Dd, Dd, Ds, Dd, Dd, Hd, Dd, Dd, Dd, Dd, Dd, Rr^Xo, Rd, Dd, Dd, Gd^Vo, Re, Wwt, Gs, Co, Wwt, Wwt, Wwt, Co, Wwf, Wwf, Gs^Vo, Gs^Ft, Ds^Ft, Ds, Ds^Es, Ds, Dd, Hd, Hd, Hd, Hd, Hd, Hd, Hd, Md, Md, Hhd, Hd, Hd, Hd
Md, Md, Md, Md, Md, Md, Md, Md, Md, Md, Md, Md, Md, Md, Md, Md^Xm, Md^Xm, Md^Xm, Md^Xm, Md^Xm, Md^Xm, Md, Hd, Hd, Hd, Dd, Ds, Dd, Dd, Rd, Rd, Dd, Hd, Md, Md^Xm, Md^Xm, Md, Md, Hhd, Hhd, Hd, Hd, Dd, Dd, Rd, Dd, Dd, Dd, Dd, Dd, Dd, Dd, Dd, Dd, Dd, Dd, Hd, Dd, Dd, Ds, Dd, Dd, Dd, Dd, Dd, Dd, Ds, Dd^Xo, Dd, Dd, Gd, Gs^Ft, Gs^Ft, Re, Re, Gll, Co, Co, Co, Rb, Co, Re, Gs, Gs^Ft, Ds, Ds, Dd, Dd, Hd, Hd, Hd, Dd, Hd, Hd, Dd, Dd, Hd, Md, Hhd, Hd, Hd, Hd
Md, Md, Md, Md, Md, Md, Md^Xm, Md, Md, Md^Xm, Md^Xm, Md^Xm, Md^Xm, Md^Xm, Md^Xm, Md^Xm, Md^Xm, Md^Xm, Md^Xm, Md^Xm, Md^Xm, Md, Hhd, Hd, Hd, Dd, Dd, Dd, Dd, Rd, Rd, Dd, Hd, Hd, Md, Md^Xm, Md^Xm, Md, Md, Hhd, Hhd, Hd, Dd, Dd, Rd, Rd, Dd, Dd, Dd^Dc, Dd, Dd, Dd, Dd, Dd, Dd, Dd, Dd, Dd, Dd, Ds, Dd, Dd, Dd^Es, Dd, Dd, Dd, Dd, Ds^Xo, Ds, Dd, Dd, Gd, Gs^Ft, Gll, Gd^Ft, Re, Co, 2 Ko, Co, Rb, Gll, Gs, Ds, Ds, Dd, Ds^Edpp, Dd, Dd, Hd, Hd, Hd, Hd, Hd, Hd, Hd, Hd, Hd, Hd, Hd, Hhd, Hd, Hd
Md, Md, Md^Xm, Md^Xm, Md^Xm, Md, Md^Xm, Md^Xm, Md^Xm, Md, Md^Xm, Md^Xm, Md^Xm, Md^Xm, Md^Xm, Md^Xm, Md^Xm, Md^Xm, Md^Xm, Md^Xm, Md^Xm, Md, Md, Hhd, Hd, Hd, Dd, Dd, Ds, Dd, Rd, Dd, Hd, Hd, Hd, Md, Md, Md^Xm, Md^Xm, Hhd, Hhd, Hhd, Hd, Hd, Dd, Rd, Dd, Dd, Dd, Dd, Dd, Dd, Dd, Dd, Dd, Dd, Dd, Dd, Dd, Dd, Dd, Dd, Dd, Dd, Dd, Hd, Hd, Ds^Xo, Ds, Dd, Dd, Gd, Dd, Co, Gs, Gs, Re, Co, Re, Re, Re, Gs, Co, Dd, Dd, Ds, Hd, Hd, Hd, Hd, Hd, Hd, Hd, Hd, Hd, Hd, Hd, Hd, Hd, Hd, Hd, Hd
Md^Xm, Md^Xm, Md^Xm, Md^Xm, Md^Xm, Md^Xm, Md^Xm, Md^Xm, Md^Xm, Md^Xm, Md^Xm, Md^Xm, Md^Xm, Md^Xm, Md^Xm, Md^Xm, Md^Xm, Md^Xm, Md, Md^Xo, Md^Xo, Md, Md^Xo, Hhd, Hd, Hd, Dd, Ds, Ds^Edpp, Ds, Ds, Hd, Dd, Dd, Dd, Hd, Hd, Md^Xm, Md^Xm, Md, Hhd, Hhd, Hd, Hd, Dd, Dd, Rd, Dd, Dd, Dd^Dr, Dd, Dd, Dd, Ds^Es, Dd, Dd, Dd, Dd, Dd, Dd, Dd, Dd, Dd, Ds, Dd, Hd, Hd, Dd^Xo, Dd, Dd, Dd, Hd, Dd, Dd, Gd^Vo, Re, Gs, Gs, Gs, Re, Re, Re, Rd, Dd, Rd, Dd, Dd, Hd, Hd, Hd, Hd, Hd, Hd, Hd, Hd, Hd, Hd, Hd, Hd, Hd, Hd, Hd
Md^Xm, Md^Xm, Md^Xm, Md^Xm, Md^Xm, Md^Xm, Md^Xm, Md^Xm, Md^Xm, Md^Xm, Md^Xm, Md^Xm, Md^Xm, Md^Xm, Md^Xm, Md^Xm, Md^Xm, Md, Md, Md, Md, Md^Xo, Hd, Hhd^Xo, Hd^Xo, Hd, Dd, Ds, Dd, Ds, Ds, Ds, Ds, Ds, Dd, Hd, Hd, Md, Md^Xm, Md, Hhd, Hd, Hd, Hd, Dd, Dd, Rd, Dd, Dd, Dd, Dd, Dd, Dd, Dd, Dd, Dd, Dd, Hd, Hd, Dd, Ds, Ds, Dd, Dd, Dd, Hd, Hd, Hd^Xo, Hd, Hd, Hd, Hd, Hd, Dd, Dd, Gd, Dd, Co, Dd, Gd^Vc, Dd, Re, Rd, Dd, Rd, Dd, Dd, Hd, Hd, Hd, Hd, Hhd, Hhd, Md, Md, Hhd, Md, Hd, Hhd, Hd, Hd, Hd
Md^Xm, Md^Xm, Md^Xm, Md^Xm, Md^Xm, Md^Xm, Md^Xm, Md^Xm, Md^Xm, Md^Xm, Md^Xm, Md^Xm, Md^Xm, Md^Xm, Md^Xm, Md^Xm, Md, Md, Md, Hhd, Hhd, Hd, Dd, Dd, Hd, Dd^Xo, Dd^Xo, Dd, Rd, Ds, Ds^Xo, Cdr, Dd^Xo, Dd, Hd, Hd, Md, Md, Md^Xm, Md, Hhd, Hd, Hd, Dd, Dd, Dd, Dd, Rr, Dd, Hd, Hd, Dd, Ds^Es, Ds, Ds, Ds, Dd, Dd, Dd, Dd, Ds, Ds, Hd, Hd, Hd, Hd, Md, Md^Xo, Md^Xm, Md, Md, Md, Hd, Hd, Hd, Dd, Dd, Dd, Dd, Dd, Dd, Re, Re, Dd, Dd, Rd, Dd, Hd, Dd, Dd, Dd, Hd, Hd, Hd, Md^Xm, Md, Md^Xm, Md, Hhd, Md, Md, Hhd
Md^Xm, Md^Xm, Md^Xm, Md^Xm, Md^Xm, Md^Xm, Md^Xm, Md^Xm, Md^Xm, Md^Xm, Md^Xm, Md^Xm, Md^Xm, Md^Xm, Md^Xm, Md^Xm, Md, Md, Md, Hhd, Ds, Dd, Ds^Es, Dd, Dd, Dd, Rd, Rd^Xo, Dd^Xo, Ds^Xo, Ds^Es, Dd^Xo, Dd, Hd^Xo, Md^Xo, Md, Md^Xm, Md^Xm, Hhd, Hhd, Hd, Hd, Dd^Dc, Dd, Dd, Dd, Rd, Re, Dd, Dd, Hd, Dd, Ds^Es, Ds, Dd, Dd, Dd, Dd^Edp, Dd, Dd, Ds, Dd, Hd, Hd, Md, Md, Md^Xm, Md^Xm, Md, Md, Hhd, Hhd, Hd, Hd, Dd, Hd, Hd, Hd, Dd, Dd, Dd, Co, Dd, Dd, Rd, Dd, Dd, Dd, Ds^Es, Dd, Dd, Hd, Hd, Hhd, Md, Md, Md, Md, Md, Md, Md, Hhd
Md^Xm, Md^Xm, Md^Xm, Md^Xm, Md^Xm, Md^Xm, Md^Xm, Md^Xm, Md^Xm, Md^Xm, Md^Xm, Md^Xm, Md^Xm, Md^Xm, Md, Md, Md, Hhd, Hhd, Wot, Ds, Dd, Ds^Edp, Ds, Dd, Dd, Rd, Dd, Dd, Ds, Ds^Edpp, Dd, Hd, Hd, Md^Xm, Md^Xm, Md^Xm, Hhd, Hhd, Hd, Hd, Dd, Dd, Dd, Dd, Rd, Dd, Dd, Dd, Dd, Dd, Dd, Ds, Ds, Dd, Dd, Dd, Dd, Dd, Dd, Dd, Dd, Hd, Hd, Md, Md, Md^Xm, Md, Hhd, Hhd, Hd, Hhd, Hd, Dd, Dd, Hd, Dd, Hd, Hd, Hd, Hd, Dd, Dd, Rd, Rd, Dd, Dd, Dd, Ds^Es, Ds, Dd, Hd, Hhd, Hhd, Hd, Md, Md, Md^Xm, Md^Xm, Md^Xm, Md, Hhd
Md^Xm, Md^Xm, Md^Xm, Md^Xm, Md^Xm, Md^Xm, Md^Xm, Md^Xm, Md^Xm, Md^Xm, Md^Xm, Md^Xm, Md^Xm, Md^Xm, Md, Md, Hhd, Dd, Dd, Wot, Wot, Ds, Ds, Ds, Dd, Dd^Vdt, Dd, Rd, Dd, Ds^Edpp, Dd, Ds, Dd, Hd, Md^Xm, Md^Xm, Md, Md, Hhd, Hd, Hd, Hd, Dd, Dd, Ds^Dr, Dd, Dd, Dd, Dd, Ds, Dd, Dd, Dd, Dd, Hd, Hd, Dd, Hd, Dd, Dd, Dd, Hd, Hd, Hd, Md, Md^Xm, Md^Xm, Md, Md, Hd, Hd, Hd, Hd, Dd, Dd, Hd, Hd, Dd, Hd, Hd, Dd, Dd, Hd, Dd, Dd, Rd, Dd, Dd, Dd, Ds^Edpp, Dd, Hd, Hd, Hd, Dd, Hd, Hhd, Md, Md, Md^Xm, Md^Xm, Md
Md^Xm, Md^Xm, Md^Xm, Md^Xm, Md^Xm, Md^Xm, Md^Xm, Md^Xm, Md^Xm, Md^Xm, Md^Xm, Md^Xm, Md^Xm, Md, Md, Hhd, Hhd, Dd, Dd, Ds, Ds, Wot, Wwt, Ce, Ce, Dd, Rd, Dd, Dd^Es, Dd^Edpp, Dd, Dd, Dd, Hd, Md^Xm, Md^Xm, Hhd, Md, Hhd, Hd, Dd, Hd, Dd, Ds^Es, Ds, Dd, Rd, Rd, Dd, Dd, Dd, Dd, Dd, Dd, Hd, Hd, Dd, Hd, Hd, Dd, Dd, Hd, Hd, Md, Md, Md, Md^Xm, Md, Md^Xm, Md, Md, Hhd, Hd, Dd, Dd, Dd, Hd, Dd, Hd, Hd, Hd, Hd, Dd, Dd, Rd, Dd, Dd, Dd, Rd, Dd, Dd, Dd, Dd, Hd, Dd, Hd, Hd, Md, Md, Md^Xm, Md^Xm, Md^Xm
Md^Xm, Md^Xm, Md^Xm, Md^Xm, Md^Xm, Md^Xm, Md^Xm, Md^Xm, Md^Xm, Md^Xm, Md^Xm, Md^Xm, Md^Xm, Md, Md, Hhd, Dd, Dd, Dd, Dd, Ce, Wot, Wwt, Re, Re, Rd, Rd, Dd, Dd, Dd^Es, Dd, Hd, Md, Md, Md, Md^Xm, Hhd, Md, Hhd, Hhd, Dd, Dd, Dd, Ds, Dd, Dd, Rd, Rd, Hd, Dd, Dd, Dd, Hd, Dd, Dd, Hd, Dd, Dd, Hd, Dd, Hd, Hd, Hd, Md, Md, Md^Xm, Md^Xm, Md^Xm, Md^Xm, Md^Xm, Md, Hhd, Hhd, Dd, Hd, Dd, Hd, Dd, Hd, Hd, Hd, Hd, Dd, Dd, Dd, Dd, Rd, Dd, Dd, Dd, Dd, Hd, Dd, Dd, Dd, Dd, Hd, Hhd, Md, Md^Xm, Md, Md^Xm
Md^Xm, Md^Xm, Md^Xm, Md^Xm, Md^Xm, Md^Xm, Md^Xm, Md^Xm, Md^Xm, Md^Xm, Md^Xm, Md, Md, Md, Md, Hhd, Dd, Ds, Ds, Dd, Re, Wwt, 3 Kdr, Rr, Rd, Rd^Vdt, Rd, Dd, Ce, Dd, Dd, Dd, Hd, Hd, Hd, Hhd, Hhd, Dd, Dd, Dd, Cdr, Hd, Dd, Dd, Dd, Dd, Dd, Dd, Dd, Hd, Hd, Hd, Hd, Hd, Dd, Hd, Dd, Dd, Dd, Hd, Ds, Dd, Dd, Hd, Hd, Md, Md, Md^Xm, Md^Xm, Md^Xm, Md^Xm, Md, Md, Hd, Hhd, Hd, Hd, Hd, Hd, Hd, Hd, Hd, Dd, Dd, Ds, Dd, Dd, Rd, Dd, Dd, Hd, Hd, Dd, Dd, Dd, Dd, Hd, Hd, Hd, Md, Md, Md
Md^Xm, Md^Xm, Md^Xm, Md^Xm, Md^Xm, Md^Xm, Md^Xm, Md^Xm, Md^Xm, Md^Xm, Md^Xm, Md, Md^Xm, Md, Md, Hhd, Dd, Dd, Ds, Ce, Re, Rr, Cdr, Cdr, Rd, Rd, Rd, Re, Ce, Dd, Dd, Dd, Hd, Hd, Dd, Dd, Dd, Dd, Dd, Dd, Dd, Dd, Dd, Rr, Rd, Rd, Dd, Dd, Dd, Hd, Hd, Hd, Ds, Dd, Dd, Hd, Hd, Dd, Dd, Dd, Ds^Es, Dd, Dd, Dd, Hd, Hd, Md, Md, Md, Md^Xm, Md^Xm, Md^Xm, Md^Xm, Md, Hhd, Hd, Hhd, Hd, Md, Hd, Hd, Hd, Dd, Dd, Dd, Ds, Dd, Rd, Dd, Dd, Dd, Dd, Dd^Edpp, Dd, Dd, Hd, Hd, Dd, Dd, Hhd, Hhd, Hhd
Md^Xm, Md^Xm, Md^Xm, Md^Xm, Md^Xm, Md^Xm, Md^Xm, Md^Xm, Md^Xm, Md^Xm, Md^Xm, Md, Md, Md, Hhd, Hhd, Hhd, Dd, Ds, Ce, Rd, Cdr, Rd, Rd, Rd, Rd, Rd, Re, Dd, Dd, Hd, Hd, Dd, Dd, Dd, Dd, Dd, Dd, Dd, Dd, Hd, Dd, Rd, Rr, Dd, Dd, Dd, Dd, Hd, Hd, Dd, Ds, Ds^Es, Ds^Edpp, Ds, Dd, Hd, Hd, Dd, Ds^Edp, Dd^Es, Dd, Dd, Hd, Hd, Hd, Md, Md, Md, Md, Md, Md^Xm, Md^Xm, Md, Md, Hhd, Hhd, Hd, Md, Hd, Hd, Hd, Dd, Hd, Dd, Ds, Dd^Es, Dd, Dd, Rd, Dd, Dd, Dd, Ds, Dd, Hd, Hd, Dd, Dd, Dd, Dd, Dd
Md^Xm, Md^Xm, Md^Xm, Md^Xm, Md, Md^Xm, Md, Md^Xm, Md, Md^Xm, Md, Md, Md, Hhd, Hhd, Dd, Dd, Dd, Dd, Ds, Dd, Dd, Rd, Rd^Es, Rd, Rd, Ce, Rd, Dd, Dd, Dd, Dd, Dd, Dd, Dd, Cdr, Dd, Dd, Dd, Dd, Hd, Dd, Dd, Rd, Hd, Hd, Hd, Hd, Dd, Dd, Ds^Es, Ds^Es, Ds, Ds, Ds, Dd, Hd, Hd, Dd, Dd, Dd, Dd, Dd, Dd, Dd, Hd, Hd, Md, Md^Xm, Md, Md, Md, Md^Xm, Md^Xm, Md, Hhd, Md^Xm, Md^Xm, Md, Hhd, Hd, Hd, Dd, Dd, Dd, Dd, Dd, Dd, Dd, Rd, Rd, Dd, Dd, Ds, Ds, Dd, Dd, Hd, Hd, Hd, Hd, Dd
Md^Xm, Md^Xm, Md, Md, Md, Md, Md, Md, Md, Md^Xo, Md^Xo, Md, Md, Hhd, Dd, Dd, Ds, Ds, Dd, Dd^Edpp, Dd, Dd^Vdt, Rd, Rd, Rd, Ce, Dd, Dd, Dd, Rd, Rd, Dd, Dd, Dd, Dd, Dd, Dd, Dd, Hd, Hd, Dd, Dd, Dd, Dd, Dd, Dd, Dd, Dd, Dd, Ds^Edpp, Dd, Dd, Dd, Cdr, Hd, Hd, Hd, Hd, Dd, Dd, Hd, Dd, Dd^Edpp, Dd, Dd, Wot, Wot, Wot, Md, Md, Md^Xm, Md, Md^Xm, Md^Xm, Md, Hhd, Md^Xm, Md^Xm, Md, Hhd, Hd, Dd, Dd, Rd, Dd, Hd, Dd, Rd, Dd, Dd, Dd, Rd, Dd, Ds, Ds, Ds^Edpp, Dd, Dd, Hd, Md, Md^Xm, Hd
Md, Md, Md, Md, Md, Md, Hhd, Hhd, Md, Md, Hhd, Hhd^Xo, Hhd, Md, Md, Dd, Dd, Dd, Dd, Dd, Dd, Rd, Dd, Dd, Dd, Dd, Dd, Hd, Dd, Dd, Rd, Rr, Dd, Dd, Rd, Dd, Dd, Hd, Dd, Dd, Re, Rd, Hd, Hd, Hd, Dd, Dd, Hd, Hd, Dd, Dd, Hd, Dd, Dd, Hd, Dd, Dd, Dd, Ds, Ds, Hd, Dd, Wot, Ds, Ds, Wot, Dd, Hd, Hd, Md, Md, Md^Xm, Md^Xm, Md^Xm, Md^Xm, Md^Xm, Md^Xm, Md, Hd, Hd, Hd, Dd, Dd^Edpp, Rd, Rd, Hd, Hd, Dd, Dd, Dd^Vct, Rd, Dd, Dd, Dd, Rd, Dd, Ds, Hd, Hd, Hd, Md, Hd
Md, Md, Md, Gd, Gd, Md, Hhd, Gd, Gd, Hhd, Gd, Gd^Xo, Hhd^Xo, Hhd, Hhd, Dd, Dd, Cdr, Dd, Dd, Dd, Dd, Dd, Dd, Dd^Es, Ds, Dd, Hd, Dd, Dd, Dd, Rd, Dd, Dd, Dd, Rd, Rd, Rd, Re, Re, Dd, Rd, Hd, Dd, Hd, Hd, Hd, Hd, Hd, Dd, Dd, Ds, Dd, Hd, Dd, Dd, Ds, Ds, Dd, Hd, Wwt, Wwt, Wot, Wot, Wot, Wot, Dd, Hd, Hd, Md, Md, Md, Md^Xm, Md^Xm, Md^Xm, Md^Xm, Md, Md, Hd, Hd, Hd, Dd, Dd^Edpp, Dd^Edpp, Dd^Edpp, Dd, Dd, Dd, Dd, Dd, Ce, Ce, Ce, Rd, Dd, Dd, Ds^Edpp, Dd, Dd, Hd, Hd, Hd
Md, Hhd, Hhd, Hhd, Gd, Gd, Ds, Ds, Ds, Ds, Dd, Ds, Dd, Dd^Xo, Dd, Rd, Ds, Dd, Rd, Rd, Dd, Dd, Dd^Edpp, Dd, Ds^Es, Ds, Dd, Hd, Hd, Dd, Dd, Dd, Hd, Dd, Dd, Dd, Dd, Rd, Dd, Dd, Dd, Hd, Hd, Dd, Hhd, Hhd, Hd, Hd, Hd, Dd, Hd, Ds, Dd, Dd, Dd, Dd, Ds, Ds, Hd, Hd, Dd, Wwt, Wwt, Wot, Wot, Dd, Hd, Dd, Hd, Hd, Hd, Hhd, Md, Md^Xm, Md^Xm, Md^Xm, Md, Md, Hd, Hd, Hd, Hd, Dd, Dd^Edpp, Dd^Edpp, Dd, Dd, Rd, Dd, Dd, Ce, 1 Ke, Ce, Rd, Dd^Vct, Ds, Rd, Dd^Edpp, Dd, Hd, Dd, Hd
Hhd, Hhd, Ds, Ds, Rd, Cdr, Dd, Ds^Edpp, Dd^Edp, Dd^Es, Dd, Rd, Rd, Dd^Xo, Rd^Xo, Ds, Ds, Dd, Rd, Dd, Dd, Dd, Dd, Dd, Dd, Dd, Dd, Dd, Dd, Hd, Dd, Dd, Dd, Hd, Dd, Dd, Dd, Dd, Hd, Dd, Dd, Hd, Hd, Hhd, Md, Md, Md, Hd, Hd, Hd, Hd, Dd, Hd, Hd, Dd, Dd, Dd, Hd, Hd, Md, Hhd, Dd, Wwt, Wot, Wwt, Ds, Dd, Dd, Dd, Hd, Hd, Md, Md, Md^Xm, Md^Xm, Md, Md, Hd, Hd, Hd, Hd, Dd, Ds, Dd^Edpp, Dd, Dd, Dd, Dd, Dd, Dd, Dd, Ce, Rd, Dd, Hd, Ds, Dd, Rd, Dd^Edpp, Hd, Dd, Hd
Dd, Ds, Dd^Es, Ds, Ds^Edpp, Rd, Rd, Dd^Edpp, Rd, Dd, Rd, Rd, Rd, Rd, Dd, Ds^Xo, Rd, Rd, Dd, Dd, Dd, Dd, Dd, Dd, Dd, Hhd, Hhd, Dd, Dd, Hd, Hd, Cdr, Dd, Dd, Hd, Hd, Hd, Hd, Md, Hd, Hd, Hd, Md, Md, Md^Xm, Md, Md, Hhd, Hd, Hd, Hd, Hd, Hd, Dd, Dd, Dd, Hd, Hd, Md, Md, Hhd, Dd, Ds, Wwt, Hd, Dd, Hd, Dd, Hd, Md, Hd, Md, Md, Md^Xm, Md^Xm, Md, Md, Hhd, Hhd, Hd, Hd, Dd, Ds, Ds, Hd, Dd, Ds, Dd^Edpp, Dd, Dd, Dd, Rd, Dd, Dd, Hd, Dd, Dd, Rd, Ds, Ds, Ds, Dd
Rd, Dd, Rd, Ds^Edpp, Rd, Rd, Dd^Edpp, Rd, Rd, Ds, Ds^Es, Ds, Dd, Dd, Gd, Dd^Xo, Dd^Xo, Dd, Hhd, Hhd, Dd, Cdr, Dd, Hhd, Hhd, Md, Md, Hhd, Hhd, Dd, Dd, Dd, Dd, Hd, Dd, Hd, Hd, Hhd, Md, Hhd, Hd, Hd, Md, Md, Hhd, Md^Xm, Md^Xm, Hhd, Hhd, Hd, Md, Md, Hd, Hd, Dd, Hd, Dd, Md, Md, Md, Hd, Hd, Dd, Ds, Dd, Dd, Hd, Hd, Md, Md, Md, Md, Md^Xm, Md^Xm, Md^Xm, Md, Md, Md, Hhd, Hd, Hd, Dd, Hd, Dd, Dd, Dd, Ds, Dd^Edpp, Dd^Edpp, Dd^Es, Dd, Rd, Hd, Hd, Md^Xm, Md, Hd, Dd, Ds, Dd, Dd, Ds
Dd, Rd, Dd, Rd, Ds, Dd, Rd, Rd, Rd, Ds, Gd, Dd, Hhd, Hhd, Hhd, Hhd, Md, Hhd^Xo, Md^Xm, Hhd, Hhd, Dd, Md, Md, Md, Md, Md^Xm, Md^Xm, Md, Hhd, Dd, Dd, Dd, Dd, Hd, Hd, Hd, Hhd, Md^Xm, Md, Hhd, Hd, Hd, Hhd, Hhd, Md^Xm, Md^Xm, Hhd, Md, Md, Md, Hhd, Hd, Hd, Hd, Md, Hd, Md, Hhd, Hd, Dd, Dd, Dd^Edpp, Ds, Dd, Dd, Hd, Dd, Md, Hhd, Hd, Md^Xm, Md^Xm, Md^Xm, Md^Xm, Md, Md, Md, Md, Hd, Hhd, Hd, Hd, Hd, Dd, Ds, Ds, Dd, Dd, Dd, Rd, Dd, Hd, Md, Md, Hhd, Hd, Ds, Ds^Es, Hd, Hd, Ds
Dd, Dd, Dd, Dd, Dd, Dd, Ds, Ds, Gd, Rd, Hhd, Hhd, Hhd, Hhd, Md, Md, Md^Xm, Md, Md^Xm, Md, Md^Xm, Hhd, Md, Md^Xm, Md^Xm, Md^Xm, Md^Xm, Md^Xm, Md, Hhd, Dd, Dd, Dd, Dd, Hd, Hd, Hd, Hhd, Md, Md^Xm, Md^Xm, Hhd, Hhd, Hd, Md, Md, Md, Md, Md, Hhd, Hhd, Hhd, Dd, Dd, Dd, Hd, Dd, Dd, Hd, Hd, Dd, Dd, Dd, Dd, Dd, Dd, Dd, Dd, Dd, Hd, Hd, Md, Md, Md, Md, Md^Xm, Md^Xm, Md, Md, Md, Hhd, Hd, Hd, Hd, Dd, Dd, Dd, Dd, Dd, Rd, Dd, Dd, Dd, Md, Hd, Dd, Dd, Dd, Dd, Dd, Dd, Dd
