Dd, Dd, Dd^Es, Dd, Dd, Dd, Dd, Dd, Dd^Eff, Dd, Dd, Dd, Dd, Ds, Ds, Wot, Wot^Qhu, Wot^Qhu, Wwt^Qhu, Wot^Qhu, Wot^Qhu, Wot^Qhu, Wot^Qhu, Ds, Ds, Dd, Dd, Dd, Dd, Ds, Ds, Dd, Hd, Hd, Mdd, Mdd^Xm, Mdd^Xm, Mdd^Xm, Mdd, Hd, Hd, Hd, Hd, Dd, Dd, Hd, Hd, Hd, Hd, Dd, Hd, Mdd, Mdd^Xm, Mdd, Hd, Hd, Dd, Dd, Dd, Hd, Hd, Dd, Dd, Hd, Hd, Hd, Dd, Hd, Dd, Hd, Hd, Hd, Hd, Mdd^Xm, Mdd^Xm, Mdd^Xm, Mdd^Xm, Md^Xm, Mdd, Mdd^Xm, Hd, Dd, Dd, Dd, Dd, Dd, Dd, Dd, Hd, Dd, Ds, Dd, Hd, Hd, Hd, Dd, Dd, Dd, Hd, Dd, Dd, Dd
Rd, Dd, Rd, Dd, Dd^Eff, Dd, Dd^Eff, Dd^Eff, Dd, Ce, Dd, Dd^Vdt, Dd, Dd, Ds, Ds, Wwrt^Qhu, Wwt^Qhu, Ds, Wwt^Qhu, Wot^Qhu, Wot^Qhu, Wwrt^Qhu, Ds, Ds, Dd, Dd, Ce, Dd, Ds, Dd, Dd, Hd, Hd, Mdd, Mdd^Xm, Mdd^Xm, Mdd, Mdd, Hd, Hd, Hd, Dd, Hd, Hd, Hd, Dd, Dd, Mdd, Hd, Hd, Mdd, Mdd^Xm, Mdd, Hd, Hd, Dd, Ds, Dd, Dd, Dd, Dd, Dd, Dd, Hd, Hd, Dd, Dd^Xo, Hd, Hd, Dd, Hd, Hd, Mdd^Qhh, Mdd, Mdd^Xm, Mdd^Xm, Mdd^Xm, Mdd^Qhh, Hd, Hd, Hd, Dd, Dd, Dd, Dd, Hd, Hd, Dd, Ds^Edp, Rd, Dd^Dr, Dd, Dd, Cdr, Dd, Ds, Hd, Dd, Dd, Hd, Dd
Dd, Rd^Esd, Dd, Rd^Esd, Rd, Dd^Eff, Rd, Dd, Dd, Dd, Rd, Rd^Esd, Dd, Ce, Ce, Dd^Qhu, Wwf^Qhu, Ds, Dd^Vdt, Wwt^Qhu, Dd, Wwrt^Qhu, Ds, Ds, Dd, Dd, Dd, Dd, Dd, Dd, Hd, Hd, Hd, Hd, Mdd^Qhh, Mdd^Xm, Mdd, Mdd^Xm, Hd, Hd, Hd, Hd, Hd, Hd, Hd, Hd, Hd, Dd, Mdd, Hd, Mdd^Xm, Mdd^Xm, Hd, Hd, Dd, Dd, Dd, Dd, Ds, Ds, Dd, Ds, Ds, Dd, Dd, Hd, Dd, Dd^Xo, Hd, Hd, Dd, Hd, Hd, Mdd^Qhh, Mdd, Mdd^Xm, Mdd^Xm, Hd^Qhh, Hd, Hd, Hd, Dd, Dd, Dd, Dd, Hd, Hd, Dd, Cdr, Ds, Rd, Dd, Cdr, Kdr, Hd, Hd, Rd, Hd, Cdr, Dd, Hd, Dd
Dd, Dd, Dd, Dd, Dd, Rd, Dd, Rd, Rd, Rd, Rd, Dd^Vda, Ds, Ce, Wwt^Qhu, Wwrt^Qhu, Ds, Dd, Rd, Dd, Dd, Dd, Dd, Dd, Ce, Dd, Dd, Ds, Dd, Hd, Hd, Hd, Hd, Hd, Hd, Hd^Qhh, Mdd^Qhh, Mdd^Xm, Mdd^Xm, Mdd, Mdd, Hd, Mdd, Hd, Mdd, Mdd, Mdd, Mdd, Mdd^Xm, Mdd^Xm, Hd^Qhh, Mdd^Qhh, Hd, Hd, Dd, Dd, Ds, Dd, Dd, Dd, Ds, Ds, Dd, Dd, Dd, Dd, Dd^Dc, Dd^Xo, Dd, Dd, Dd, Dd, Hd, Mdd^Qhh, Mdd^Qhh, Mdd^Xm, Mdd^Qhh, Hd^Qhh, Hd, Dd, Dd, Hd, Dd, Dd, Ds, Ds, Ds, Ds, Ds, Ds, Ds^Es, Dd, Dd, Dd, Hd, Dd, Rd, Ds, Dd, Cdr, Dd, Hd
Dd, Dd, Dd, Dd^Eff, Dd^Eff, Rd^Esd, Dd^Vdt, Dd, Rd^Esd, Dd, Dd, Rd^Esd, Ds, Wwf^Qhu, Ds^Qhu, Dd, Dd, Ce, Rd^Esd, Dd, Ce, Dd, Dd, Dd, Dd, Dd, Ds, Ds, Dd, Hd, Hd^Qhh, Mdd, Mdd^Qhh, Hd, Hd, Hd^Qhh, Hd^Qhh, Hd, Mdd, Mdd^Xm, Mdd^Xm, Mdd, Mdd, Mdd, Mdd, Mdd, Mdd, Mdd, Mdd^Xm, Hd^Qhh, Hd, Hd^Qhh, Hd, Dd, Dd, Dd, Ds, Dd, Dd, Ds, Dd, Dd, Dd, Ds, Dd, Dd, Dd, Dd^Xo, Ds, Ds, Dd, Hd, Mdd, Mdd^Qhh, Hd^Qhh, Hd^Qhh, Mdd^Qhh, Mdd, Hd, Dd, Dd, Hd, Dd, Dd, Dd, Ds, Ds^Dr, Ds^Es, Ds, Ds, Dd, Dd, Dd, Dd^Vdr, Ds, Dd, Dd, Rd^Esd, Dd, Cdr, Hd, Hd
Dd, Dd, Dd^Eff, Dd^Eff, Dd, Dd, Dd, Dd^Edpp, Dd, Rd, Ce, Dd, Wwf^Qhu, Wwf^Qhu, Ds, Ds, Dd, Ce, Rd, Dd, Dd, Dd, Dd, Dd, Dd^Edpp, Dd^Edpp, Ds, Ds, Ds, Dd, Hd, Mdd^Qhh, Hd^Qhh, Hd, Hd, Dd, Dd, Hd, Hd, Mdd, Mdd^Xm, Mdd, Mdd^Xm, Mdd^Xm, Mdd^Xm, Mdd^Xm, Mdd^Xm, Mdd^Xm, Mdd^Qhh, Hd^Qhh, Dd, Hd, Dd, Dd, Dd, Ds, Dd, Dd, Dd, Dd, Ds, Dd, Dd, Dd, Hd, Dd, Dd, Ds^Xo, Dd, Ds, Dd, Hd, Dd, Dd, Hd, Mdd^Qhh, Dd, Hd, Dd, Dd, Dd, Dd, Dd, Dd, Dd, Ds^Es, Ds, Dd, Hd, Ds, Rd^Esd, Cdr, Dd, Ds, Ds, Cdr, Cdr, Dd, Dd, Ds, Hd, Dd
Hd, Dd, Dd, Ds, Ce, Ce, Dd, Dd, Dd, Ce, 4 Ket, Ce, Rd, Ds, Dd, Rd, Rd, Rd, Dd^Vda, Dd, Dd^Edpp, Dd, Dd, Dd, Dd^Edpp, Dd, Ds, Dd, Dd, Dd, Hd, Mdd^Qhh, Hd, Hd, Dd, Dd, Hd, Hd, Hd, Mdd, Mdd^Xm, Mdd^Xm, Mdd, Hd, Hd, Hd, Mdd, Mdd^Qhh, Hd, Dd, Hd, Hd, Dd, Dd, Dd, Dd, Dd, Dd, Dd, Dd, Dd, Dd, Hd, Dd, Hd, Hd, Dd, Dd^Xo, Dd, Ds, Dd, Dd, Dd, Hd, Hd, Mdd^Qhh, Dd, Dd, Dd, Dd, Hd, Dd, Dd, Dd, Dd, Dd, Ds, Hd, Ds, Dd, Rd, Dd, Hd, Hd, Dd, Dd, Dd, Dd, Hd, Hd, Hd, Hd
Hd, Dd, Ds, Ds, Dd, Ce, Dd, Dd, Rd, Ce, Ce, Ce, Rd, Dd, Dd, Rd, Rd, Rd, Dd, Dd, Dd, Dd, Dd^Eff, Dd, Dd^Eff, Ds^Eff, Ds, Dd, Hd, Hd, Dd, Hd, Hd, Hd, Dd, Dd, Hd, Hd, Hd^Qhh, Mdd^Xm, Mdd, Mdd, Hd^Qhh, Mdd^Qhh, Hd, Hd, Hd, Mdd, Dd, Dd, Dd, Hd, Dd, Dd, Dd, Dd, Dd, Dd, Dd, Dd^Dc, Dd, Dd, Dd, Hd, Hd, Hd, Dd, Ds^Xo, Dd, Dd, Dd, Ds, Dd, Hd, Dd, Dd, Dd, Dd, Dd, Dd, Hd, Hd, Hd, Dd, Dd, Ds, Ds, Ds, Dd, Rd^Esd, Dd, Hd, Hd, Ds, Dd, Dd, Dd, Rd, Dd, Hd, Dd, Dd
Hd, Dd, Dd, Ds, Dd, Dd, Dd, Dd^Vda, Dd, Dd, Dd, Dd, Dd, Dd, Ce, Dd, Dd, Rd, Rd^Esd, Dd, Dd, Dd^Eff, Dd^Es, Dd^Eff, Dd, Ds, Ds, Dd, Dd, Dd, Dd, Dd, Dd, Hd, Hd, Hd, Hd, Hd^Qhh, Mdd^Qhh, Mdd^Xm, Mdd^Qhh, Hd^Qhh, Hd, Dd, Dd, Hd, Dd, Hd, Dd, Dd, Dd, Dd, Rd, Rd, Re, Rd^Esd, Dd, Rd, Dd, Dd, Rd^Esd, Dd, Co, Dd, Dd, Hd, Dd, Dd^Xo, Hd, Dd, Dd, Dd, Ds, Dd, Ds^Es, Dd, Dd, Dd^Dc, Dd, Dd, Dd, Hd, Hd, Dd, Dd^Edpp, Dd, Dd, Dd, Dd^Es, Dd, Dd, Hd, Ds, Dd, Dd^Edp, Cdr, Ds, Ds^Dr, Ds, Hd, Dd, Dd
Hd, Hd, Dd, Ds^Es, Dd, Ds^Edpp, Ds^Edpp, Dd, Dd, Dd, Dd, Dd, Ce, Ce, Dd, Dd, Dd, Dd, Dd, Rd^Esd, Rd, Dd, Dd, Dd, Ds, Ds, Dd, Dd, Dd, Ds, Ds, Dd, Dd, Hd, Hd, Hd, Hd, Mdd^Qhh, Mdd^Xm, Mdd^Xm, Mdd^Qhh, Mdd^Qhh, Hd, Hd, Dd, Dd, Dd, Dd, Dd, Rd, Rd, Dd, Dd, Dd, Dd, Dd, Dd, Dd, Dd, Rd^Esd, Rd^Esd, Rd, Rd, Dd, Dd, Dd, Hd, Hd^Xo, Dd, Dd, Dd, Ds, Dd, Dd, Dd, Ds, Ds, Ds, Dd, Dd, Dd, Dd, Hd, Dd, Dd^Edpp, Dd^Edpp, Dd^Edpp, Dd^Edpp, Rd^Esd, Rd, Dd^Edpp, Dd, Ds, Dd, Dd, Dd, Ds, Ds^Es, Dd, Dd, Dd, Dd
Dd, Dd, Dd, Dd, Hd, Dd, Ds, Dd, Dd, Ce, Ce, Ce, Dd, Dd, Dd, Dd, Dd^Eff, Dd^Eff, Dd, Rd, Dd, Rd, Dd, Dd, Dd, Dd, Dd, Dd, Ds, Ds, Ds, Dd, Hd, Dd, Hd, Hd, Mdd, Mdd, Mdd^Xm, Mdd, Hd^Qhh, Hd^Qhh, Dd, Dd, Ds, Hd, Ds, Ds, Rd^Esd, Rr, Dd, Dd, Dd, Dd, Ds, Dd, Hd, Dd, Dd, Dd, Hd, Rd, Rd, Dd, Dd, Dd, Hd, Hd^Xo, Dd, Dd, Dd, Ds, Dd, Hd, Hd, Dd, Ds, Ds, Dd, Dd, Hd, Hd, Dd, Dd, Dd^Edpp, Dd^Es, Dd^Edpp, Rd, Dd^Edpp, Dd^Edpp, Dd, Ds, Dd, Dd, Dd, Rd, Ds, Ds^Edp, Dd, Dd, Hd, Hd
Hd, Dd, Dd, Hd, Dd^Edpp, Dd, Dd, Ds, Dd, Dd, Dd, Dd, Dd^Eff, Dd^Eff, Dd, Dd, Dd, Dd, Dd, Dd^Vdt, Dd, Dd, Dd, Rd, Rd, Dd, Dd, Cdr, Ds, Ds, Dd, Dd, Dd, Hd, Mdd, Hd, Hd, Mdd^Xm, Hd^Qhh, Hd^Qhh, Hd, Dd, Dd, Dd, Ds, Ds^Edp, Ds, Ds, Ds, Dd, Dd, Dd^Dc, Dd, Dd, Ds, Ds, Dd, Dd, Dd, Dd, Hd, Rd, Rd^Esd, Dd, Rd, Hd, Dd, Hd^Xo, Hd^Xo, Dd^Xo, Dd^Xo, Dd^Xo, Dd^Xo, Dd^Xo, Dd^Xo, Dd^Xo, Ds^Xo, Ds^Xo, Dd^Xo, Hd^Xo, Dd^Xo, Dd^Xo, Dd^Xo, Dd^Xo, Rd^Xo, Dd^Xo, Dd^Xo, Rd^Xo, Dd^Xo, Dd^Xo, Hd^Xo, Ds^Xo, Dd^Xo, Dd^Xo, Hd^Xo, Ds^Xo, Dd^Xo, Dd^Xo, Dd^Xo, Hd^Xo, Hd^Xo, Hd
Hd, Dd, Dd, Dd, Dd, Dd, Hd, Dd, Hd, Dd, Hd, Dd, Dd, Hd, Dd, Dd, Dd, Hd, Dd, Dd, Dd, Dd, Dd^Es, Ds, Rd, Rd^Esd, Dd, Dd, Ds, Dd, Dd, Dd, Hd, Hd, Mdd, Mdd, Mdd^Xm, Mdd^Xm, Hd^Qhh, Hd^Qhh, Hd, Dd, Ds, Ds^Es, Dd^Edpp, Rd, Ds, Rd, Ds, Ds, Ds, Dd, Hd, Dd, Ds, Hd, Hd, Dd, Dd, Dd, Hd, Rd, Co, Dd, Rd, Dd, Dd, Dd^Xo, Dd, Dd, Ds, Dd, Dd, Ds, Dd, Dd, Ds, Ds, Ds, Ds, Ds, Dd, Gd, Dd, Rd, Rd, Dd, Dd, Hd, Dd, Dd, Hd, Hd, Dd, Dd, Dd, Hd, Dd, Hd, Dd, Dd, Hd
Hd, Hd, Dd, Hd, Dd, Dd, Hd, Hd, Hd, Dd, Hd, Hd, Dd, Hd, Hd, Dd, Hd, Hd, Hd, Dd, Dd, Dd, Dd, Ds, Ds, Dd, Dd, Ds, Dd, Dd, Hd, Dd, Hd, Hd, Mdd, Mdd, Mdd^Xm, Mdd^Xm, Mdd, Hd, Hd, Dd, Ds, Ds, Dd, Dd, Re, Rd^Esd, Dd, Dd, Rd^Esd, Dd, Dd, Ds, Dd, Hd, Dd, Dd, Dd, Hd, Dd, Dd, Dd, Dd, Rd^Esd, Rd^Esd, Rd^Esd, Dd^Xo, Dd, Dd, Dd, Dd, Gs^Vc, Ds, Ds, Ds, Wwt, Ds, Ds, Ds, Wwf, Gs, Gs^Vo, Gs, Rd^Esd, Dd, Dd, Hd, Dd, Hd, Hd, Dd, Hd, Dd, Dd, Dd, Dd, Dd, Dd, Dd, Hd, Hd
Hd, Hd, Dd, Hd, Hd, Hd, Hd, Hd, Hd, Dd, Dd, Hd, Hd, Hd, Hd, Hd, Hd^Qhh, Hd, Hd, Hd, Hd, Dd, Dd, Dd, Ds, Dd, Dd, Ds, Ds, Dd, Dd, Hd, Mdd, Mdd, Mdd^Xm, Mdd^Xm, Mdd, Mdd, Hd, Hd, Hd, Dd, Ds, Dd, Rd, Re, Dd, Dd, Dd, Rd, Dd, Dd, Dd, Dd, Dd, Dd, Dd, Dd, Dd, Hd, Dd, Dd, Hd, Dd, Dd, Rd, Rd, Dd^Xo, Dd, Dd, Gd, Gs^Fts, Gs^Ft, Gs, Wwt^Bw\r, Wwt^Es, Wot, Wot, Wot^Es, Wwrt, Wwt, Wwrt, Wwrt, Gs^Fts, Gd^Ft, Dd, Ds, Dd, Dd, Dd, Hd, Hd, Hd, Dd, Hd, Dd, Dd, Hd, Hd, Dd, Hd^Qhh, Mdd^Qhh
Mdd^Qhh, Hd^Qhh, Hd^Qhh, Hd, Hd, Hd, Hd, Hd, Hd, Hd, Hd^Qhh, Hd, Hd, Hd, Hd, Hd^Qhh, Mdd^Qhh, Mdd, Hd, Hd, Mdd, Hd, Hd, Dd, Dd, Dd, Dd, Rd, Rd, Dd, Dd, Mdd, Hd, Mdd^Xm, Mdd^Xm, Hd, Hd, Hd, Hd, Hd, Dd, Dd, Dd, Dd, Re, Re^Esd, Dd, Ds^Edpp, Ds, Dd, Dd, Ds, Dd, Dd, Dd, Dd^Dc, Dd, Dd, Dd, Dd, Dd, Dd, Hd, Dd, Dd, Dd, Rd, Re^Xo, Rd, Dd, Gd^Ft, Gs^Fts, Wwf, Wwt, Wwrt, Wwt, Wot, Wot, Wot, Wot, Wot, Wwt, Wwt, Gs^Ft, Ds, Ds^Es, Dd, Dd, Dd, Dd, Hd, Hd, Hd, Hd, Hd, Hd, Mdd, Mdd, Mdd^Qhh, Hd, Mdd^Qhh, Mdd
Mdd, Mdd^Qhh, Hd^Qhh, Mdd, Mdd, Mdd, Hd, Mdd^Qhh, Hd^Qhh, Hd, Mdd^Qhh, Hd^Qhh, Hd^Qhh, Hd, Hd, Hd^Qhh, Mdd^Qhh, Mdd, Mdd^Xm, Mdd, Mdd, Mdd, Hd, Hd, Dd, Cdr, Dd, Dd, Ds, Ds, Dd, Hd, Hd, Mdd^Xm, Hd, Hd, Mdd^Qhh, Hd, Hd, Hd, Hd, Dd, Dd, Dd, Dd, Dd, Dd, Ds, Dd, Dd, Dd, Dd, Dd, Dd, Dd, Dd, Dd, Dd, Hd, Dd, Dd, Hd, Mdd^Qhh, Dd, Dd, Dd, Rd^Esd, Dd^Xo, Dd, Dd, Gd, Gs, Wwf^Es, Wwrt^Ewl, Wwt, Wot, Wot, Wot, Co, Wot, Wwt, Wot, Wwf, Ds, Ds, Ds^Edpp, Ds, Ds, Hd, Dd, Hd, Hd, Hd, Hd, Hd, Hd, Hd^Qhh, Hd^Qhh, Hd, Hd^Qhh, Hd, Mdd
Mdd, Mdd, Mdd, Mdd, Mdd, Hd, Mdd, Mdd, Mdd, Hd^Qhh, Mdd, Mdd^Qhh, Mdd^Qhh, Hd, Mdd, Mdd, Mdd, Mdd, Mdd^Xm, Mdd^Xm, Mdd^Xm, Mdd^Qhh, Hd^Qhh, Hd, Dd, Dd, Dd, Dd, Ds, Ds, Dd, Hd, Dd, Mdd^Xm, Mdd^Xm, Hd, Mdd, Hd^Qhh, Hd, Hd, Hd, Dd, Dd, Rd^Esd, Dd, Dd, Dd, Ds^Es, Dd, Dd, Hd, Dd, Hd, Mdd, Dd, Dd, Dd, Hd, Hd, Dd, Dd, Hd, Dd, Dd, Dd, Dd, Dd, Rr^Xo, Rd^Esd, Dd, Dd, Gd^Vo, Re, Wwrt, Gs, Co, Wwrt, Wwt, Wwt, Co, Wwf, Wwf^Ewl, Gs^Vo, Gs^Ft, Ds^Ft, Ds, Ds^Es, Ds, Dd, Hd, Hd, Hd, Hd, Hd, Hd, Hd, Mdd^Qhh, Mdd, Hd^Qhh, Mdd, Hd^_mh, Hd
Mdd, Mdd, Mdd, Mdd, Mdd, Mdd, Mdd, Mdd, Mdd, Mdd, Mdd, Mdd, Mdd, Mdd, Mdd, Mdd^Xm, Mdd^Xm, Mdd^Xm, Mdd^Xm, Mdd^Xm, Mdd^Xm, Mdd^Qhh, Hd^Qhh, Hd, Hd, Dd, Ds, Dd, Dd, Rd, Rd^Esd, Dd, Hd, Mdd, Mdd^Xm, Mdd^Xm, Mdd, Mdd^Qhh, Hd^Qhh, Hd, Hd, Hd, Dd, Dd, Rd^Esd, Dd, Dd, Dd, Dd, Hd, Hd, Dd, Dd, Dd, Dd, Dd, Hd, Dd, Dd, Ds, Dd, Dd, Dd, Dd, Dd, Dd, Ds, Dd^Xo, Dd, Dd, Gd, Gs^Ft, Gs^Fts, Re, Re, Gll, Co, Co, Co, Rb, Co, Re, Gs, Gs^Fts, Ds, Ds, Dd, Dd, Hd, Hd, Hd, Dd, Hd, Hd, Dd, Dd, Hd, Mdd^Qhh, Hd, Hd^Qhh, Mdd^Qhh, Hd
Mdd, Mdd, Mdd, Mdd, Mdd, Mdd, Mdd^Xm, Mdd, Mdd, Mdd^Xm, Mdd^Xm, Mdd^Xm, Mdd^Xm, Mdd^Xm, Mdd^Xm, Mdd^Xm, Mdd^Xm, Mdd^Xm, Mdd^Xm, Mdd^Xm, Mdd^Xm, Mdd^Qhh, Hd^Qhh, Hd, Hd, Dd, Dd, Dd, Dd, Rd^Esd, Rd, Dd, Hd, Hd^Qhh, Mdd^Qhh, Mdd^Xm, Mdd^Xm, Mdd, Mdd^Qhh, Hd^Qhh, Hd, Hd, Dd, Dd, Rd, Rd, Dd, Dd, Dd^Dc, Dd, Hd, Dd, Dd, Dd, Hd, Dd, Dd, Dd, Dd, Ds, Hd, Dd, Hd, Dd, Dd, Dd, Dd, Ds^Xo, Ds, Dd, Dd, Gd, Gs^Ft, Gll, Gd^Fts, Re, Co, 2 Ko, Co, Rb, Gll, Gs, Ds, Ds, Dd, Ds^Edpp, Dd, Dd, Hd, Hd, Hd, Hd, Hd, Hd, Hd, Hd, Hd, Hd, Mdd, Hd, Mdd^Qhh, Mdd^Qhh
Mdd, Mdd, Mdd^Xm, Mdd^Xm, Mdd^Xm, Mdd, Mdd^Xm, Mdd^Xm, Mdd^Xm, Mdd, Mdd^Xm, Mdd^Xm, Mdd^Xm, Mdd^Xm, Mdd^Xm, Mdd^Xm, Mdd^Xm, Mdd^Xm, Mdd^Xm, Mdd^Xm, Mdd^Xm, Mdd, Mdd^Qhh, Hd^Qhh, Hd, Hd, Dd, Dd, Ds, Dd, Rd^Esd, Dd, Hd, Hd, Hd^Qhh, Mdd, Mdd, Mdd^Xm, Mdd^Xm, Hd^Qhh, Hd, Hd, Hd, Hd, Dd, Rd^Esd, Dd, Dd, Dd, Dd, Dd, Dd, Dd, Dd, Dd, Hd, Dd, Dd, Dd, Dd, Hd, Hd, Dd, Dd, Dd, Hd, Hd, Ds^Xo, Ds, Dd, Dd, Gd^Esd, Dd, Co, Gs, Gs, Re, Co, Re, Re, Re, Gs, Co, Dd, Dd, Ds, Hd, Hd, Hd, Hd, Hd, Hd, Hd, Hd, Hd, Hd, Hd, Mdd, Mdd^Xm, Hd, Hd, Hd
Mdd^Xm, Mdd^Xm, Mdd^Xm, Mdd^Xm, Mdd^Xm, Mdd^Xm, Mdd^Xm, Mdd^Xm, Mdd^Xm, Mdd^Xm, Mdd^Xm, Mdd^Xm, Mdd^Xm, Mdd^Xm, Mdd^Xm, Mdd^Xm, Mdd^Xm, Mdd^Xm, Mdd, Mdd^Xo, Mdd^Xo, Mdd, Mdd^Xo, Hd, Hd, Hd, Dd, Ds, Ds^Edpp, Ds, Ds, Hd, Dd, Dd, Dd, Hd^Qhh, Hd^Qhh, Mdd^Xm, Mdd^Xm, Mdd, Hd, Hd, Hd, Hd, Dd, Dd, Rd^Esd, Dd, Dd, Dd^Dr, Dd, Dd, Dd, Ds^Es, Dd, Hd, Dd, Dd, Mdd^Qhh, Dd, Dd, Hd, Dd, Ds, Dd, Hd, Hd, Dd^Xo, Dd, Dd, Dd, Hd, Dd, Dd, Gd^Vo, Re, Gs, Gs, Gs, Re, Re, Re, Rd^Esd, Dd, Rd, Dd, Dd, Hd, Hd, Hd, Hd, Hd, Hd, Hd, Hd, Hd, Hd, Hd, Mdd, Mdd, Hd, Hd
Mdd^Xm, Mdd^Xm, Mdd^Xm, Mdd^Xm, Mdd^Xm, Mdd^Xm, Mdd^Xm, Mdd^Xm, Mdd^Xm, Mdd^Xm, Mdd^Xm, Mdd^Xm, Mdd^Xm, Mdd^Xm, Mdd^Xm, Mdd^Xm, Mdd^Xm, Mdd, Mdd^Qhh, Mdd^Qhh, Mdd^Qhh, Mdd^Xo, Hd, Hhd^Xo, Hd^Xo, Hd, Dd, Ds, Dd, Ds, Ds, Ds, Ds, Ds, Dd, Hd, Hd^Qhh, Mdd, Mdd^Xm, Mdd, Hd, Hd, Hd, Hd, Dd, Dd, Rd, Dd, Dd, Dd, Dd, Hd, Dd, Dd, Dd, Dd, Dd, Hd, Hd, Dd, Ds, Ds, Dd, Dd, Dd, Hd, Hd, Hd^Xo, Hd, Hd, Hd, Hd, Hd, Dd, Dd, Gd, Dd, Co, Dd, Gd^Vc, Dd, Re, Rd, Dd, Rd^Esd, Dd^Esd, Dd, Hd, Hd, Hd, Hd, Hd, Hd, Mdd, Mdd^Qhh, Hd^Qhh, Mdd^Qhh, Hd, Hd^Qhh, Hd, Hd, Hd
Mdd^Xm, Mdd^Xm, Mdd^Xm, Mdd^Xm, Mdd^Xm, Mdd^Xm, Mdd^Xm, Mdd^Xm, Mdd^Xm, Mdd^Xm, Mdd^Xm, Mdd^Xm, Mdd^Xm, Mdd^Xm, Mdd^Xm, Mdd^Xm, Mdd^Qhh, Mdd^Qhh, Mdd^Qhh, Hd^_mh, Hd^Qhh, Hd, Dd, Dd, Hd, Dd^Xo, Dd^Xo, Dd, Rd^Esd, Ds, Ds^Xo, Cdr, Dd^Xo, Dd, Hd, Hd^Qhh, Mdd, Mdd, Mdd^Xm, Mdd, Hd, Hd, Hd, Dd, Dd, Dd, Dd, Rr, Dd, Hd, Hd, Dd, Ds^Es, Ds, Ds, Ds, Dd, Dd, Dd, Dd, Ds, Ds, Hd, Hd, Hd, Hd, Mdd, Md^Xo, Mdd^Xm, Mdd, Mdd, Mdd, Hd, Hd, Hd, Dd, Dd, Dd, Dd, Dd, Dd, Re, Re, Dd, Dd, Rd, Dd, Hd, Dd, Dd, Dd, Hd, Hd, Hd^Qhh, Mdd^Xm, Mdd, Mdd^Xm, Mdd^Qhh, Hd, Mdd^Qhh, Mdd^Qhh, Hd
Mdd^Xm, Mdd^Xm, Mdd^Xm, Mdd^Xm, Mdd^Xm, Mdd^Xm, Mdd^Xm, Mdd^Xm, Mdd^Xm, Mdd^Xm, Mdd^Xm, Mdd^Xm, Mdd^Xm, Mdd^Xm, Mdd^Xm, Mdd^Xm, Mdd^Qhh, Mdd, Mdd, Hd, Ds^Qhh, Dd, Ds^Es, Dd, Dd, Dd, Rd, Rd^Xo, Dd^Xo, Ds^Xo, Ds^Es, Dd^Xo, Dd, Hd^Xo, Mdd^Xo, Mdd^Qhh, Mdd^Xm, Mdd^Xm, Hd, Hd, Hd, Hd, Dd^Dc, Dd, Dd, Dd, Rd^Esd, Re, Dd, Dd, Hd, Dd, Ds^Es, Ds, Dd, Dd, Ds, Dd^Edp, Dd, Dd, Ds, Dd, Hd, Hd^Qhh, Mdd^Qhh, Mdd, Mdd^Xm, Mdd^Xm, Mdd, Mdd, Hd, Hd, Hd, Hd, Dd, Hd, Hd, Hd, Dd, Dd, Dd, Co, Dd, Dd, Rd, Dd, Dd, Dd, Ds^Es, Dd, Dd, Hd, Hd, Hd^Qhh, Mdd^Qhh, Mdd, Mdd, Mdd, Mdd^_mh, Mdd, Mdd, Hd^Qhh
Mdd^Xm, Mdd^Xm, Mdd^Xm, Mdd^Xm, Mdd^Xm, Mdd^Xm, Mdd^Xm, Mdd^Xm, Mdd^Xm, Mdd^Xm, Mdd^Xm, Mdd^Xm, Mdd^Xm, Mdd^Xm, Mdd, Mdd, Mdd, Hd^Qhh, Hd^Qhh, Wot^Qhh, Ds^Es, Dd, Ds^Edp, Ds, Dd, Dd, Rd^Esd, Dd, Dd, Ds, Ds^Edpp, Dd, Hd, Hd, Mdd^Xm, Mdd^Xm, Mdd^Xm, Hd, Hd, Hd, Hd, Dd, Dd, Dd, Dd, Rd, Dd, Dd, Dd, Dd, Dd, Dd, Ds, Ds, Dd, Dd, Dd, Dd, Dd, Dd, Dd, Dd, Hd, Hd^Qhh, Mdd^Qhh, Mdd, Mdd^Xm, Mdd, Hd, Hd, Hd, Hd, Hd, Dd, Dd, Hd, Dd, Hd, Hd, Hd, Hd, Dd, Dd, Rd^Esd, Rd, Dd, Dd, Dd, Ds^Es, Ds, Dd, Hd, Hd, Hd, Hd, Mdd^Qhh, Mdd^Qhh, Mdd^Xm, Mdd^Xm, Mdd^Xm, Mdd, Hd
Mdd^Xm, Mdd^Xm, Mdd^Xm, Mdd^Xm, Mdd^Xm, Mdd^Xm, Mdd^Xm, Mdd^Xm, Mdd^Xm, Mdd^Xm, Mdd^Xm, Mdd^Xm, Mdd^Xm, Mdd^Xm, Mdd^Qhh, Mdd^Qhh, Hd^Qhh, Dd, Dd^Es, Wot, Wot, Ds, Ds^Es, Ds, Dd, Dd^Vdt, Dd, Rd^Esd, Dd, Ds^Edpp, Dd, Ds, Dd, Hd, Mdd^Xm, Mdd^Xm, Mdd, Mdd, Hd, Hd, Hd, Hd, Dd, Dd, Ds^Dr, Dd, Dd, Dd, Dd, Ds, Dd, Dd, Rd, Dd, Hd, Hd, Dd, Hd, Dd, Dd, Ds, Hd, Hd, Hd, Mdd, Mdd^Xm, Mdd^Xm, Mdd, Mdd, Hd, Hd, Hd, Hd, Dd, Dd, Hd, Hd, Dd, Hd, Hd, Dd, Dd, Hd, Dd, Dd, Rd, Dd, Dd, Dd, Ds^Edpp, Dd, Hd, Hd, Hd, Dd, Hd, Hd^Qhh, Mdd, Mdd, Mdd^Xm, Mdd^Xm, Mdd
Mdd^Xm, Mdd^Xm, Mdd^Xm, Mdd^Xm, Mdd^Xm, Mdd^Xm, Mdd^Xm, Mdd^Xm, Mdd^Xm, Mdd^Xm, Mdd^Xm, Mdd^Xm, Mdd^Xm, Mdd, Mdd^Qhh, Hd^Qhh, Hd, Dd, Dd, Ds, Ds^Es, Wot, Wwt, Ce, Ce, Dd^Es, Rd^Edt, Dd, Dd^Es, Dd^Edpp, Dd, Dd, Dd, Hd, Mdd^Xm, Mdd^Xm, Hd, Mdd, Hd, Hd, Dd, Hd, Dd, Ds^Es, Ds, Dd, Rd, Rd, Dd, Dd, Ds, Dd, Dd, Dd, Ds, Ds, Rd, Ds, Hd, Dd, Dd, Hd, Hd, Mdd, Mdd, Mdd, Mdd^Xm, Mdd, Mdd^Xm, Mdd, Mdd, Hd, Hd, Dd, Dd, Dd, Hd, Dd, Hd, Hd, Hd, Hd, Dd, Dd, Rd, Dd, Dd, Dd, Rd, Dd, Dd, Dd, Dd, Hd, Dd, Hd, Hd, Mdd^Qhh, Mdd, Mdd^Xm, Mdd^Xm, Mdd^Xm
Mdd^Xm, Mdd^Xm, Mdd^Xm, Mdd^Xm, Mdd^Xm, Mdd^Xm, Mdd^Xm, Mdd^Xm, Mdd^Xm, Mdd^Xm, Mdd^Xm, Mdd^Xm, Mdd^Xm, Mdd, Mdd, Hd^Qhh, Dd, Dd, Dd, Dd, Ce, Wwrt, Wwt, Re, Re, Rd^Edt, Rd^Edt, Dd, Dd, Dd^Es, Dd^Edt, Hd, Mdd, Mdd, Mdd, Mdd^Xm, Hd, Mdd, Hd, Hd, Dd, Dd, Dd, Ds, Dd, Dd, Rd^Esd, Rd, Hd, Dd, Dd, Dd, Hd, Dd, Dd^Dr, Ds^Edb, Rd^Edb, Dd, Rd, Dd, Hd, Mdd, Hd, Mdd, Mdd, Mdd^Xm, Mdd^Xm, Mdd^Xm, Mdd^Xm, Mdd^Xm, Mdd, Hd, Hd, Dd, Hd, Dd, Hd, Dd, Hd, Hd, Hd, Hd, Dd, Dd, Dd, Dd, Rd^Esd, Dd, Dd, Dd, Dd, Hd, Dd, Dd, Dd, Dd, Hd, Hd^Qhh, Mdd^Qhh, Mdd^Xm, Mdd, Mdd^Xm
Mdd^Xm, Mdd^Xm, Mdd^Xm, Mdd^Xm, Mdd^Xm, Mdd^Xm, Mdd^Xm, Mdd^Xm, Mdd^Xm, Mdd^Xm, Mdd^Xm, Mdd, Mdd, Mdd, Mdd, Hd, Dd, Ds, Ds, Dd^Edt, Re, Wwt, 3 Kdr, Rr, Rd^Edt, Rd^Vdt, Rd, Dd, Ce, Dd^Edt, Dd^Edt, Dd, Hd, Hd, Hd, Hd, Hd, Dd, Dd, Dd, Cdr, Hd, Dd, Dd, Dd, Dd, Dd, Dd, Dd, Hd, Mdd^Qhh, Hd, Mdd^Qhh, Hd, Dd, Ds^Edb, Dd^Edb, Isa, Dd, Ds, Ds, Dd, Dd, Hd, Hd, Mdd, Mdd, Mdd^Xm, Mdd^Xm, Mdd^Xm, Mdd^Xm, Mdd, Mdd, Hd, Hd, Hd, Hd, Hd, Hd, Hd, Hd, Hd, Dd, Dd, Ds, Dd, Dd, Rd, Dd, Dd, Hd, Hd, Dd, Dd, Dd, Dd, Hd, Hd, Hd, Mdd^Qhh, Mdd^Qhh, Mdd
Mdd^Xm, Mdd^Xm, Mdd^Xm, Mdd^Xm, Mdd^Xm, Mdd^Xm, Mdd^Xm, Mdd^Xm, Mdd^Xm, Mdd^Xm, Mdd^Xm, Mdd, Md^Xm, Mdd, Mdd^Qhh, Hd, Dd, Dd^Edt, Ds^Edt, Ce, Re, Rr, Cdr, Cdr, Rd^Edt, Rd^Edt, Rd^Edt, Re^Edt, Ce, Dd, Dd, Dd, Hd, Hd, Dd, Dd, Dd, Dd, Dd, Dd, Dd, Dd, Dd, Rr, Rd^Esd, Rd, Dd, Dd, Mdd^Qhh, Mdd^Qhh, Mdd, Hd^Qhh, Ds, Dd, Dd, Hd, Hd, Dd, Dd, Dd, Ds^Es, Dd, Dd, Dd, Hd, Hd, Mdd, Mdd, Mdd, Mdd^Xm, Mdd^Xm, Mdd^Xm, Mdd^Xm, Mdd, Hd, Hd, Hd, Hd, Mdd, Hd, Hd, Hd, Dd, Dd, Dd, Ds, Dd, Rd, Dd, Dd, Dd, Dd, Dd^Edpp, Dd, Dd, Hd, Hd, Dd, Dd, Hd, Hd, Hd^Qhh
Mdd^Xm, Mdd^Xm, Mdd^Xm, Mdd^Xm, Mdd^Xm, Mdd^Xm, Mdd^Xm, Mdd^Xm, Mdd^Xm, Mdd^Xm, Mdd^Xm, Mdd, Mdd^Qhh, Mdd^Qhh, Hd, Hd, Hd, Dd^Edt, Ds, Ce, Rd, Cdr, Rd, Rd^Edt, Rd, Rd, Rd, Re, Dd, Dd, Hd, Hd, Dd, Dd, Dd, Dd, Dd, Dd, Dd, Dd, Hd, Dd, Rd, Rr, Dd, Dd, Dd, Dd, Hd^Qhh, Mdd, Dd, Ds, Ds^Es, Ds^Edpp, Ds, Dd, Mdd, Hd, Dd, Ds^Edp, Dd^Es, Dd, Rd, Hd, Hd, Hd, Mdd, Mdd, Mdd^Qhh, Mdd^Qhh, Mdd^Qhh, Mdd^Xm, Mdd^Xm, Mdd, Mdd, Hd, Hd, Hd, Mdd, Hd, Hd, Hd, Dd, Hd, Dd, Ds, Dd^Es, Dd, Dd, Rd, Dd, Dd, Dd, Ds, Dd, Hd, Hd, Dd, Dd, Dd, Dd, Dd
Mdd^Xm, Mdd^Xm, Mdd^Xm, Mdd^Xm, Mdd, Mdd^Xm, Mdd, Mdd^Xm, Mdd, Mdd^Xm, Mdd, Mdd, Mdd^Qhh, Hd^Qhh, Hd, Dd, Dd, Dd, Dd, Ds, Dd, Dd, Rd^Esd, Rd^Es, Rd, Rd, Ce, Rd^Edt, Dd, Dd, Dd, Dd, Dd, Dd, Dd, Cdr, Dd, Dd, Dd, Dd, Hd, Dd, Dd, Rd, Hd, Hd, Hd, Mdd^Qhh, Dd, Dd, Ds^Es, Ds^Es, Ds, Ds, Ds, Dd, Hd, Hd, Dd, Dd, Dd, Rd, Isa, Dd, Dd, Hd, Hd, Mdd^Qhh, Md^Xm, Mdd^_mh, Mdd^Qhh, Mdd, Mdd^Xm, Mdd^Xm, Mdd, Hd, Mdd^Xm, Mdd^Xm, Mdd, Hd, Hd, Hd, Dd, Dd, Dd, Dd, Dd, Dd, Dd, Rd^Esd, Rd, Dd, Dd, Ds, Ds, Dd, Dd, Hd, Hd, Hd, Hd, Dd
Mdd^Xm, Mdd^Xm, Mdd, Mdd, Mdd^Qhh, Mdd, Mdd, Mdd, Mdd, Mdd^Xo, Mdd^Xo, Mdd, Mdd, Hd^Qhh, Dd, Dd, Ds, Ds, Dd, Dd^Edpp, Dd, Dd^Vdt, Rd^Esd, Rd^Edt, Rd^Edt, Ce, Dd, Dd, Dd, Rd^Esd, Rd, Dd, Dd, Dd, Dd, Dd, Dd, Dd, Hd, Hd, Dd, Dd, Dd, Dd, Dd, Dd, Dd, Dd, Dd, Ds^Edpp, Dd, Dd, Dd, Cdr, Hd, Hd, Hd, Hd, Dd, Dd^Dr, Hd, Dd, Dd^Edpp, Dd^Vdr, Dd, Wot, Wot, Wot^Qhh, Mdd^Qhh, Mdd, Mdd^Qhh, Mdd, Mdd^Xm, Mdd^Xm, Mdd, Hd, Mdd^Xm, Mdd^Xm, Mdd, Hd, Hd, Dd, Dd, Rd^Esd, Dd, Hd, Dd, Rd^Esd, Dd, Dd, Dd, Rd, Dd, Ds, Ds, Ds^Edpp, Dd, Dd, Hd, Mdd, Mdd^Xm, Hd
Mdd, Mdd, Mdd^Qhh, Mdd^Qhh, Mdd, Mdd^Qhh, Hd^Qhh, Hd^Qhh, Mdd, Mdd, Hd, Hd^Xo, Hd, Mdd, Mdd, Dd, Dd, Dd, Dd^Edt, Dd^Edt, Dd, Rd^Esd, Dd, Dd^Edt, Dd, Dd, Dd, Hd, Dd, Dd, Rd, Rr, Dd, Dd, Rd, Dd, Dd, Hd, Dd, Dd, Re, Rd^Esd, Hd, Hd, Hd, Dd, Dd, Mdd, Mdd^Qhh, Dd, Dd, Hd, Dd, Dd, Hd, Dd, Dd, Dd, Rd, Ds, Ds, Dd, Wot, Ds, Ds, Wwrt, Dd, Hd, Hd, Mdd^Qhh, Mdd, Mdd^Xm, Mdd^Xm, Mdd^Xm, Mdd^Xm, Mdd^Xm, Mdd^Xm, Mdd, Hd, Hd, Hd, Dd, Dd^Edpp, Rd, Rd^Esd, Hd, Hd, Dd, Dd, Dd^Vct, Rd, Dd, Dd, Dd, Rd^Esd, Dd, Ds, Hd, Hd, Hd, Mdd, Hd
Mdd, Mdd^Qhh, Mdd, Ds, Ds, Mdd^Qhh, Hd, Ds, Ds, Hd, Ds, Ds^Xo, Hd^Xo, Hd, Hd, Dd, Dd, Cdr, Dd^Edt, Dd^Edt, Dd, Dd, Dd, Dd, Dd^Es, Ds, Dd, Hd, Dd, Dd, Dd, Rd^Esd, Dd, Dd, Dd, Rd^Esd, Rd, Rd, Re, Re, Dd, Rd, Hd, Dd, Hd, Hd, Hd, Mdd^Qhh, Hd^Qhh, Dd, Dd, Ds, Dd, Hd, Dd, Dd, Ds, Ds, Dd, Ds, Wwf, Wwt, Wot, Wot^Bw/r, Wot, Wwf, Dd, Hd, Hd, Mdd, Mdd, Mdd, Mdd^Xm, Mdd^Xm, Mdd^Xm, Mdd^Xm, Mdd, Mdd, Hd, Hd, Hd, Dd, Dd^Edpp, Dd^Edpp, Dd^Edpp, Dd, Dd, Dd, Dd, Dd, Ce, Ce, Ce, Rd^Esd, Dd, Dd, Ds^Edpp, Dd, Dd, Hd, Hd, Hd
Mdd, Hd^Qhh, Hd, Hd, Ds, Ds, Ds, Ds, Ds, Ds, Dd, Ds, Dd, Dd^Xo, Dd, Rd, Ds, Dd, Rd, Rd, Dd, Dd, Dd^Edpp, Dd, Ds^Es, Ds, Dd, Hd, Hd, Dd, Dd, Dd, Hd, Dd, Dd, Dd, Dd, Rd^Esd, Dd, Dd, Dd, Hd, Hd, Dd, Hd^Qhh, Hd, Hd, Hd, Mdd^Qhh, Dd, Hd, Ds, Dd, Dd, Dd, Dd, Ds, Ds, Hd, Hd, Dd, Wwt, Wwt, Wot, Wot, Dd, Hd, Dd, Hd, Hd, Hd, Hd, Mdd, Mdd^Xm, Mdd^Xm, Mdd^Xm, Mdd^Qhh, Mdd^Qhh, Hd, Hd, Hd, Hd, Dd, Dd^Edpp, Dd^Edpp, Dd, Dd, Rd^Esd, Dd, Dd, Ce, 1 Ke, Ce, Rd^Esd, Dd^Vct, Ds, Rd^Esd, Dd^Edpp, Dd, Hd, Dd, Hd
Hd, Hd, Ds, Ds, Rd^Esd, Cdr, Dd, Ds^Edpp, Dd^Edp, Dd^Es, Dd, Rd, Rd^Esd, Dd^Xo, Rd^Xo, Ds, Ds, Dd, Rd^Esd, Dd, Dd, Dd, Dd, Dd, Dd, Dd, Dd, Dd, Dd, Hd, Dd, Dd, Dd, Hd, Dd, Dd, Dd, Dd, Hd, Dd, Dd, Hd, Hd, Hd, Mdd^Qhh, Mdd^Qhh, Mdd^Qhh, Mdd, Mdd, Hd, Hd, Dd, Hd, Hd, Dd, Dd, Dd, Hd, Hd, Mdd, Hd, Dd, Wwt, Wot, Wwrt, Ds, Dd, Dd, Dd, Hd, Hd, Mdd, Mdd, Mdd^Xm, Mdd^Xm, Mdd^Qhh, Mdd, Hd^Qhh, Hd^Qhh, Hd, Hd, Dd, Ds, Dd^Edpp, Dd, Dd, Dd, Dd, Dd, Dd, Dd, Ce, Rd, Dd, Hd, Ds, Dd, Rd, Dd^Edpp, Hd, Dd, Hd
Dd, Ds, Dd^Es, Ds, Ds^Edpp, Rd^Esd, Rd, Dd^Edpp, Rd, Dd, Rd^Esd, Rd, Rd, Rd, Dd, Ds^Xo, Rd^Esd, Rd, Dd, Dd, Dd, Dd, Dd, Dd, Dd, Hd, Hd, Dd, Dd, Hd, Hd, Cdr, Dd, Dd, Hd, Hd, Hd, Hd, Mdd^Qhh, Hd^Qhh, Hd^Qhh, Hd, Mdd^Qhh, Mdd^Qhh, Mdd^Xm, Mdd, Mdd^_mh, Hd^Qhh, Hd, Hd, Hd, Hd, Hd, Dd, Dd, Dd, Hd, Hd, Mdd^Qhh, Mdd^Qhh, Hd^Qhh, Mdd^Qhh, Mdd^Qhh, Wwt, Hd, Dd, Hd^Qhh, Dd, Hd^Qhh, Mdd, Hd, Mdd, Mdd, Mdd^Xm, Mdd^Xm, Mdd^Qhh, Mdd, Hd, Hd^_mh, Hd^Qhh, Hd, Dd, Ds, Ds, Hd, Dd, Ds, Dd^Edpp, Dd, Dd, Dd, Rd, Dd, Dd, Hd, Dd, Dd, Rd^Esd, Ds, Ds, Ds, Dd
Rd, Dd, Rd, Ds^Edpp, Rd, Rd, Dd^Edpp, Rd, Rd^Esd, Ds, Ds^Es, Ds, Dd, Dd, Ds, Dd^Xo, Dd^Xo, Dd, Hd, Hd, Dd, Cdr, Dd, Hd, Hd^Qhh, Mdd^Qhh, Mdd, Hd, Hd^Qhh, Dd, Dd, Dd, Dd, Hd, Dd, Hd, Hd, Hd, Mdd^Qhh, Hd, Hd^Qhh, Hd, Mdd^Qhh, Mdd, Hd, Mdd^Xm, Mdd^Xm, Hd^Qhh, Hd^Qhh, Hd^Qhh, Mdd, Mdd, Hd, Hd, Dd, Hd, Dd, Mdd^Qhh, Mdd, Mdd, Hd, Hd, Dd, Ds^Qhh, Dd^Qhh, Mdd^Qhh, Hd, Hd^Qhh, Mdd, Mdd^Qhh, Mdd^Qhh, Mdd, Mdd^Xm, Mdd^Xm, Mdd^Xm, Mdd^Qhh, Mdd, Mdd, Hd, Hd^Qhh, Hd, Dd, Hd, Dd, Dd, Dd, Ds, Dd^Edpp, Dd^Edpp, Dd^Es, Dd, Rd^Esd, Hd, Hd, Mdd^Xm, Mdd, Hd, Dd, Ds, Dd, Dd, Ds
Dd, Rd^Esd, Dd, Rd, Ds, Dd, Rd, Rd, Rd, Ds, Ds, Dd, Hd, Hd, Hd^Qhh, Hd, Mdd, Hd^Xo, Mdd^Xm, Hd, Hd, Dd, Mdd, Mdd^Qhh, Mdd^Qhh, Mdd^Qhh, Mdd^Xm, Mdd^Xm, Mdd^Qhh, Hd^Qhh, Dd, Dd, Dd, Dd, Hd, Hd, Hd, Hd^Qhh, Mdd^Xm, Mdd, Hd, Hd^Qhh, Hd, Hd, Hd, Mdd^Xm, Mdd^Xm, Hd, Mdd^Qhh, Mdd, Mdd, Hd, Hd, Hd, Hd^Qhh, Mdd^Qhh, Hd^Qhh, Mdd^Qhh, Hd, Hd, Dd, Dd^_mh, Dd^Edpp, Ds, Dd, Dd, Hd, Dd, Mdd, Hd, Hd^Qhh, Mdd^Xm, Mdd^Xm, Mdd^Xm, Mdd^Xm, Mdd^Qhh, Mdd^Qhh, Mdd, Mdd^Qhh, Hd^Qhh, Hd, Hd, Hd, Hd, Dd, Ds, Ds, Dd, Dd, Dd, Rd, Dd, Hd, Mdd, Mdd, Hd, Hd, Ds, Ds^Es, Hd, Hd, Ds
Dd, Dd, Dd, Dd, Dd, Dd, Ds, Ds, Ds, Rd^Esd, Hd, Hd, Hd, Hd^Qhh, Mdd^Qhh, Mdd, Mdd^Xm, Mdd, Mdd^Xm, Mdd, Md^Xm, Hd, Mdd, Mdd^Xm, Mdd^Xm, Mdd^Xm, Mdd^Xm, Mdd^Xm, Mdd, Hd^Qhh, Dd, Dd, Dd, Dd, Hd, Hd, Hd, Hd^Qhh, Mdd, Mdd^Xm, Mdd^Xm, Hd, Hd, Hd, Mdd, Mdd, Mdd, Mdd, Mdd^Qhh, Hd, Hd, Hd, Hd, Hd, Dd^Qhh, Hd, Dd, Dd, Hd, Hd, Dd, Dd, Dd, Dd, Dd, Dd, Dd, Dd, Dd, Hd, Hd, Mdd^Qhh, Mdd^Qhh, Mdd, Mdd, Mdd^Xm, Mdd^Xm, Mdd^Qhh, Mdd, Mdd, Hd, Hd, Hd, Hd, Dd, Dd, Dd, Dd, Dd, Rd^Esd, Dd, Dd, Dd, Mdd, Hd, Dd, Dd, Dd, Dd, Dd, Dd, Dd
