Mm, Mm, Mm, Md^Xm, Md^Xm, Md^Xm, Mm, Mm, Wwt, Mm, Mm^Xm, Mm, Mm, Mm, Md, Md, Md, Hh, Gs^Ftd, Gs^Ft, Gs^Ftd, Gs^Fts, Gs^Fts, Gs, Gs^Fts, Gs^Ft, Gs^Fts, Mm, Mm, Mm^Xm, Mm^Xm, Mm^Xm, Mm^Xm, Mm, Gs^Fts, Gs^Fts, Gs^Fts, Gs^Fts, Gs^Fts, Gs^Fts, Gs^Fts, Gs^Fts, Hh, Hhd, Hhd, Hhd, Hhd, Hhd, Hhd, Hhd, Hhd, Hhd, Gs, Gs, Gs, Gs, Gs, Gs, Wwt, Wwt, Wot, Wot, Wot, Wot, Wwt, Wwt, Wwf, Wwt, Gs, Gd, Gs, Gd, Hhd, Hhd, Hhd, Hhd
Hh, Mm, Hh, Md^Xm, Mm, Mm, Mm, Wwt, Mm^Xm, Mm^Xm, Mm^Xm, Mm^Xm, Mm^Xm, Mm, Md^Xm, Md^Xm, Hh, Gs^Ftd, Gs^Fts, Gs^Fts, Gs, Gs, Gs, Gs^Fts, Hh, Hh, Hh, Hh, Mm, Mm^Xm, Mm^Xm, Mm^Xm, Mm, Mm, Mm, Gs, Gs, Gs, Gs^Fts, Hh, Hh, Hh, Hhd, Hhd, Gs, Hhd, Gs, Hhd, Gs, Gs, Gs, Gs, Wwt, Wwf, Wwt, Wot, Wot, Wot, Wot, Wot, Wot, Wot, Wwf, Wwt, Wwf, Wwt, Gs, Gs, Gs, Gs, Md, Hhd, Hhd, Hhd, Hhd, Hhd
Gs, Hh, Hh, Mm, Hh, Hh, Wwt, Wwt, Mm, Mm^Xm, Mm, Mm, Mm, Mm^Xm, Md^Xm, Md, Mm, Gs^Fts, Gs^Fts, Gs, Gg^Es, Gg^Efm, Gs^Ftd, Gs, Gs, Gs, Gs, Gs, Wwt, Mm, Wot, Mm, Wwt, Gs^Fts, Wwt, Wwt, Wwt, Wwf, Wwf, Gs, Gs^Vht, Gs^Fts, Gs, Gs, Wwt, Gs, Wwt, Gs, Wwt, Wwt, Wwt, Wwf^Es, Wot, Wwf, Wwt, Wwt, Wwt, Wwt, Wwt, Wwt, Re, Wwt, Ds, Wwf, Gs, Gs^Fts, Gs, Hhd, Md, Hhd, Md, Md, Hhd, Hhd, Gd, Gd
Ds, Ds, Gs, Gs, Hh, Hh, Wwt, Mm, Mm, Mm, Mm, Mm, Md, Mm^Xm, Mm^Xm, Mm^Xm, Mm, Hh, Hh, Gs, Gg, Gg, Gs, Gs^Fts, Gs, Gs, Wwt, Wwt, Wot, Wot, Wot, Wwt, Wot, Wwt, Wot, Wot, Wot, Wwt, Wwt, Wwt, Wwt, Wwt, Wwt, Wwt, Wot, Wwt, Wwt, Wwt, Wot, Wot, Wot, Wot, Wwt, Wwt, Wwt, Wwt, Wwf^Esd, Ds, Gs, Gs, Re, Re, Gs, Gs, Gs, Gs, Hhd, Hhd, Hhd, Md, Md, Md, Hhd, Gd, Rd, Dd
Wwt, Ds, Wwt, Wwt, Wwt, Wwt, Mm, Mm, Hh^Ft, Hh^Ft, Mm, Mm, Mm, Mm^Xm, Mm, Mm, Hh, Hh, Hh, Gs, Gs, Gs, Gs^Ftd, Gs^Fts, Wwf, Wwt, Wot, Wot, Wot, Wot, Wot, Wot, Wwt, Wot, Wwt, Wot, Wwt, Wwt, Gs^Fts, Wwf, Wwt, Wwt, Wwt, Wot, Wwt, Wwt, Wwt, Wwt, Gs^Fts, Wwt, Gs, Wwt, Gs, Wwt, Gs, Gs, Gs, Gs^Vct, Gs, Gs^Fts, Re, Re, Rd, Gs^Fts, Gs^Fts, Gs, Gs, Hhd, Hhd, Md, Md, Hhd, Gd, Gd, Rd, Rd
Wot, Wwt, Ds, Ds, Gs, Hh, Gs, Hh, Hh, Mm, Gs^Ft, Hh, Mm, Mm^Xo, Mm, Mm, Gs, Gs^Fts, Gs^Fts, Gs^Fts, Wwf, Gs, Wwf, Gs, Wwt, Wwt, Wwt, Wwt, Ce, Wwt, Wwt, Wwt, Gs, Wwt, Wwf, Wwt, Wwf, Wwf, Gs, Gs, Gd, Wwt, Gd, Wwt, Gs, Gs, Gs, Gs, Gs, Gs, Dd, Gs, Gd, Gd, Gs^Fts, Gg, Gg^Es, Gs, Gs, Gs, Re, Re^Ecf, Gs, Gs^Vct, Gg, Gs, Gs, Hhd, Hhd, Hhd, Gd, Gd, Dd, Rd, Dd, Dd
Wwt, Wot, Wot, Ds, Wwt, Gg, Gg^Efm, Gs, Gg, Gs^Ftd, Gg, Hh, Gs^Ftd, Mm^Xo, Gs^Xo, Gs^Fts, Wwf, Gs, Wwt, Wwf, Wwt, Wwt, Wwt, Wwt, Wwt, Wwt, Wot, Wot, Wot, Gs^Fts, Ce, Gd^Fts, Gd, Gs, Gs, Gs, Gs, Hhd, Hhd, Gd, Gd, Hhd, Gd, Gs, Gs, Gs, Dd^Es, Dd^Es, Gs, Dd, Dd^Es, Gs, Gs, Gs^Fts, Gs^Ftd, Gs, Gg, Gs, Gs^Ecf, Rd, Gd, Gs, Gd, Gs, Gg, Gs^Fts, Gs^Ftd, Hhd, Gd, Hhd, Hhd, Gd, Gd, Dd, Rd, Rd
Ds, Wwt, Wot, Wot, Wwt, Ds, Ds, Gg, Wwf, Gg, Wwt, Gs^Ftd, Wwt, Gs, Wwt^Xo, Wwt, Wwt, Wwt, Wwt, Wwt, Wwt, Wwt, Wwt, Wwt, Wot, Wot, Ce, Wot, Wot, Wwt, Gs, Gs, Gd, Gd^Vht, Gd, Gs, Gs, Hhd, Hhd, Gd, Hhd, Hhd, Hhd, Hd, Hd, Gd, Dd^Es, Dd, Hd, Dd, Dd, Dd, Gd, Gd, Gs^Ftd, Gs, Gs^Vct, Gs, Rd, Rd, Ce, Ce, Ce, Gs, Gs^Vct, Gs, Gs^Fts, Gd, Rd, Gd, Dd, Dd, Dd, Rd, Rd, Dd
Ds, Wwt, Wwt, Wwt, Wot, Wot, Wwt, Wwt, Wwt, Wwt, Wwt, Wwf, Wwt, Wwt, Wwt, Wwf^Xo, Wwt, Wwf, Gs, Wwf, Gs^Vht, Wwt, Wot, Wwt, Wot^Bw/r, Ce, 4 Ket, Ce, Wwt, Wwt, Wwt, Ce, Ce, Gs, Hhd, Hhd, Gs, Hhd, Hhd, Hhd, Md, Md, Hhd, Hd, Hd, Dd, Dd, Dd^Es, Hd, Hd, Dd, Dd, Dd, Dd, Gd, Gs, Gs, Gs, Rd, Gd, Ce, 1 Ke, Ce, Gs, Gs^Ftd, Gd, Rd, Rd, Rd, Rd, Dd^Edpp, Dd, Dd, Dd^Edpp, Dd, Dd
Ds, Ds, Ds, Wwt, Wwt, Wot, Wwt, Wwf, Ds, Wwt, Ds, Wwt, Ds, Wwt, Wwt, Wwt^Xo, Hhd^Xo, Gs^Fts, Gs, Gs, Gs, Wwt, Wot^Bw/r, Ce, Wot, Ce, Ce, Ce, Wwt^Bw\r, Wwt, Wwt, Gs, Gg, Ket, Gs, Gs, Gs, Gs, Hhd, Md, Md^Xm, Md, Md, Hhd, Hd, Hd, Dd^Es, Dd, Hd, Hd, Hd, Hd, Dd, Dd, Dd, Gd, Rd, Gs^Ecf, Rd, Rd^Es, Gd, Ce, Gs, Gs, Gs^Fts, Gs^Fts, Gd, Dd, Dd, Rd, Dd, Dd, Hd, Dd, Hd, Hd
Gs, Gs, Ds, Wwt, Wwt, Wwt, Ds, Ds, Ds, Ds, Ds, Ds, Hh, Ds, Hh, Hhd, Md^Xo, Hhd, Hhd, Gs, Wwt, Ce, Wot, Wot, Wot, Wot, Wwt, Wwt, Wwt, Wwt^Bw\r, Wwt^Bw\r, Gs, Gs, Ce, Gg, Gg^Efm, Gs, Gs, Hhd, Md, Md, Md, Md, Gd, Hd, Dd, Dd, Dd, Hd, Hd, Hd, Dd^Dc, Hd, Dd, Rd, Gd, Dd, Ds, Dd, Rd, Gd, Gd, Dd, Gd, Rd, Gd, Gd, Rd, Rd, Dd^Edpp, Dd, Dd, Dd, Hd, Hd, Hd
Gs, Gs, Gs^Fts, Gs, Ds, Ds, Gg, Ds, Gs^Ftd, Gs^Fts, Gg^Efm, Gs, Gg, Hh, Hh, Hhd, Md^Xm, Md^Xm, Hhd, Wwt, Wot, Wot, Wwt, Wwt, Wot, Wot, Wwt, Wwt, Wwt, Wwt, Gs, Rb, Re, Ce, Gs, Gg, Gs, Hhd, Gs, Gd, Hhd, Hhd, Hhd, Hhd, Hhd, Hd, Dd, Hd, Hd, Hd, Dd, Dd, Dd, Dd, Dd, Ds, Dd, Dd, Dd, Gd, Gd, Dd, Dd, Rd, Rd, Ds, Dd, Rd, Dd, Dd, Rd, Hd, Dd, Hd, Hd, Mdd
Gs, Gs^Ft, Gs^Fts, Gs, Gs, Gs, Gg, Gg, Gs, Gs, Gg^Efm, Gs, Gs^Ftd, Hh, Hhd, Mm, Mm, Md^Xm, Md, Wwt, Wot, Wwt, Wwt, Ce, Ce, Gs^Fts, Gs, Wwf, Wwt, Wwf, Ce, Rb, Re, Gd, Gs^Vht, Gg, Gg, Gd, Gd, Hhd, Gd, Gd, Hhd, Hhd, Hd, Hd, Dd, Hd, Hd, Dd, Hd, Dd, Hd, Rd, Dd, Dd, Rd, Hd, Rd, Gd, Rd, Rd, Dd, Dd, Hd, Rd, Dd, Rd, Dd, Rd, Dd, Hd, Hd, Hd, Hd, Mdd
Gg^Efm, Gg, Gs, Gg, Gg, Gg^Es, Gg, Gs^Fts, Gs, Gg, Gs, Gs, Gg, Gg, Hhd, Hhd, Md, Md^Xm, Md^Xm, Wot, Md, Wwt, Hhd, Gd, Gd, Ket, Ce, Gg, Gs, Ce, Gs, Gs, Re, Gs, Gd, Gs, Gs, Gs, Gd, Gd, Hd, Gd, Gd, Hd, Hd, Hd, Dd, Hd, Hd, Dd, Hd, Hd, Hd, Ds, Dd, Dd, Dd, Dd, Dd, Ds, Rd, Rd, Rd, Dd, Dd, Rd, Hd, Dd, Dd, Dd^Dc, Dd, Dd, Hd, Hd, Mdd, Mdd
Gg, Gg^Efm, Hh, Gg, Gs, Gs, Gg, Gg, Gg, Gs, Gg^Efm, Gs^Efm, Gg, Gs^Fts, Gs, Hhd, Hhd, Md, Md, Md^Xm, Md^Xm, Md, Hhd, Gd, Gd, Gd, Gd, Ce, Gs, Gs, Gg, Gg^Vht, Gs, Rd, Rd, Re, Re, Gs, Dd, Gd, Dd, Hd, Hd, Hd, Hd, Dd, Dd, Dd, Rd, Hd, Hd, Hd, Hd, Dd, Dd, Rd, Hd, Hd, Ds, Rd, Dd, Dd, Dd, Rd, Rd, Dd, Dd, Dd^Edp, Dd, Dd, Hd, Hd, Hd, Hd, Hd, Hd
Hh, Gg, Gs, Gs, Gs^Ftd, Gs, Gs^Fts, Gg^Efm, Gg, Gs, Gs, Gs, Gg^Efm, Gs, Hh, Hh, Hh, Hhd, Md, Md^Xm, Md^Xm, Md, Md, Hhd, Hhd, Gd, Gd, Gd, Gs^Vht, Gs, Gg, Gd, Gd, Re, Re, Rd, Dd^Vda, Gd, Dd, Ce, Dd, Hd, Dd, Dd, Dd, Dd, Hd, Dd, Rd, Hd, Hd, Hd, Hd, Dd, Cer, Dd, Hd, Hd, Dd, Rd, Dd, Dd, Dd, Rd, Rd, Rd, Rd, Dd^Edpp, Dd^Edpp, Hd, Dd, Dd, Dd, Hd, Dd, Hd
Hh, Hh, Hh, Gs, Gg, Gs^Ft, Gs^Ftd, Gg, Gs^Fts, Gs, Hh, Gg, Hh, Gs, Hh, Hh, Hh, Hhd, Md, Md^Xm, Md^Xm, Md^Xm, Md, Hhd, Gd, Hhd, Hhd, Gd, Gd, Gs, Hhd, Gs, Gs, Gd, Gd, Rd, Rd, Dd, Dd, Dd, Dd, Dd, Dd, Rd, Dd, Hd, Hd, Dd, Dd, Hd, Cer, Dd, Rd, Dd, Wwf, Dd, Dd^Vdr, Dd, Dd, Dd, Dd, Rd, Dd, Dd, Rd, Rd, Dd, Dd^Edpp, Dd^Edpp, Dd, Dd, Dd, Dd^Es, Hd, Dd, Dd
Mm, Hh, Hh, Gs, Hh, Gg^Ft, Hh^Ft, Gg, Gs^Fts, Gs^Fts, Gs, Gg, Hh, Hh, Mm^Xm, Mm, Mm, Hh, Hhd, Md, Md^Xm, Md^Xm, Md, Md, Hhd, Hhd, Hhd, Gd, Hhd, Hhd, Hd, Gd, Dd, Ce, Dd, Rd, Dd, Rd, Rd, Dd^Es, Dd, Dd, Ds, Rd, Dd, Hd, Hd, Hd, Dd, Cer, Dd, Rd, Rd, Dd, Wwt, Wwf, Rd, Ds, Dd, Dd^Edp, Rd, Rd, Dd, Rd, Rd, Ds, Dd, Dd, Dd, Dd, Rd, Dd, Dd, Dd, Rd, Dd
Mm, Mm, Hh, Hh, Hh, Gg, Hh, Gg^Efm, Hh, Hh, Gs, Gs^Fts, Mm, Mm, Mm^Xm, Mm, Hh, Mm, Hh, Md, Md, Md^Xm, Md^Xm, Md, Md, Hhd, Hhd, Hhd, Hd, Hd, Hd, Hd, Hd, Dd, Rd, Hd, Dd, Rd, Dd, Dd, Rd, Rd, Ds, Ds, Ds, Hd, Hd, Dd, Dd, Dd, Wwt, Rd, Wot, Wot, Wwt, Rd, Rd, Cer, Rd, Rd, Dd, Dd, Ds, Dd, Rd, Ds, Dd, Dd, Dd, Rd, Rd, Dd^Edp, Dd, Dd, Dd, Dd
Md^Xm, Mm, Mm, Mm, Hh, Hh, Hh, Hh, Mm, Mm, Hh, Hh, Mm^Xm, Mm^Xm, Mm^Xm, Mm, Hh, Hh, Hh, Md, Hh, Md, Md^Xm, Md^Xm, Md, Md, Hhd, Hd, Hd, Hd, Dd, Dd, Dd, Ds, Rd, Dd, Dd, Rd, Dd, Dd, Rd, Dd, Ds, Ds, Ds, Dd, Dd, Hd, Dd, Dd^Vdr, Dd, Wwt, Dd^Es, Wot, Wwf, Rd, Dd, Rd, Rd, Dd, Dd, Dd^Es, Ds, Rd, Dd, Rd, Hd, Hd, Dd, Dd, Rd, Rd, Dd, Dd^Edpp, Dd, Dd
Md^Xm, Md^Xm, Md^Xm, Mm, Mm, Mm, Hh, Hh, Mm, Mm, Mm, Mm, Mm^Xm, Mm^Xm, Mm, Hh, Hh, Hh, Hh, Hh, Md, Md, Md^Xm, Md^Xm, Md, Md^Xm, Hhd, Dd, Dd, Dd, Rd, Rd, Dd, Dd, Dd, Rd, Dd, Dd, Dd, Dd, Dd, Ds, Dd, Dd^Edp, Ds^Edp, Ds, Dd, Dd, Dd, Dd, Cer, Dd, Dd, Rd, Rd, Rd, Cer, Dd, Dd, Rd, Dd, Rd, Rd, Rd, Dd, Dd, Dd, Ds, Dd, Rd, Rd, Rd, Dd, Dd, Dd, Dd
Md^Xm, Mm, Mm, Mm, Hh, Hh, Mm, Mm, Mm, Mm, Mm, Mm, Mm^Xm, Mm^Xm, Mm, Mm, Hh, Hh, Hh, Md, Md^Xm, Md, Md^Xm, Md, Md, Md, Hd, Dd, Rd, Dd, Ds, Rd, Rd, Dd, Dd, Rd, Rd, Rd, Dd, Dd^Edp, Dd, Dd, Rd, Dd, Dd, Ds, Rd, Rd, Rd, Rd, Rd, Cer, Dd, Rd, Dd, Cer, Dd, Dd, Dd, Rd, Rd, Ds, Dd, Rd, Dd, Dd, Dd, Dd, Rd, Rd, Ds, Ds, Dd, Dd, Rd, Dd
Mm, Md^Xm, Mm, Mm, Hh, Hh, Hh, Mm, Hh, Hh, Hh, Mm, Mm^Xm, Hhd, Hh, Hh, Hhd, Mm, Md, Md, Md^Xm, Md^Xm, Md^Xm, Md^Xm, Md, Md, Hd, Dd, Dd, Rd, Rd, Rd, Dd, Rd, Rd, Rd, Rd, Dd, Dd, Dd, Dd, Rd, Dd, Rd, Rd, Rd, Dd, Dd, Dd, Dd, Rd, Rd, Rd, Rd, Dd, Dd^Es, Hd, Dd, Rd, Rd, Dd, Rd, Rd, Dd, Dd, Rd, Rd, Dd, Dd, Dd, Ds^Es, Ds, Dd, Rd, Rd, Dd
Mm, Mm, Hh, Hh, Gs, Hh, Hh, Mm, Hh, Hh, Mm, Mm, Mm, Hhd, Md, Hh, Md, Md, Md^Xm, Md^Xm, Md^Xm, Md^Xm, Md, Md^Xm, Md, Md, Hd, Dd, Ds, Rd, Rd, Dd, Dd, Dd, Dd, Dd, Dd, Dd, Rd, Dd, Rd, Dd, Rd, Rd, Ds, Ds, Hd, Dd, Dd, Rd, Dd, Rd, Dd, Rd, Rd, Dd, Dd, Rd, Rd, Dd, Dd, Rd, Rd, Dd, Dd^Ecf, Rd, Rd, Dd, Dd, Dd^Edpp, Ds, Ds^Es, Ds, Rd, Dd, Dd
Hh, Hh, Hh, Hh, Gs, Gs, Hh, Mm, Hh, Hh, Mm, Mm, Hhd, Md, Md, Md, Md^Xm, Md^Xm, Md^Xm, Md^Xm, Md^Xm, Md^Xm, Md, Md, Md, Md, Ds, Ds, Ds, Dd, Dd, Dd, Dd, Ds, Rd, Dd, Dd^Edp, Dd, Rd, Rd, Dd, Rd, Rd, Rd, Rd, Ds, Hd, Hd, Dd, Dd, Dd, Dd^Dr, Dd, Rd, Dd, Rd, Rd, Rd, Rd, Rd, Dd^Vdt, Dd, Rd, Rd, Dd, Rd^Vdt, Rd, Dd, Dd, Dd, Rd, Ds, Dd, Rd, Dd, Dd
Hh, Hh, Gs, Gs, Gg, Gs, Gg, Hh, Hh, Hh, Hhd, Mm, Md, Md, Md^Xm, Md^Xm, Md^Xm, Md, Md, Md^Xm, Md^Xm, Md, Hd, Md, Md, Hd, Hd, Ds, Ds, Ds, Dd, Rd, Rd, Dd, Rd, Rd, Dd, Rd, Dd, Dd, Dd^Edp, Dd^Edpp, Rd, Dd, Dd, Dd, Dd, Hd, Hd, Dd^Es, Dd, Ds, Rd, Dd, Rd, Rd, Rd, Dd, Dd, Dd, Dd, Rd, Cer, Rd, Cer, Rd, Rd, Dd, Rd, Dd, Rd, Dd, Dd, Dd, Dd, Dd
Hh, Hh, Gs, Gg, Hh, Gg, Hh, Hh, Hh, Hhd, Hhd, Md, Md^Xm, Md^Xm, Md^Xm, Md^Xm, Md^Xm, Md, Hd, Md, Md, Md^Xm, Hd, Hd, Hd, Dd, Ds, Ds, Rd, Rd, Rd, Dd^Vdt, Rd, Dd, Rd, Rd, Dd, Dd, Rd, Dd, Dd, Dd, Ds^Edp, Rd, Rd, Dd, Dd, Hd, Hd, Dd, Rd, Dd, Rd, Rd, Ds^Es, Rd, Dd, Dd, Ds, Dd^Ecf, Dd, Dd, Rd, Cer, 3 Ke, Cer, Dd, Rd, Dd^Ecf, Rd, Rd, Rd, Dd, Dd, Dd^Dc, Dd
Hh, Hh, Hh, Gg, Hh, Hh, Hhd, Hh, Hh, Hh, Md, Md, Md^Xm, Md^Xm, Md^Xm, Md^Xm, Md^Xm, Md, Hd, Hd, Hd, Md, Hd, Hd, Hd, Dd, Dd, Ds^Edpp, Ds, Ds, Cer, Rd, Rd, Rd, Dd, Dd, Dd, Rd, Rd, Rd, Dd^Edp, Dd, Rd, Rd, Dd, Dd, Hd, Ds, Hd, Dd, Dd, Rd, Dd, Ds, Dd, Dd, Hd, Dd, Ds, Rd, Dd^Vdt, Rd, Rd, Cer, Cer, Cer, Cer, Dd, Rd, Rd, Dd, Ds, Ds, Dd, Dd, Dd
Hh, Hh, Md, Hh, Hh, Md, Md, Hhd, Hh, Hh, Md^Xm, Md^Xm, Md, Md^Xm, Md^Xm, Md, Md, Md, Hd, Hd, Hd, Hd, Dd, Hd, Hd, Hd, Dd, Ds, Cer, Cer, 2 Ke, Cer, Dd, Dd^Vdt, Dd, Rd, Dd, Rd, Dd, Ds, Dd, Dd^Edp, Ds, Dd, Dd, Hd, Hd, Hd, Dd, Dd, Dd, Rd, Dd, Dd, Dd, Hd, Ds, Dd, Dd, Rd, Rd, Rd, Dd, Dd, Dd, Rd, Dd, Dd, Dd^Vdt, Dd, Ds, Dd, Dd, Ds, Ds, Dd
Md, Md, Md, Hh, Hh, Md, Md, Md, Md^Xm, Md^Xm, Md^Xm, Md^Xm, Md, Md, Md^Xm, Md, Md, Md, Hd, Hd, Hd, Hd, Dd, Dd, Hd, Dd, Dd^Vdt, Ds, Cer, Cer, Cer, Cer, Rd, Dd, Rd, Rd, Dd, Dd, Dd, Rd, Ds, Ds^Edp, Dd, Dd, Ds, Hd, Dd, Dd, Ds^Dr, Dd, Dd, Dd, Hd, Hd, Dd, Hd, Hd, Dd, Rd, Rd, Rd, Dd^Ecf, Rd^Vct, Ds, Dd, Rd, Rd, Rd, Rd, Dd, Rd, Ds, Ds, Rd, Rd, Dd
Md, Md^Xm, Md^Xm, Hh, Md, Md, Md^Xm, Md, Md, Md, Md^Xm, Md, Md, Md, Md, Md^Xm, Hd, Hd, Hd, Dd, Dd, Hd, Dd, Rd, Dd, Dd, Dd, Dd, Dd, Cer, Rd, Rd, Dd, Rd, Ds, Ds, Dd, Hd, Dd, Dd, Dd, Ds, Rd, Dd, Ds, Rd, Rd, Dd, Ds, Rd, Rd, Dd, Dd, Dd^Edp, Dd, Dd, Dd, Dd, Rd, Rd, Dd, Dd, Rd, Rd, Dd, Dd, Rd, Dd^Ecf, Dd, Rd, Ds^Es, Dd, Dd, Rd, Rd, Dd
Md^Xm, Md, Md^Xm, Md, Md, Md, Md^Xm, Md, Md^Xm, Md^Xm, Md^Xm, Md, Md, Md, Hd, Md, Hd, Hd, Dd, Dd, Dd^Dc, Dd, Rd, Rd, Rd, Rd, Dd^Edp, Dd, Dd, Rd, Dd, Dd, Dd, Dd^Vdt, Ds, Ds, Dd, Hd, Rd, Hd, Dd, Rd, Rd, Dd, Dd, Rd, Dd, Rd, Ds, Rd, Ds, Dd, Dd^Dc, Dd, Dd, Rd, Rd, Rd, Dd, Rd, Rd, Dd, Dd, Rd, Rd, Dd, Rd, Dd, Dd, Ds, Dd, Dd, Dd, Dd, Dd, Rd
Md^Xm, Md^Xm, Md^Xm, Md^Xm, Md^Xm, Md^Xm, Md^Xm, Md^Xm, Md^Xm, Md^Xm, Md^Xm, Md^Xm, Hd, Hd, Hd, Hd, Hd, Hd, Hd, Dd, Dd, Dd, Ds, Rd, Dd, Rd, Dd, Dd, Rd, Rd, Dd, Rd, Rd, Dd, Rd, Dd, Dd, Rd, Rd, Dd, Dd, Dd, Hd, Dd, Dd, Ds, Dd, Dd, Dd, Ds, Dd, Ds, Dd, Dd, Dd, Rd, Rd, Rd, Rd, Ds, Ds, Ds, Ds^Es, Rd, Rd, Dd, Rd, Rd, Ds, Ds, Ds, Dd^Dc, Dd, Dd, Dd, Dd
Md^Xm, Md^Xm, Md^Xm, Md^Xm, Md^Xm, Md^Xm, Md^Xm, Md^Xm, Md^Xm, Md, Md, Hd, Hd, Hd, Dd, Hd, Dd, Hd, Dd, Hd, Ds, Ds, Dd, Dd, Dd, Dd, Dd, Rd, Rd, Dd, Dd, Dd, Dd, Rd, Dd, Rd, Dd, Dd, Hd, Dd, Hd, Hd, Hd, Hd, Hd, Dd, Dd, Dd, Dd, Dd, Dd, Ds, Ds, Dd, Dd, Rd, Dd, Dd, Dd, Ds, Dd, Ds^Es, Ds, Ds, Dd, Dd, Dd, Rd, Rd, Rd, Dd, Dd, Dd, Dd, Dd, Dd
