Mm, Mm, Mm, Md^Xm, Md^Xm, Md^Xm, Mm, Mm, Wwt, Mm, Mm^Xm, Mm, Mm, Mm, Md, Md, Md, Hh, Gs^Ftd, Gs^Ft, Gs^Ftd, Gs^Fts, Gs^Fts, Gs, Gs^Fts, Gs^Ft, Gs^Fts, Mm, Mm, Mm^Xm, Mm^Xm, Mm^Xm, Mm^Xm, Mm, Gs^Fts, Gs^Fts, Gs^Fts, Gs^Fts, Gs^Fts, Gs^Fts, Gs^Fts, Gs^Fts, Hh, Hhd, Hhd, Hhd, Hhd, Hhd, Hhd, Hhd, Hhd, Hhd, Gs, Gs, Gs, Gs, Gs, Gs, Wwrt, Wwt, Wot, Wot, Wot, Wot, Wwt, Wwt, Wwf, Wwt, Gs, Gd, Gs, Gd, Hhd, Hhd, Hhd, Hhd
Hh, Mm, Hh, Md^Xm, Mm, Mm, Mm, Wwt, Mm^Xm, Mm^Xm, Mm^Xm, Mm^Xm, Mm^Xm, Mm, Md^Xm, Md^Xm, Hh, Gs^Ftd, Gs^Fts, Gs^Fts, Gs, Gs, Gs, Gs^Fts, Hh, Hh, Hh, Hh, Mm, Mm^Xm, Mm^Xm, Mm^Xm, Mm, Mm, Mm, Gs, Gs, Gs, Gs^Fts, Hh, Hh, Hh, Hhd, Hhd, Gs, Hhd, Gs, Hhd, Gs, Gs, Gs, Gs, Wwt, Wwf, Wwt, Wwrt, Wot, Wot, Wot, Wot, Wot, Wot, Wwrt, Wwt, Wwf, Wwt, Gs, Gs, Gs, Gs, Md, Hhd, Hhd, Hhd, Hhd, Hhd
Gs, Hh, Hh, Mm, Hh, Hh, Wwt, Wwt, Mm, Mm^Xm, Mm, Mm, Mm, Mm^Xm, Md^Xm, Md, Mm, Gs^Fts, Gs^Fts, Gs, Gg^Es, Gg^Efm, Gs^Ftd, Gs, Gs, Gs, Gs, Gs, Wwrt, Mm, Wot, Mm, Wwt, Gs^Fts, Wwt, Wwrt, Wwrt, Wwf, Wwf, Gs, Gs^Vht, Gs^Fts, Gs, Gs, Wwrt, Gs, Wwrt, Gs, Wwt, Wwt, Wwt, Wwf^Es, Wwrt, Wwf, Wwt, Wwt, Wwt, Wwt, Wwt, Wwt, Re, Wwrt, Ds, Wwf, Gs, Gs^Fts, Gs, Hhd, Md, Hhd, Md, Md, Hhd, Hhd, Gd, Gd
Ds, Ds^Esd, Gs^Esd, Gs, Hh, Hh, Wwrt, Mm, Mm, Mm, Mm, Mm, Md, Mm^Xm, Mm^Xm, Mm^Xm, Mm, Hh, Hh, Gs, Gg, Gg, Gs, Gs^Fts, Gs, Gs, Wwt, Wwt^Ewl, Wot, Wot, Wot, Wwt, Wot, Wwt, Wot, Wot, Wot, Wwt, Wwt, Wwt, Wwt, Wwt, Wwt, Wwt, Wot, Wwt, Wwt, Wwt, Wwrt, Wot, Wot, Wot, Wwt, Wwt, Wwrt, Wwt, Wwf, Ds, Gs, Gs, Re, Re, Gs, Gs, Gs, Gs, Hhd, Hhd, Hhd, Md, Md, Md, Hhd, Gd, Rd, Dd
Wwt, Ds^Esd, Wwt, Wwrt, Wwt, Wwt, Mm, Mm, Hh^Ft, Hh^Ft, Mm, Mm, Mm, Mm^Xm, Mm, Mm, Hh, Hh, Hh, Gs, Gs, Gs, Gs^Ftd, Gs^Fts, Wwf, Wwrt, Wwt, Wot, Wot, Wot, Wot, Wot, Wwt, Wot, Wwt, Wot, Wwt^Ewl, Wwt, Gs^Fts, Wwf, Wwt, Wwt, Wwt, Wot, Wwrt, Wwt, Wwt, Wwt, Gs^Fts, Wwt, Gs, Wwt, Gs, Wwrt, Gs, Gs, Gs, Gs^Vct, Gs, Gs^Fts, Re, Re^Edt, Rd, Gs^Fts, Gs^Fts, Gs, Gs, Hhd, Hhd, Md, Md, Hhd, Gd, Gd, Rd, Rd
Wot, Wwt, Ds, Ds, Gs, Hh, Gs, Hh, Hh, Mm, Gs^Ft, Hh, Mm, Mm^Xo, Mm, Mm, Gs, Gs^Fts, Gs^Fts, Gs^Fts, Wwf, Gs, Wwf, Gs, Wwt, Wwt, Wwt, Wwt, Ce, Wwt, Wwrt^Ewl, Wwt, Gs, Wwt, Wwf^Ewl, Wwt, Wwf^Ewl, Wwf, Gs, Gs, Gd, Wwt, Gd, Wwrt, Gs, Gs, Gs, Gs, Gs, Gs, Dd, Gs, Gd, Gd, Gs^Fts, Gg, Gg^Es, Gs^Edt, Gs, Gs, Re, Re^Ecf, Gs^Edt, Gs^Vct, Gg, Gs, Gs, Hhd, Hhd, Hhd, Gd, Gd, Dd, Rd, Dd, Dd
Wwt, Wot, Wot, Ds^Esd, Wwt^Ewl, Gg, Gg^Efm, Gs, Gg, Gs^Ftd, Gg, Hh, Gs^Ftd, Mm^Xo, Gs^Xo, Gs^Fts, Wwf, Gs, Wwt, Wwf, Wwrt, Wwrt, Wwt, Wwt, Wwt, Wwt, Wot, Wot, Wot, Gs^Fts, Ce^Edb, Gd^Fts, Gd, Gs, Gs, Gs, Gs, Hhd, Hhd, Gd, Gd, Hhd, Gd, Gs, Gs, Gs, Dd^Es, Dd^Es, Gs, Dd, Dd^Es, Gs, Gs, Gs^Fts, Gs^Ftd, Gs, Gg, Gs^Edt, Gs^Ecf, Rd, Gd, Gs, Gd, Gs^Edt, Gg, Gs^Fts, Gs^Ftd, Hhd, Gd, Hhd, Hhd, Gd, Gd, Dd, Rd, Rd
Ds, Wwt, Wot, Wot, Wwt, Ds, Ds, Gg^Esd, Wwf, Gg, Wwrt, Gs^Ftd, Wwt, Gs, Wwt^Xo, Wwt, Wwt, Wwt, Wwt, Wwt, Wwt, Wwt, Wwt, Wwt, Wwrt, Wwrt, Ce^Edb, Wot, Wot, Wwt^Ewl, Gs^Edb, Gs^Edb, Gd, Gd^Vht, Gd, Gs, Gs, Hhd, Hhd, Gd, Hhd, Hhd, Hhd, Hd, Hd, Gd, Dd^Es, Dd, Hd, Dd, Dd, Dd, Gd^Esd, Gd, Gs^Ftd, Gs, Gs^Vct, Gs, Rd, Rd, Ce, Ce, Ce, Gs, Gs^Vct, Gs, Gs^Fts, Gd, Rd, Gd, Dd, Dd, Dd, Rd^Esd, Rd, Dd
Ds, Wwrt^Ewl, Wwrt, Wwt, Wot, Wot, Wwt, Wwt, Wwt, Wwt, Wwt, Wwf, Wwt, Wwt, Wwt, Wwf^Xo, Wwt, Wwf, Gs, Wwf, Gs^Vht, Wwt, Wwrt, Wwt, Wwt^Bw/r, Ce^Edb, 4 Ket^Edb, Ce^Edb, Wwrt, Wwrt, Wwrt, Ce^Edb, Ce^Edb, Gs, Hhd, Hhd, Gs, Hhd, Hhd, Hhd, Md, Md, Hhd, Hd, Hd, Dd, Dd, Dd^Es, Hd, Hd, Dd, Dd, Dd, Dd, Gd, Gs, Gs^Edt, Gs, Rd, Gd, Ce, 1 Ke, Ce, Gs^Edt, Gs^Ftd, Gd, Rd, Rd, Rd, Rd^Esd, Dd^Edpp, Dd, Dd, Dd^Edpp, Dd, Dd
Ds^Esd, Ds, Ds, Wwt, Wwt^Ewl, Wot, Wwt, Wwf, Ds, Wwt, Ds, Wwt, Ds, Wwt, Wwrt, Wwrt^Xo, Hhd^Xo, Gs^Fts, Gs, Gs^Edb, Gs^Edb, Wwt^Ewl, Wwt^Bw/r, Ce, Wot, Ce^Edb, Ce^Edb, Ce^Edb, Wwt^Bw\r, Wwt, Wwrt, Gs^Edb, Gg, Ket, Gs, Gs, Gs, Gs, Hhd, Md, Md^Xm, Md, Md, Hhd, Hd, Hd, Dd^Es, Dd, Hd, Hd, Hd, Hd, Dd, Dd, Dd, Gd^Edt, Rd^Edt, Gs^Ecf, Rd, Rd^Es, Gd, Ce, Gs, Gs, Gs^Fts, Gs^Fts, Gd, Dd, Dd, Rd, Dd, Dd, Hd, Dd, Hd, Hd
Gs, Gs^Esd, Ds, Wwrt, Wwt^Ewl, Wwt^Ewl, Ds, Wwrt, Ds, Ds, Ds, Ds, Hh, Ds, Hh, Hhd, Md^Xo, Hhd, Hhd, Gs^Edb, Wwt, Ce, Wwrt, Wot, Wot, Wwrt, Wwt, Wwt, Wwt, Wwt^Bw\r, Wwt^Bw\r, Gs, Gs, Ce^Edb, Gg^Edb, Gg^Efm, Gs, Gs, Hhd, Md, Md, Md, Md, Gd, Hd, Dd, Dd, Dd, Hd, Hd, Hd, Dd^Dc, Hd, Dd, Rd, Gd, Dd, Ds, Dd^Edt, Rd^Edt, Gd, Gd, Dd, Gd, Rd, Gd, Gd, Rd^Esd, Rd^Esd, Dd^Edpp, Dd, Dd, Dd, Hd, Hd, Hd
Gs, Gs, Gs^Fts, Gs, Ds, Ds^Esd, Gg, Ds, Gs^Ftd, Gs^Fts, Gg^Efm, Gs, Gg, Hh, Hh, Hhd, Md^Xm, Md^Xm, Hhd, Wwrt, Wot, Wwrt, Wwt, Wwt, Wot, Wot, Wwt, Wwt, Wwt, Wwrt, Gs, Rb, Re^Edb, Ce^Edb, Gs, Gg, Gs, Hhd, Gs, Gd, Hhd, Hhd, Hhd, Hhd, Hhd, Hd, Dd, Hd, Hd, Hd, Dd, Dd, Dd, Dd, Dd, Ds, Dd, Dd, Dd, Gd, Gd, Dd, Dd, Rd, Rd, Ds, Dd, Rd, Dd, Dd, Rd, Hd, Dd, Hd, Hd, Mdd
Gs, Gs^Ft, Gs^Fts, Gs, Gs, Gs, Gg, Gg, Gs, Gs, Gg^Efm, Gs, Gs^Ftd, Hh, Hhd, Mm, Mm, Md^Xm, Md, Wwt, Wot, Wwt, Wwt, Ce, Ce^Edb, Gs^Fts, Gs, Wwf, Wwrt, Wwf^Ewl, Ce, Rb^Edb, Re^Edb, Gd^Edb, Gs^Vht, Gg, Gg^Edb, Gd, Gd, Hhd, Gd, Gd, Hhd, Hhd, Hd, Hd, Dd, Hd, Hd, Dd, Hd, Dd, Hd, Rd, Dd, Dd, Rd^Esd, Hd, Rd, Gd, Rd, Rd, Dd, Dd, Hd, Rd, Dd, Rd, Dd, Rd, Dd, Hd, Hd, Hd, Hd, Mdd
Gg^Efm, Gg, Gs, Gg, Gg, Gg^Es, Gg, Gs^Fts, Gs, Gg, Gs, Gs, Gg, Gg, Hhd, Hhd, Md, Md^Xm, Md^Xm, Wot, Md, Wwrt, Hhd, Gd, Gd, Ket^Edb, Ce^Edb, Gg, Gs, Ce^Edb, Gs^Edb, Gs, Re, Gs, Gd, Gs, Gs^Edb, Gs^Edb, Gd^Edb, Gd, Hd, Gd, Gd, Hd, Hd, Hd, Dd, Hd, Hd, Dd, Hd, Hd, Hd, Ds, Dd, Dd, Dd, Dd, Dd, Ds, Rd, Rd, Rd^Esd, Dd, Dd, Rd, Hd, Dd, Dd, Dd^Dc, Dd, Dd, Hd, Hd, Mdd, Mdd
Gg, Gg^Efm, Hh, Gg, Gs, Gs, Gg, Gg, Gg, Gs, Gg^Efm, Gs^Efm, Gg, Gs^Fts, Gs, Hhd, Hhd, Md, Md, Md^Xm, Md^Xm, Md, Hhd, Gd, Gd, Gd^Edb, Gd, Ce, Gs, Gs^Edb, Gg, Gg^Vht, Gs^Edb, Rd, Rd^Edb, Re, Re, Gs, Dd, Gd, Dd, Hd, Hd, Hd, Hd, Dd, Dd, Dd, Rd, Hd, Hd, Hd, Hd, Dd, Dd, Rd^Esd, Hd, Hd, Ds, Rd, Dd, Dd, Dd, Rd, Rd, Dd, Dd, Dd^Edp, Dd, Dd, Hd, Hd, Hd, Hd, Hd, Hd
Hh, Gg, Gs, Gs, Gs^Ftd, Gs, Gs^Fts, Gg^Efm, Gg, Gs, Gs, Gs, Gg^Efm, Gs, Hh, Hh, Hh, Hhd, Md, Md^Xm, Md^Xm, Md, Md, Hhd, Hhd, Gd, Gd, Gd, Gs^Vht, Gs^Edb, Gg^Edb, Gd, Gd^Edb, Re^Edb, Re^Edb, Rd, Dd^Vda, Gd, Dd^Edb, Ce^Edb, Dd, Hd, Dd, Dd, Dd, Dd, Hd, Dd, Rd, Hd, Hd, Hd, Hd, Dd, Cer, Dd, Hd, Hd, Dd, Rd, Dd, Dd, Dd, Rd, Rd, Rd^Esd, Rd, Dd^Edpp, Dd^Edpp, Hd, Dd, Dd, Dd, Hd, Dd, Hd
Hh, Hh, Hh, Gs, Gg, Gs^Ft, Gs^Ftd, Gg, Gs^Fts, Gs, Hh, Gg, Hh, Gs, Hh, Hh, Hh, Hhd, Md, Md^Xm, Md^Xm, Md^Xm, Md, Hhd, Gd, Hhd, Hhd, Gd, Gd, Gs^Edb, Hhd, Gs, Gs, Gd, Gd, Rd, Rd, Dd, Dd, Dd^Edb, Dd, Dd, Dd, Rd, Dd, Hd, Hd, Dd, Dd, Hd, Cer^Edb, Dd, Rd^Edb, Dd, Wwf, Dd, Dd^Vdr, Dd, Dd, Dd, Dd, Rd, Dd, Dd, Rd, Rd, Dd, Dd^Edpp, Dd^Edpp, Dd, Dd, Dd, Dd^Es, Hd, Dd, Dd
Mm, Hh, Hh, Gs, Hh, Gg^Ft, Hh^Ft, Gg, Gs^Fts, Gs^Fts, Gs, Gg, Hh, Hh, Mm^Xm, Mm, Mm, Hh, Hhd, Md, Md^Xm, Md^Xm, Md, Md, Hhd, Hhd, Hhd, Gd, Hhd, Hhd, Hd, Gd, Dd, Ce, Dd^Edb, Rd, Dd, Rd, Rd^Esd, Dd^Es, Dd, Dd, Ds, Rd, Dd, Hd, Hd, Hd, Dd, Cer, Dd^Edb, Rd^Edb, Rd^Edb, Dd, Wwt, Wwf, Rd, Ds, Dd, Dd^Edp, Rd, Rd^Esd, Dd, Rd^Esd, Rd, Ds, Dd, Dd, Dd, Dd, Rd, Dd, Dd, Dd, Rd, Dd
Mm, Mm, Hh, Hh, Hh, Gg, Hh, Gg^Efm, Hh, Hh, Gs, Gs^Fts, Mm, Mm, Mm^Xm, Mm, Hh, Mm, Hh, Md, Md, Md^Xm, Md^Xm, Md, Md, Hhd, Hhd, Hhd, Hd, Hd, Hd, Hd, Hd, Dd^Edb, Rd^Edb, Hd, Dd, Rd, Dd, Dd, Rd, Rd^Esd, Ds, Ds, Ds, Hd, Hd, Dd, Dd^Edb, Dd, Wwt, Rd, Wot, Wot, Wwt, Rd^Edt, Rd^Edt, Cer, Rd^Edt, Rd^Edt, Dd, Dd, Ds, Dd, Rd^Esd, Ds, Dd, Dd, Dd, Rd, Rd, Dd^Edp, Dd, Dd, Dd, Dd
Md^Xm, Mm, Mm, Mm, Hh, Hh, Hh, Hh, Mm, Mm, Hh, Hh, Mm^Xm, Mm^Xm, Mm^Xm, Mm, Hh, Hh, Hh, Md, Hh, Md, Md^Xm, Md^Xm, Md, Md, Hhd, Hd, Hd, Hd, Dd, Dd, Dd, Ds, Rd^Esd, Dd, Dd, Rd^Esd, Dd, Dd, Rd^Esd, Dd, Ds, Ds, Ds, Dd, Dd, Hd, Dd^Edb, Dd^Vdr, Dd, Wwt, Dd^Es, Wot, Wwf, Rd^Edt, Dd, Rd, Rd, Dd, Dd, Dd^Es, Ds, Rd, Dd, Rd, Hd, Hd, Dd, Dd, Rd, Rd^Esd, Dd, Dd^Edpp, Dd, Dd
Md^Xm, Md^Xm, Md^Xm, Mm, Mm, Mm, Hh, Hh, Mm, Mm, Mm, Mm, Mm^Xm, Mm^Xm, Mm, Hh, Hh, Hh, Hh, Hh, Md, Md, Md^Xm, Md^Xm, Md, Md^Xm, Hhd, Dd, Dd, Dd, Rd, Rd, Dd, Dd, Dd, Rd, Dd, Dd, Dd, Dd, Dd, Ds, Dd, Dd^Edp, Ds^Edp, Ds, Dd, Dd, Dd, Dd^Edb, Cer, Dd, Dd, Rd, Rd, Rd^Edb, Cer^Edb, Dd, Dd, Rd^Esd, Dd, Rd, Rd, Rd, Dd, Dd, Dd, Ds, Dd, Rd^Esd, Rd, Rd, Dd, Dd, Dd, Dd
Md^Xm, Mm, Mm, Mm, Hh, Hh, Mm, Mm, Mm, Mm, Mm, Mm, Mm^Xm, Mm^Xm, Mm, Mm, Hh, Hh, Hh, Md, Md^Xm, Md, Md^Xm, Md, Md, Md, Hd, Dd, Rd, Dd, Ds, Rd, Rd, Dd, Dd, Rd, Rd, Rd, Dd, Dd^Edp, Dd, Dd, Rd, Dd, Dd, Ds, Rd^Esd, Rd, Rd, Rd, Rd, Cer, Dd, Rd, Dd, Cer^Edb, Dd, Dd, Dd, Rd, Rd, Ds, Dd, Rd, Dd, Dd, Dd, Dd, Rd, Rd, Ds, Ds, Dd, Dd, Rd, Dd
Mm, Md^Xm, Mm, Mm, Hh, Hh, Hh, Mm, Hh, Hh, Hh, Mm, Mm^Xm, Hhd, Hh, Hh, Hhd, Mm, Md, Md, Md^Xm, Md^Xm, Md^Xm, Md^Xm, Md, Md, Hd, Dd, Dd, Rd, Rd, Rd, Dd, Rd, Rd, Rd, Rd, Dd, Dd, Dd, Dd, Rd, Dd, Rd, Rd, Rd^Esd, Dd, Dd, Dd, Dd^Edt, Rd^Edt, Rd, Rd, Rd^Esd, Dd, Dd^Es, Hd, Dd, Rd, Rd, Dd, Rd, Rd, Dd, Dd, Rd, Rd^Esd, Dd, Dd, Dd, Ds^Es, Ds, Dd, Rd, Rd^Esd, Dd
Mm, Mm, Hh, Hh, Gs, Hh, Hh, Mm, Hh, Hh, Mm, Mm, Mm, Hhd, Md, Hh, Md, Md, Md^Xm, Md^Xm, Md^Xm, Md^Xm, Md, Md^Xm, Md, Md, Hd, Dd, Ds, Rd^Esd, Rd, Dd, Dd, Dd, Dd, Dd, Dd, Dd, Rd, Dd, Rd, Dd, Rd, Rd, Ds, Ds, Hd, Dd, Dd, Rd^Edt, Dd, Rd, Dd, Rd, Rd, Dd, Dd, Rd, Rd, Dd, Dd, Rd, Rd, Dd, Dd^Ecf, Rd^Esd, Rd, Dd, Dd, Dd^Edpp, Ds, Ds^Es, Ds, Rd, Dd, Dd
Hh, Hh, Hh, Hh, Gs, Gs, Hh, Mm, Hh, Hh, Mm, Mm, Hhd, Md, Md, Md, Md^Xm, Md^Xm, Md^Xm, Md^Xm, Md^Xm, Md^Xm, Md, Md, Md, Md, Ds, Ds, Ds, Dd, Dd, Dd, Dd, Ds, Rd, Dd, Dd^Edp, Dd, Rd, Rd, Dd, Rd, Rd, Rd, Rd^Esd, Ds, Hd, Hd, Dd, Dd, Dd, Dd^Dr, Dd, Rd, Dd, Rd, Rd, Rd, Rd, Rd, Dd^Vdt, Dd, Rd^Edb, Rd, Dd, Rd^Vdt, Rd, Dd, Dd, Dd, Rd^Esd, Ds, Dd, Rd, Dd, Dd
Hh, Hh, Gs, Gs, Gg, Gs, Gg, Hh, Hh, Hh, Hhd, Mm, Md, Md, Md^Xm, Md^Xm, Md^Xm, Md, Md, Md^Xm, Md^Xm, Md, Hd, Md, Md, Hd, Hd, Ds, Ds, Ds, Dd, Rd^Edt, Rd, Dd, Rd^Edt, Rd, Dd, Rd, Dd, Dd, Dd^Edp, Dd^Edpp, Rd, Dd, Dd, Dd, Dd, Hd, Hd, Dd^Es, Dd, Ds, Rd, Dd, Rd, Rd, Rd, Dd, Dd, Dd, Dd, Rd, Cer^Edb, Rd^Edb, Cer, Rd^Edt, Rd^Edt, Dd, Rd, Dd, Rd, Dd, Dd, Dd, Dd, Dd
Hh, Hh, Gs, Gg, Hh, Gg, Hh, Hh, Hh, Hhd, Hhd, Md, Md^Xm, Md^Xm, Md^Xm, Md^Xm, Md^Xm, Md, Hd, Md, Md, Md^Xm, Hd, Hd, Hd, Dd, Ds, Ds, Rd^Esd, Rd^Edt, Rd, Dd^Vdt, Rd^Edt, Dd, Rd^Edt, Rd, Dd, Dd, Rd, Dd, Dd, Dd, Ds^Edp, Rd, Rd, Dd, Dd, Hd, Hd, Dd, Rd^Esd, Dd, Rd, Rd, Ds^Es, Rd, Dd, Dd, Ds, Dd^Ecf, Dd, Dd, Rd, Cer, 3 Ke, Cer^Edt, Dd, Rd, Dd^Ecf, Rd, Rd, Rd^Esd, Dd, Dd, Dd^Dc, Dd
Hh, Hh, Hh, Gg, Hh, Hh, Hhd, Hh, Hh, Hh, Md, Md, Md^Xm, Md^Xm, Md^Xm, Md^Xm, Md^Xm, Md, Hd, Hd, Hd, Md, Hd, Hd, Hd, Dd, Dd, Ds^Edpp, Ds, Ds, Cer^Edt, Rd, Rd, Rd^Edt, Dd, Dd, Dd, Rd^Esd, Rd, Rd, Dd^Edp, Dd, Rd, Rd, Dd, Dd, Hd, Ds, Hd, Dd, Dd, Rd, Dd, Ds, Dd, Dd, Hd, Dd, Ds, Rd^Esd, Dd^Vdt, Rd, Rd^Edb, Cer^Edb, Cer^Edb, Cer, Cer, Dd, Rd, Rd, Dd, Ds, Ds, Dd, Dd, Dd
Hh, Hh, Md, Hh, Hh, Md, Md, Hhd, Hh, Hh, Md^Xm, Md^Xm, Md, Md^Xm, Md^Xm, Md, Md, Md, Hd, Hd, Hd, Hd, Dd, Hd, Hd, Hd, Dd, Ds, Cer, Cer^Edt, 2 Ke, Cer, Dd, Dd^Vdt, Dd, Rd, Dd, Rd, Dd, Ds, Dd, Dd^Edp, Ds, Dd, Dd, Hd, Hd, Hd, Dd, Dd, Dd, Rd^Esd, Dd, Dd, Dd, Hd, Ds, Dd, Dd, Rd, Rd, Rd, Dd, Dd, Dd, Rd, Dd, Dd, Dd^Vdt, Dd, Ds, Dd, Dd, Ds, Ds, Dd
Md, Md, Md, Hh, Hh, Md, Md, Md, Md^Xm, Md^Xm, Md^Xm, Md^Xm, Md, Md, Md^Xm, Md, Md, Md, Hd, Hd, Hd, Hd, Dd, Dd, Hd, Dd, Dd^Vdt, Ds, Cer^Edt, Cer, Cer, Cer, Rd, Dd, Rd^Edt, Rd, Dd, Dd, Dd, Rd, Ds, Ds^Edp, Dd, Dd, Ds, Hd, Dd, Dd, Ds^Dr, Dd, Dd, Dd, Hd, Hd, Dd, Hd, Hd, Dd, Rd^Esd, Rd, Rd, Dd^Ecf, Rd^Vct, Ds, Dd, Rd^Esd, Rd, Rd, Rd, Dd, Rd^Esd, Ds, Ds, Rd^Esd, Rd, Dd
Md, Md^Xm, Md^Xm, Hh, Md, Md, Md^Xm, Md, Md, Md, Md^Xm, Md, Md, Md, Md, Md^Xm, Hd, Hd, Hd, Dd, Dd, Hd, Dd, Rd, Dd, Dd, Dd, Dd, Dd^Edt, Cer, Rd, Rd^Edt, Dd, Rd, Ds, Ds, Dd, Hd, Dd, Dd, Dd, Ds, Rd, Dd, Ds, Rd, Rd, Dd, Ds, Rd, Rd, Dd, Dd, Dd^Edp, Dd, Dd, Dd, Dd, Rd, Rd, Dd, Dd, Rd, Rd, Dd, Dd, Rd, Dd^Ecf, Dd, Rd, Ds^Es, Dd, Dd, Rd, Rd, Dd
Md^Xm, Md, Md^Xm, Md, Md, Md, Md^Xm, Md, Md^Xm, Md^Xm, Md^Xm, Md, Md, Md, Hd, Md, Hd, Hd, Dd, Dd, Dd^Dc, Dd, Rd^Esd, Rd, Rd, Rd^Esd, Dd^Edp, Dd, Dd, Rd, Dd, Dd^Edt, Dd, Dd^Vdt, Ds, Ds, Dd, Hd, Rd, Hd, Dd, Rd, Rd, Dd, Dd, Rd, Dd, Rd^Esd, Ds, Rd, Ds, Dd, Dd^Dc, Dd, Dd, Rd, Rd, Rd, Dd, Rd, Rd^Esd, Dd, Dd, Rd, Rd, Dd, Rd, Dd, Dd, Ds, Dd, Dd, Dd, Dd, Dd, Rd
Md^Xm, Md^Xm, Md^Xm, Md^Xm, Md^Xm, Md^Xm, Md^Xm, Md^Xm, Md^Xm, Md^Xm, Md^Xm, Md^Xm, Hd, Hd, Hd, Hd, Hd, Hd, Hd, Dd, Dd, Dd, Ds, Rd, Dd, Rd, Dd, Dd, Rd, Rd, Dd, Rd, Rd, Dd, Rd, Dd, Dd, Rd^Esd, Rd, Dd, Dd, Dd, Hd, Dd, Dd, Ds, Dd, Dd, Dd, Ds, Dd, Ds, Dd, Dd, Dd, Rd, Rd, Rd, Rd, Ds, Ds, Ds, Ds^Es, Rd^Esd, Rd, Dd, Rd, Rd^Esd, Ds, Ds, Ds, Dd^Dc, Dd, Dd, Dd, Dd
Md^Xm, Md^Xm, Md^Xm, Md^Xm, Md^Xm, Md^Xm, Md^Xm, Md^Xm, Md^Xm, Md, Md, Hd, Hd, Hd, Dd, Hd, Dd, Hd, Dd, Hd, Ds, Ds, Dd, Dd, Dd, Dd, Dd, Rd, Rd, Dd, Dd, Dd, Dd, Rd, Dd, Rd, Dd, Dd, Hd, Dd, Hd, Hd, Hd, Hd, Hd, Dd, Dd, Dd, Dd, Dd, Dd, Ds, Ds, Dd, Dd, Rd, Dd, Dd, Dd, Ds, Dd, Ds^Es, Ds, Ds, Dd, Dd, Dd, Rd, Rd, Rd, Dd, Dd, Dd, Dd, Dd, Dd
