border_size=1
usage=map

Dd          , Dd          , Dd          , Dd          , Dd          , Hd          , Hd          , Md          , Md          , Md          , Md          , Hd          , Gs^Ft       , Gs^Ft       , Gs^Ft       , Gs^Ft       , Gs^Ft       , Dd          , Gs^Ft       , Gs^Ft       , Gs^Ft       , Gs^Ft       , Gs^Ft       , Gs^Ft       , Gs^Ft       , Gs^Ft       , Gs^Ft       , Gs^Ft       , Gs^Ft       , Gs^Ft       , Gs^Ft       , Gs^Ft       , Gs^Ft       , Gs^Ft       , Gs^Ft       , Gs^Ft       , Hh          , Hh          , Hh          , Hh          , Hh          , Hh          , Hh          , Hh          , Hh          , Hh          , Gs          , Gs          , Gs          , Gs          , Gs          , Gs          , Ww          , Ww          , Wo          , Wo          , Wo          , Wo          , Ww          , Ww          , Wwf         , Ww          
Dd          , Dd          , Dd          , Hd          , Hd          , Hd          , Hd          , Md          , Md^Xm       , Md^Xm       , Hh          , Gs^Ft       , Gs^Ft       , Gs^Ft       , Gs          , Gs          , Gs          , Gs^Ft       , Hh          , Hh          , Hh          , Hh          , Gs          , Gs          , Gs          , Gs          , Gs^Ft       , Gs^Ft       , Gs          , Gs          , Gs          , Gs          , Gs^Ft       , Hh          , Hh          , Hh          , Hh          , Hh          , Gs          , Hh          , Gs          , Hh          , Gs          , Gs          , Gs          , Gs          , Ww          , Wwf         , Ww          , Wo          , Wo          , Wo          , Wo          , Wo          , Wo          , Wo          , Wwf         , Ww          , Wwf         , Ww          , Gs          , Gs          
Gs^Ft       , Dd          , Gs^Ft       , Dd          , Dd          , Hd          , Md          , Md          , Md^Xm       , Md          , Mm          , Gs^Ft       , Gs^Ft       , Gs          , Gs^Ft       , Gs^Ft       , Gs^Ft       , Hh          , Hh          , Gs          , Gs          , Gs          , Ww          , Gs          , Ww          , Gs          , Ww          , Gs^Ft       , Ww          , Ww          , Ww          , Wwf         , Wwf         , Gs          , Gs^Vht      , Gs^Ft       , Gs          , Gs          , Ww          , Gs          , Ww          , Gs          , Ww          , Ww          , Ww          , Wwf         , Ww          , Wwf         , Ww          , Ww          , Ww          , Ww          , Ww          , Ww          , Gs^Ft       , Ww          , Ds          , Wwf         , Hh          , Gs^Ft       , Gs          , Hh          
Gs          , Gs^Ft       , Gs          , Gs^Ft       , Gs          , Gs          , Md          , Md^Xm       , Mm^Xm       , Mm^Xm       , Mm          , Hh          , Hh          , Gs          , Gs^Ft       , Hh          , Hh          , Gs^Ft       , Gs          , Gs          , Ww          , Ww          , Wo          , Ww          , Wo          , Ww          , Wo          , Ww          , Wo          , Wo          , Wo          , Ww          , Ww          , Ww          , Ww          , Ww          , Ww          , Ww          , Wo          , Ww          , Ww          , Wwf         , Wwf         , Wwf         , Ww          , Ww          , Wwf         , Ww          , Gs          , Wwf         , Wwf         , Ds          , Gs          , Gs^Ft       , Gs^Ft       , Gs^Vht      , Hh          , Hh          , Gs^Ft       , Gs^Vht      , Hh          , Gs          
Gs          , Gs          , Gs^Ft       , Gs^Ft       , Gs^Ft       , Gs^Ft       , Mm          , Mm^Xm       , Mm          , Mm          , Hh          , Hh          , Hh          , Gs          , Gs          , Hh          , Gs^Ft       , Gs^Ft       , Wwf         , Wwf         , Wo          , Wo          , Wo          , Wo          , Wo          , Wo          , Ww          , Wo          , Ww          , Wo          , Ww          , Ww          , Gs^Ft       , Wwf         , Ww          , Ww          , Ww          , Wo          , Ww          , Ww          , Gs          , Wwf         , Gs^Ft       , Gs^Ft       , Gs          , Gs          , Gs          , Gs          , Gs          , Gs          , Gs          , Hh          , Hh          , Hh          , Hh          , Hh          , Gs^Ft       , Ce          , 1 Ke        , Hh          , Hd          , Gs          
Gs          , Hh          , Hh          , Hh          , Gs^Ft       , Hh          , Mm          , Mm^Xm       , Mm          , Mm          , Gs          , Gs^Ft       , Gs^Ft       , Gs^Ft       , Hh          , Hh          , Wwf         , Gs          , Wwf         , Ww          , Ww          , Ww          , Co          , Ww          , Ww          , Ww          , Gs          , Ww          , Wwf         , Ww          , Wwf         , Wwf         , Gs          , Gs          , Hh          , Ww          , Gs          , Ww          , Gs          , Gs          , Gs          , Gs          , Gs^Ft       , Gs          , Hh          , Gs          , Gs          , Gs          , Gs          , Gs          , Gs          , Gs          , Gs          , Gs^Vht      , Gs          , Hh          , Ce          , Ce          , Ce          , Ce          , Rd          , Hd          
Hh          , Gs          , Gs^Ft       , Gs^Ft       , Gs          , Hh          , Gs^Ft       , Mm^Xm       , Gs^Xo       , Gs^Ft       , Wwf         , Gs          , Ww          , Gs^Vht      , Ww          , Wwf         , Wwf         , Wwf         , Ww          , Ww          , Wwf         , Co          , Co          , Gs^Ft       , Gs^Ft       , Gs^Ft       , Gs          , Gs          , Gs          , Gs          , Gs          , Gs          , Gs          , Gs          , Hh          , Hh          , Gs          , Gs          , Gs          , Gs          , Hh          , Hh          , Hh          , Hh          , Gs          , Gs          , Rd          , Dd          , Rd          , Rd          , Ds          , Dd          , Dd^Vdt      , Rd          , Dd          , Gs          , Ds          , Ce          , Dd          , Gs          , Rd          , Hd          
Gs          , Gs          , Wwf         , Gs          , Ww          , Gs^Ft       , Ww          , Gs^Xo       , Ww^Xo       , Ww^Xo       , Ww          , Ww          , Ww          , Ww          , Ww          , Wwf         , Ww          , Ww          , Ww          , Wwf         , Co          , Ww          , Ww          , Gs          , Gs          , Gs          , Gs          , Gs^Vht      , Gs          , Gs          , Gs          , Gs          , Gs          , Gs          , Hh          , Gs          , Gs          , Gs          , Ds          , Gs          , Gs          , Gs          , Gs          , Gs          , Dd          , Dd          , Rd          , Dd          , Rd          , Rd          , Ds          , Dd          , Rd          , Rd          , Dd          , Ds          , Rd          , Ds          , Ds          , Dd^Vdt      , Rd          , Rd          
Ww          , Ww          , Ww          , Ww          , Ww          , Wwf         , Ww          , Ww          , Wwf         , Wwf         , Ds^Xo       , Wwf         , Gs          , Gs^Ft       , Gs^Ft       , Co          , Ds          , Ds          , Wwf         , Co          , 2 Ko        , Co          , Ww          , Co          , Co          , Gs          , Gs          , Gs          , Hd          , Hd          , Hd          , Hd          , Hd          , Dd          , Dd          , Dd          , Dd          , Ds          , Ds          , Ds          , Ds          , Gs          , Gs          , Gs          , Rd          , Rd          , Ds          , Hd          , Dd          , Dd          , Dd          , Rd          , Dd          , Ds          , Rd          , Dd          , Rd          , Dd          , Rd          , Ds          , Rd          , Rd          
Ww          , Wwf         , Gs^Ft       , Ww          , Ds          , Ww          , Ds          , Ww          , Ds          , Ds^Xo       , Hd^Xo       , Gs^Ft       , Hh          , Gs^Ft       , Hh          , Co          , Gs          , Gs^Vht      , Wwf         , Co          , Co          , Co          , Wwf         , Ww          , Co          , Gs          , Gs          , Gs          , Hd          , Md          , Md^Xm       , Hd          , Md          , Hd          , Md^Xm       , Md          , Md          , Dd          , Hd          , Dd          , Dd          , Rd          , Rd          , Ds          , Ds          , Rd          , Rd          , Hd          , Dd          , Hd          , Rd          , Dd          , Rd          , Rd          , Rd          , Dd          , Ds          , Dd          , Ds          , Rd          , Dd          , Dd          
Hd          , Ds          , Gs^Ft       , Gs          , Gs          , Ds          , Hh          , Ds          , Hh          , Hd^Xo       , Md^Xo       , Hd          , Hd          , Hh          , Hh          , Hh          , Gs          , Co          , Wwf         , Ww          , Wwf         , Ww          , Ww          , Gs^Ft       , Gs^Ft       , Dd^Vda      , Co          , Dd          , Dd^Dr       , Hd          , Md          , Md^Xm       , Md^Xm       , Md^Xm       , Hd          , Hd          , Hd          , Hd          , Rd          , Rd          , Dd          , Dd          , Rd          , Dd          , Ds          , Ds          , Dd          , Dd          , Rd          , Ds          , Dd          , Ds          , Rd          , Hd          , Ds          , Hd          , Rd          , Rd          , Rd          , Dd          , Dd          , Rd          
Hh          , Hh          , Gs^Ft       , Gs^Ft       , Gg^Efm         , Gs          , Hh          , Hh          , Hh          , Ds          , Ds^Xo       , Md^Xo       , Hd          , Hh          , Hh          , Ds^Dr       , Gs          , Co          , Gs          , Gs^Ft       , Gs^Dr       , Ww          , Ww          , Ww          , Ww          , Gs          , Co          , Dd          , Dd          , Hd          , Hd          , Md^Xm       , Md^Xm       , Md          , Md          , Hd          , Dd          , Dd          , Dd          , Rd          , Dd          , Rd          , Dd^Dc       , Dd          , Rd          , Hd^Dr       , Rd          , Dd          , Dd          , Ds          , Dd          , Ds          , Dd          , Rd          , Ds          , Dd          , Dd^Dc       , Rd          , Rd          , Ds          , Dd          , Rd          
Hh          , Hh          , Gs          , Gs          , Gg^Efm         , Gs          , Gs^Ft       , Hh          , Gs^Ft       , Ds          , Md^Xo       , Md^Xo       , Md          , Hh          , Hh          , Ds          , Dd          , Dd^Vda      , Co          , Gs^Ft       , Gs^Vht      , Wwf         , Ww          , Wwf         , Ww          , Gs^Ft       , Gs          , Ds          , Dd          , Dd          , Hd          , Md          , Hd          , Hd          , Hd          , Md^Xm       , Hd          , Hd          , Dd          , Ds          , Dd          , Rd          , Rd          , Rd          , Hd          , Hd          , Hd          , Rd          , Dd          , Dd          , Rd          , Hd          , Rd          , Ds          , Rd          , Dd          , Rd          , Dd          , Hd          , Rd          , Dd          , Rd          
Hh          , Gs^Ft       , Gs          , Gg          , Hh          , Hh          , Hh          , Hh          , Gs          , Ds          , Md          , Md^Xm       , Md^Xm       , Md          , Md          , Hd          , Hd          , Dd          , Hd          , Co          , Gs          , Ww          , Gs^Ft       , Wwf         , Gs          , Gs^Vht      , Co          , Ds          , Dd          , Hd          , Hd          , Md^Xm       , Hd          , Hd          , Dd^Dc       , Md          , Hd          , Dd          , Rd          , Rd          , Dd          , Dd          , Rd          , Dd          , Dd          , Hd          , Dd          , Ds          , Dd          , Dd          , Dd          , Dd          , Dd          , Ds          , Rd          , Rd          , Hd          , Rd          , Hd          , Rd          , Dd          , Dd          
Hh          , Gg          , Gg          , Gs          , Gg^Efm         , Gs          , Gs          , Hh          , Gs          , Dd          , Hd          , Md          , Md          , Md^Xm       , Md^Xm       , Md          , Hd          , Dd          , Dd^Dr       , Dd          , Dd          , Co          , Co          , Gs          , Ds          , Co          , Rd          , Dd          , Hd          , Rd          , Rd          , Dd          , Dd          , Hd          , Dd          , Hd          , Dd          , Dd          , Rd          , Dd          , Dd          , Dd          , Rd          , Dd          , Dd          , Rd          , Rd          , Dd          , Dd          , Rd          , Ds          , Dd          , Ds          , Rd          , Rd          , Rd          , Hd          , Ds          , Dd          , Rd          , Dd          , Dd          
Gs^Ft       , Hh          , Hh          , Gs          , Gs          , Gs          , Gg          , Gs          , Dd          , Dd          , Dd          , Hd          , Md          , Md^Xm       , Md^Xm       , Md          , Md          , Hd          , Dd          , Ds          , Dd          , Rd          , Rd          , Ds          , Dd          , Dd          , Dd          , Dd          , Hd          , Dd          , Hd          , Dd          , Dd          , Rd          , Dd          , Dd          , Dd          , Dd          , Dd          , Dd          , Dd          , Rd          , Rd          , Hd          , Dd          , Dd          , Dd^Dr       , Dd          , Hd          , Dd          , Hd          , Ds          , Hd          , Rd          , Hd          , Dd          , Dd          , Dd          , Dd          , Dd          , Dd          , Dd          
Gs^Ft       , Hh          , Gs^Ft       , Gs          , Hh          , Hh          , Gg          , Gs          , Gs          , Dd          , Dd          , Hd          , Md          , Md^Xm       , Md^Xm       , Md^Xm       , Md          , Hd          , Rd          , Ds          , Rd          , Dd          , Dd          , Dd          , Hd          , Dd^Dr       , Dd          , Hd          , Hd          , Hd          , Dd          , Dd          , Dd          , Dd          , Dd          , Dd          , Hd          , Rd          , Dd          , Dd          , Rd          , Dd          , Dd          , Hd          , Dd          , Dd          , Dd          , Dd          , Dd          , Hd          , Hd          , Ds          , Ds          , Hd          , Hd          , Hd          , Hd          , Dd          , Rd          , Ds          , Ds          , Dd          
Hh          , Gg          , Gs^Ft       , Gs^Ft       , Gs          , Hh          , Hh          , Hh          , Gs^Ft       , Gs          , Dd          , Dd          , Dd          , Md          , Md^Xm       , Md^Xm       , Md          , Md          , Hd          , Dd          , Dd          , Hd          , Dd          , Rd          , Hd          , Hd          , Hd          , Hd          , Hd          , Hd          , Rd          , Dd          , Dd          , Dd          , Dd          , Dd          , Hd          , Rd          , Dd          , Rd          , Ds          , Dd          , Dd          , Dd          , Dd          , Dd^Vdt      , Dd          , Dd          , Dd          , Hd          , Hd          , Ds          , Hd          , Rd          , Rd          , Dd          , Hd          , Rd          , Rd          , Ds          , Dd          , Ds          
Hh          , Gg^Efm         , Hh          , Hh          , Gs          , Gs^Ft       , Hh          , Hh          , Gs          , Dd          , Hd          , Dd^Dc       , Dd          , Md          , Md          , Md^Xm       , Md^Xm       , Md          , Md          , Dd          , Hd          , Dd          , Hd          , Hd          , Hd          , Hd          , Hd          , Hd          , Dd          , Dd          , Hd          , Dd          , Dd          , Dd          , Dd          , Dd          , Rd          , Rd          , Rd          , Ds          , Ds          , Rd          , Ce          , Dd          , Ce          , Dd          , Dd          , Dd          , Hd          , Dd          , Dd          , Rd          , Rd          , Hd          , Dd          , Dd          , Ds          , Dd          , Dd          , Ds          , Ds          , Dd          
Hh          , Hh          , Gg^Efm         , Gs          , Hh          , Hh          , Hh          , Hh          , Dd          , Dd          , Hd          , Hd          , Dd          , Md          , Hd          , Md          , Md^Xm       , Md^Xm       , Md          , Md          , Hd          , Hd          , Ds          , Hd          , Dd          , Hd          , Dd          , Ds          , Dd          , Dd          , Dd          , Dd          , Hd          , Dd          , Rd          , Hd          , Md          , Dd          , Dd^Dc       , Dd          , Ds          , Dd          , Dd          , Ce          , 3 Ke        , Ce          , Dd          , Dd^Vdt      , Dd          , Hd          , Dd          , Rd          , Dd          , Rd          , Rd          , Rd          , Ds          , Hd          , Rd          , Dd          , Dd          , Dd          
Hh          , Hh          , Gg^Efm         , Gg          , Gs          , Hh          , Hh          , Hh          , Dd          , Dd          , Ds          , Ds          , Hd          , Dd          , Md          , Md          , Md^Xm       , Md^Xm       , Md          , Md          , Hd          , Hd          , Hd          , Dd          , Dd^Vdt      , Hd          , Dd          , Rd          , Dd          , Dd          , Dd          , Dd          , Dd          , Rd          , Hd          , Md^Xm       , Md          , Hd          , Dd          , Dd          , Dd          , Dd^Vdt      , Dd          , Ce          , Ce          , Ce          , Ce          , Hd          , Hd          , Hd          , Hd          , Dd          , Dd          , Hd          , Rd          , Ds          , Ds          , Ds          , Rd          , Dd          , Rd          , Ds          
Gs          , Gg          , Gg          , Gg^Efm         , Gg          , Hh          , Gs^Ft       , Hh          , Gs^Ft       , Dd          , Ds          , Ds          , Hd          , Md          , Dd^Dc       , Md          , Md^Xm       , Md          , Md          , Md          , Hd          , Rd          , Rd          , Dd          , Ds          , Hd          , Ds          , Dd          , Dd          , Dd          , Rd          , Rd          , Dd          , Dd          , Dd          , Dd          , Md          , Dd          , Rd          , Rd          , Dd          , Rd          , Ds          , Ds          , Dd          , Dd          , Dd          , Dd          , Hd          , Hd          , Hd          , Dd          , Hd          , Md          , Hd          , Ds          , Hd          , Ds          , Dd          , Rd          , Rd          , Rd          
Gs^Ft       , Gs          , Hh          , Hh          , Hh          , Gs          , Hh          , Hh          , Hh          , Gs          , Dd          , Dd          , Hd          , Md          , Dd          , Md          , Md          , Md^Xm       , Md          , Md          , Hd          , Rd          , Dd^Vdt      , Dd          , Ce          , Ce          , Ce          , Hd          , Hd          , Dd          , Dd          , Hd          , Dd          , Dd          , Md^Xm       , Md          , Hd          , Dd          , Dd          , Dd          , Dd          , Dd          , Dd          , Dd          , Dd^Vdt      , Rd          , Dd          , Dd          , Hd          , Hd          , Md          , Md          , Md          , Md          , Md^Xm       , Rd          , Hd          , Dd          , Dd          , Rd          , Dd^Dc       , Rd          
Gs^Ft       , Gs^Ft       , Hh          , Hh          , Gs          , Hh          , Hh          , Hh          , Hh          , Gs^Ft       , Gs^Ft       , Dd          , Dd          , Dd          , Dd          , Md          , Md^Xm       , Md^Xm       , Md          , Hd          , Hd          , Dd          , Ds          , Ce          , Wwf         , 4 Ke        , Ce          , Dd          , Rd          , Rd          , Ds          , Dd          , Hd          , Hd          , Md          , Dd          , Rd          , Rd          , Dd          , Dd          , Dd          , Dd          , Dd          , Dd          , Dd          , Dd          , Dd          , Hd          , Dd^Dc       , Hd          , Hd          , Hd          , Hd          , Md          , Md          , Md^Xm       , Md          , Hd          , Hd          , Dd          , Dd          , Dd          
Gs^Ft       , Gs^Ft       , Gs          , Gg          , Gs          , Gg^Efm         , Hh          , Hh          , Gs^Ft       , Gs^Ft       , Gs^Ft       , Gs          , Dd          , Hd          , Md          , Md          , Md^Xm       , Md^Xm       , Md          , Hd          , Ds          , Ds          , Dd^Vdt      , Ce          , Ce          , Ce          , Ds          , Ds          , Rd          , Ds          , Rd          , Hd          , Md          , Md          , Hd          , Hd          , Hd          , Hd          , Rd          , Rd          , Dd          , Hd          , Hd          , Rd          , Dd          , Hd          , Dd          , Dd          , Ds          , Hd          , Ds          , Ds          , Dd          , Hd          , Dd          , Md          , Md^Xm       , Md          , Hd          , Dd          , Dd          , Dd          
Hh          , Gs          , Hh          , Gs          , Gs^Ft       , Gg^Efm         , Hh          , Hh          , Hh          , Gs          , Dd          , Dd          , Ds          , Hd          , Md          , Md          , Md^Xm       , Md^Xm       , Md          , Hd          , Hd          , Dd          , Hd          , Dd          , Dd          , Rd          , Rd          , Dd          , Rd          , Rd          , Dd          , Hd          , Md          , Rd          , Hd          , Rd          , Ds          , Rd          , Hd          , Dd          , Rd          , Dd          , Dd          , Rd          , Rd          , Ds          , Rd          , Hd          , Ds          , Ds          , Rd          , Rd          , Ds          , Dd          , Hd          , Md          , Md^Xm       , Md          , Hd          , Dd          , Dd          , Dd          
Hh          , Hh          , Gs^Ft       , Gs          , Hh          , Hh          , Gs          , Gg^Efm         , Gs          , Gs          , Dd          , Hd          , Ds          , Dd          , Md          , Md          , Md          , Md^Xm       , Md          , Md          , Md          , Hd          , Rd          , Rd          , Rd          , Dd^Vdt      , Rd          , Dd          , Hd          , Rd          , Md          , Md          , Rd          , Rd          , Dd          , Hd          , Ds          , Dd          , Rd          , Rd          , Ds          , Dd          , Hd          , Hd          , Rd          , Ds          , Hd          , Rd          , Ds          , Dd          , Rd          , Dd          , Ds          , Hd          , Hd          , Md^Xm       , Md^Xm       , Md          , Dd          , Dd          , Hd          , Md          
Hh          , Hh          , Gs^Ft       , Hh          , Hh          , Hh          , Gg          , Hh          , Gs^Ft       , Gs          , Dd          , Ds          , Hd          , Hd          , Md          , Md          , Md^Xm       , Md^Xm       , Md          , Md          , Dd^Dc       , Md          , Rd          , Rd          , Hd          , Dd          , Rd          , Rd          , Dd          , Md          , Dd          , Hd          , Dd          , Hd          , Dd^Dc       , Dd          , Rd          , Ds          , Dd          , Rd          , Ds          , Ds          , Hd          , Rd          , Hd          , Ds          , Dd          , Ds          , Dd          , Dd          , Hd          , Hd          , Ds          , Md          , Md^Xm       , Md          , Md          , Hd          , Dd          , Dd          , Md          , Md          
Hh          , Hh          , Hh          , Gs          , Gs          , Gg          , Gs^Ft       , Hh          , Hh          , Gs          , Dd          , Dd          , Hd          , Md          , Md          , Md          , Md          , Md^Xm       , Md^Xm       , Md          , Md          , Md          , Hd          , Hd          , Md          , Hd          , Rd          , Rd          , Rd          , Md          , Hd          , Hd          , Rd          , Dd          , Hd          , Dd          , Rd          , Dd          , Dd          , Dd          , Hd          , Rd          , Hd          , Hd          , Hd          , Ds          , Ds          , Dd          , Dd          , Hd          , Ds          , Ds          , Hd          , Md          , Md          , Hd          , Dd          , Md^Xm       , Md^Xm       , Hd          , Dd          , Md          
Gs          , Hh          , Gs^Ft       , Gs          , Gs^Ft       , Gs          , Gs          , Gs^Ft       , Hh          , Hh          , Dd          , Hd          , Dd          , Md          , Md          , Md^Xm       , Md          , Md^Xm       , Md^Xm       , Md          , Md          , Hd          , Md          , Md          , Hd          , Md          , Hd          , Rd          , Rd          , Hd          , Dd^Vdt      , Dd          , Rd          , Rd          , Dd          , Rd          , Rd          , Dd          , Dd          , Dd          , Dd          , Hd          , Hd          , Hd          , Hd          , Hd          , Hd          , Hd          , Dd          , Hd          , Hd          , Md          , Md          , Md          , Hd          , Hd          , Ds          , Ds          , Dd          , Hd          , Ds          , Dd          
