border_size=1
usage=map

Dd          , Dd          , Dd          , Dd          , Dd          , Hd          , Hd          , Md          , Md          , Md          , Md          , Hd          , Gs^Ft       , Gs^Ft       , Gs^Ft       , Gs^Ft       , Gs^Ft       , Dd          , Gs^Ft       , Gs^Ft       , Gs^Ft       , Gs^Ft       , Gs^Ft       , Gs^Ft       , Gs^Ft       , Gs^Ft       , Gs^Ft       , Gs^Ft       , Gs^Ft       , Gs^Ft       , Gs^Ft       , Gs^Ft       , Gs^Ft       , Gs^Ft       , Gs^Ft       , Gs^Ft       , Hh          , Hh          , Hh          , Hh          , Hh          , Hh          , Hh          , Hh          , Hh          , Hh          , Gs          , Gs          , Gs          , Gs          , Gs          , Gs          , Ww          , Ww          , Wo          , Wo          , Wo          , Wo          , Ww          , Ww          , Ww          , Ww          
Dd          , Dd          , Dd          , Hd          , Hd          , Hd          , Hd          , Md          , Md^Xm       , Md^Xm       , Hh          , Gs^Ft       , Gs^Ft       , Gs^Ft       , Gs          , Gs          , Gs          , Gs^Ft       , Hh          , Hh          , Hh          , Hh          , Gs          , Gs          , Gs          , Gs          , Gs^Ft       , Gs^Ft       , Gs          , Gs          , Gs          , Gs          , Gs^Ft       , Hh          , Hh          , Hh          , Hh          , Hh          , Gs          , Hh          , Gs          , Hh          , Gs          , Gs          , Gs          , Gs          , Wwf         , Wwf         , Ww          , Wo          , Wo          , Wo          , Wo          , Wo          , Wo          , Wo          , Ww          , Wo          , Wwf         , Ww          , Gs          , Gs          
Gs^Ft       , Dd          , Gs^Ft       , Dd          , Dd          , Hd          , Md          , Md          , Md^Xm       , Md          , Mm          , Gs^Ft       , Gs^Ft       , Gs          , Gs^Ft       , Gs^Ft       , Gs^Ft       , Hh          , Hh          , Gs          , Gs          , Gs          , Ww          , Gs          , Ww          , Gs          , Ww          , Gs^Ft       , Ww          , Ww          , Ww          , Ww          , Ww          , Gs          , Gs^Vht      , Gs^Ft       , Gs          , Gs          , Ww          , Gs          , Ww          , Gs          , Ww          , Ww          , Ww          , Wwf         , Ww          , Wwf         , Ww          , Ww          , Ww          , Ww          , Ww          , Ww          , Gs^Ft       , Ww          , Ds          , Wwf         , Hh          , Gs^Ft       , Gs          , Hh          
Gs          , Gs^Ft       , Gs          , Gs^Ft       , Gs          , Gs          , Md          , Md^Xm       , Mm^Xm       , Mm^Xm       , Mm          , Hh          , Hh          , Gs          , Gs^Ft       , Hh          , Hh          , Gs^Ft       , Gs          , Gs          , Ww          , Ww          , Wo          , Ww          , Wo          , Ww          , Wo          , Ww          , Wo          , Wo          , Wo          , Ww          , Ww          , Ww          , Ww          , Ww          , Ww          , Ww          , Wo          , Ww          , Ww          , Ww          , Ww          , Ww          , Ww          , Ww          , Ww          , Ww          , Gs          , Wwf         , Wwf         , Ds          , Gs          , Gs^Ft       , Gs^Ft       , Gs^Vht      , Hh          , Hh          , Ce          , Gs^Vht      , Hh          , Gs          
Gs          , Gs          , Gs^Ft       , Gs^Ft       , Gs^Ft       , Gs^Ft       , Mm          , Mm^Xm       , Mm          , Mm          , Hh          , Hh          , Hh          , Gs          , Gs          , Hh          , Gs^Ft       , Gs^Ft       , Wwf         , Wwf         , Wo          , Wo          , Wo          , Wo          , Wo          , Wo          , Ww          , Wo          , Ww          , Wo          , Ww          , Ww          , Gs^Ft       , Ww          , Ww          , Ww          , Ww          , Wo          , Ww          , Ww          , Gs          , Ww          , Gs^Ft       , Gs^Ft       , Gs          , Gs          , Gs          , Gs          , Gs          , Gs          , Gs          , Hh          , Hh          , Hh          , Hh          , Hh          , Gs^Ft       , Ce          , 1 Ke        , Hh          , Hd          , Gs          
Gs          , Hh          , Hh          , Hh          , Gs^Ft       , Hh          , Mm          , Mm^Xm       , Mm          , Mm          , Gs          , Gs^Ft       , Gs^Ft       , Gs^Ft       , Hh          , Hh          , Wwf         , Gs          , Wwf         , Ww          , Ww          , Ww          , Ce          , Ww          , Ww          , Ww          , Gs          , Ww          , Ww          , Ww          , Ww          , Ww          , Gs          , Gs          , Hh          , Ww          , Gs          , Ww          , Gs          , Gs          , Gs          , Gs          , Gs^Ft       , Gs          , Hh          , Gs          , Gs          , Gs          , Gs          , Gs          , Gs          , Gs          , Gs          , Gs^Vht      , Gs          , Hh          , Gs^Ft       , Ce          , Ce          , Ce          , Rd          , Hd          
Hh          , Gs          , Gs^Ft       , Gs^Ft       , Gs          , Hh          , Gs^Ft       , Mm^Xm       , Gs          , Gs^Ft       , Ww          , Gs          , Ww          , Gs^Vht      , Ww          , Wwf         , Wwf         , Wwf         , Ww          , Ww          , Wwf         , Ce          , Ce          , Gs^Ft       , Gs^Ft       , Gs^Ft       , Gs          , Gs          , Gs          , Gs          , Gs          , Gs          , Gs          , Gs          , Hh          , Hh          , Gs          , Gs          , Gs          , Gs          , Hh          , Hh          , Hh          , Hh          , Gs          , Gs          , Rd          , Dd          , Rd          , Rd          , Ds          , Dd          , Dd^Vdt      , Rd          , Dd          , Gs          , Ds          , Gs^Ft       , Dd          , Gs          , Rd          , Hd          
Gs          , Gs          , Ww          , Gs          , Ww          , Gs^Ft       , Ww          , Gs          , Ww          , Ww          , Ww          , Ww          , Ww          , Ww          , Ww          , Ww          , Ww          , Ww          , Ww          , Ww          , Ce          , Wwf         , Wwf         , Gs          , Gs          , Gs          , Gs          , Gs^Vht      , Gs          , Gs          , Gs          , Gs          , Gs          , Gs          , Hh          , Gs          , Gs          , Gs          , Ds          , Gs          , Gs          , Gs          , Gs          , Gs          , Dd          , Dd          , Rd          , Dd          , Rd          , Rd          , Ds          , Dd          , Rd          , Rd          , Dd          , Ds          , Rd          , Ds          , Ds          , Dd^Vdt      , Rd          , Rd          
Ww          , Ww          , Ww          , Ww          , Ww          , Ww          , Ww          , Ww          , Ww          , Ww          , Ds          , Ds          , Gs          , Gs^Ft       , Gs^Ft       , Ce          , Ds          , Ds          , Wwf         , Ce          , 2 Ke        , Ce          , Wwf         , Ce          , Ce          , Gs          , Gs          , Gs          , Hd          , Hd          , Hd          , Hd          , Hd          , Dd          , Dd          , Dd          , Dd          , Ds          , Ds          , Ds          , Ds          , Gs          , Gs          , Gs          , Rd          , Rd          , Ds          , Hd          , Dd          , Dd          , Dd          , Rd          , Rd          , Ds          , Rd          , Dd          , Rd          , Dd          , Rd          , Ds          , Rd          , Rd          
Ww          , Ww          , Gs^Ft       , Ww          , Ds          , Ww          , Ds          , Ww          , Ds          , Ds          , Hd          , Gs^Ft       , Hh          , Gs^Ft       , Hh          , Ce          , Gs          , Gs^Vht      , Wwf         , Ce          , Ce          , Ce          , Wwf         , Ww          , Ce          , Gs          , Gs          , Gs          , Hd          , Md          , Md^Xm       , Hd          , Md          , Hd          , Md^Xm       , Md          , Md          , Dd          , Hd          , Dd          , Dd          , Rd          , Rd          , Ds          , Ds          , Rd          , Rd          , Hd          , Dd          , Hd          , Rd          , Rd          , Rd          , Rd          , Rd          , Rd          , Ds          , Dd          , Ds          , Rd          , Dd          , Dd          
Hd          , Ds          , Gs^Ft       , Gs          , Gs          , Ds          , Hh          , Ds          , Hh          , Hd          , Md          , Hd          , Hd          , Hh          , Hh          , Hh          , Gs          , Ce          , Wwf         , Wwf         , Wwf         , Wwf         , Ww          , Gs^Ft       , Gs^Ft       , Dd^Vda      , Ce          , Dd          , Dd          , Hd          , Md          , Md^Xm       , Md^Xm       , Md^Xm       , Hd          , Hd          , Hd          , Hd          , Rd          , Rd          , Dd          , Dd          , Rd          , Dd          , Ds          , Ds          , Rd          , Dd          , Rd          , Ds          , Dd          , Ds          , Rd          , Rd          , Ds          , Hd          , Rd          , Rd          , Rd          , Dd          , Dd          , Rd          
Hh          , Hh          , Gs^Ft       , Gs^Ft       , Ggf         , Gs          , Hh          , Hh          , Hh          , Ds          , Ds          , Md          , Hd          , Hh          , Hh          , Ds          , Gs          , Ce          , Gs          , Gs^Ft       , Gs          , Wwf         , Wwf         , Wwf         , Ww          , Gs          , Ce          , Dd          , Dd          , Hd          , Hd          , Md^Xm       , Md^Xm       , Md          , Md          , Hd          , Dd          , Dd          , Dd          , Rd          , Dd          , Rd          , Dd^Dc       , Dd          , Rd          , Rd          , Rd          , Dd          , Rd          , Ds          , Dd          , Ds          , Dd          , Rd          , Ds          , Dd          , Dd^Dc       , Rd          , Rd          , Ds          , Dd          , Rd          
Hh          , Hh          , Gs          , Gs          , Ggf         , Gs          , Gs^Ft       , Hh          , Gs^Ft       , Ds          , Md          , Md          , Md          , Hh          , Hh          , Ds          , Dd          , Dd          , Ce          , Gs^Ft       , Gs^Vht      , Wwf         , Ww          , Wwf         , Ww          , Gs^Ft       , Gs          , Ds          , Dd          , Dd          , Hd          , Md          , Hd          , Hd          , Hd          , Md^Xm       , Hd          , Hd          , Dd          , Ds          , Rd          , Rd          , Rd          , Rd          , Dd          , Rd          , Rd          , Rd          , Dd          , Ds          , Rd          , Hd          , Rd          , Ds          , Rd          , Dd          , Rd          , Rd          , Ds          , Rd          , Dd          , Rd          
Hh          , Gs^Ft       , Gs          , Gg          , Hh          , Hh          , Hh          , Hh          , Gs          , Ds          , Md          , Md^Xm       , Md^Xm       , Md          , Md          , Hd          , Hd          , Dd          , Hd          , Ce          , Gs          , Ww          , Gs^Ft       , Wwf         , Gs          , Gs^Vht      , Ce          , Ds          , Dd          , Hd          , Hd          , Md^Xm       , Hd          , Hd          , Dd^Dc       , Md          , Hd          , Dd          , Rd          , Rd          , Rd          , Rd          , Rd          , Dd          , Dd          , Rd          , Dd          , Ds          , Dd          , Rd          , Rd          , Rd          , Dd          , Ds          , Rd          , Rd          , Rd          , Rd          , Ds          , Rd          , Dd          , Dd          
Hh          , Gg          , Gg          , Gs          , Ggf         , Gs          , Gs          , Hh          , Gs          , Dd          , Hd          , Md          , Md          , Md^Xm       , Md^Xm       , Md          , Hd          , Dd          , Dd          , Dd          , Dd          , Ce          , Ce          , Gs          , Ds          , Ce          , Rd          , Dd          , Hd          , Rd          , Rd          , Dd          , Dd          , Hd          , Dd          , Hd          , Dd          , Dd          , Rd          , Dd          , Dd          , Dd          , Rd          , Dd          , Dd          , Rd          , Rd          , Dd          , Dd          , Rd          , Ds          , Dd          , Ds          , Rd          , Rd          , Rd          , Ds          , Ds          , Dd          , Rd          , Dd          , Dd          
Gs^Ft       , Hh          , Hh          , Gs          , Gs          , Gs          , Gg          , Gs          , Dd          , Dd          , Dd          , Hd          , Md          , Md^Xm       , Md^Xm       , Md          , Md          , Hd          , Dd          , Ds          , Dd          , Rd          , Rd          , Ds          , Dd          , Dd          , Rd          , Dd          , Hd          , Dd          , Hd          , Dd          , Rd          , Rd          , Dd          , Dd          , Dd          , Dd          , Rd          , Dd          , Dd          , Rd          , Rd          , Rd          , Dd          , Dd          , Dd          , Dd          , Dd^Vdt      , Dd          , Rd          , Ds          , Hd          , Rd          , Hd          , Dd          , Dd          , Dd          , Dd          , Dd          , Dd          , Dd          
Gs^Ft       , Hh          , Gs^Ft       , Gs          , Hh          , Hh          , Gg          , Gs          , Gs          , Dd          , Dd          , Hd          , Md          , Md^Xm       , Md^Xm       , Md^Xm       , Md          , Hd          , Rd          , Ds          , Rd          , Dd          , Dd          , Dd          , Hd          , Rd          , Rd          , Dd^Dc       , Dd          , Hd          , Dd          , Dd          , Rd          , Rd          , Rd          , Dd          , Hd          , Rd          , Rd          , Dd          , Rd          , Dd          , Dd          , Dd^Vdt      , Dd          , Dd          , Rd          , Dd          , Dd          , Rd          , Rd          , Ds          , Ds          , Hd          , Hd          , Hd          , Hd          , Dd          , Rd          , Ds          , Ds          , Dd          
Hh          , Gg          , Gs^Ft       , Gs^Ft       , Gs          , Hh          , Hh          , Hh          , Gs^Ft       , Gs          , Dd          , Dd          , Dd          , Md          , Md^Xm       , Md^Xm       , Md          , Md          , Hd          , Rd          , Rd          , Hd          , Rd          , Rd          , Rd          , Hd          , Hd          , Dd          , Rd          , Hd          , Rd          , Dd          , Dd          , Rd          , Rd          , Dd          , Hd          , Rd          , Rd          , Rd          , Ds          , Dd          , Dd          , Dd          , Ce          , Ce          , 3 Ke        , Ce          , Ce          , Dd^Vdt      , Dd          , Ds          , Hd          , Rd          , Rd          , Dd          , Hd          , Rd          , Rd          , Ds          , Dd          , Ds          
Hh          , Ggf         , Hh          , Hh          , Gs          , Gs^Ft       , Hh          , Hh          , Gs          , Dd          , Hd          , Dd^Dc       , Dd          , Md          , Md          , Md^Xm       , Md^Xm       , Md          , Md          , Rd          , Hd          , Dd          , Rd          , Rd          , Hd          , Dd          , Hd          , Rd          , Rd          , Rd          , Hd          , Dd          , Dd          , Dd          , Dd          , Dd          , Rd          , Rd          , Rd          , Ds          , Ds          , Rd          , Dd          , Dd          , Dd          , Ce          , Rd          , Ce          , Rd          , Dd          , Dd          , Rd          , Rd          , Hd          , Dd          , Dd          , Ds          , Dd          , Dd          , Ds          , Ds          , Dd          
Hh          , Hh          , Ggf         , Gs          , Hh          , Hh          , Hh          , Hh          , Dd          , Dd          , Hd          , Hd          , Dd          , Md          , Hd          , Md          , Md^Xm       , Md^Xm       , Md          , Md          , Hd          , Dd          , Ds          , Dd          , Dd          , Hd          , Rd          , Ds          , Dd          , Dd          , Dd          , Dd          , Hd          , Dd          , Rd          , Hd          , Md          , Dd          , Dd^Dc       , Dd          , Ds          , Rd          , Rd          , Rd          , Ds          , Dd          , Dd          , Rd          , Dd          , Dd^Vdt      , Dd          , Rd          , Dd          , Rd          , Rd          , Rd          , Ds          , Hd          , Rd          , Dd          , Dd          , Dd          
Hh          , Hh          , Ggf         , Gg          , Gs          , Hh          , Hh          , Hh          , Dd          , Dd          , Ds          , Ds          , Hd          , Dd          , Md          , Md          , Md^Xm       , Md^Xm       , Md          , Md          , Hd          , Hd          , Hd          , Rd          , Dd^Vdt      , Hd          , Rd          , Rd          , Dd          , Dd          , Dd          , Dd          , Dd          , Rd          , Hd          , Md^Xm       , Md          , Hd          , Dd          , Dd          , Rd          , Rd          , Rd          , Ds          , Dd          , Dd          , Hd          , Hd          , Hd          , Hd          , Rd          , Dd          , Dd          , Hd          , Rd          , Ds          , Ds          , Ds          , Rd          , Dd          , Rd          , Ds          
Gs          , Gg          , Gg          , Ggf         , Gg          , Hh          , Gs^Ft       , Hh          , Gs^Ft       , Dd          , Ds          , Ds          , Hd          , Md          , Dd^Dc       , Md          , Md^Xm       , Md          , Md          , Md          , Hd          , Rd          , Rd          , Rd          , Ds          , Hd          , Ds          , Dd          , Dd          , Dd          , Rd          , Rd          , Dd          , Dd          , Dd          , Dd          , Md          , Dd          , Rd          , Rd          , Rd          , Rd          , Ds          , Ds          , Dd          , Dd          , Rd          , Rd          , Hd          , Rd          , Rd          , Dd          , Hd          , Md          , Hd          , Ds          , Hd          , Ds          , Dd          , Rd          , Rd          , Rd          
Gs^Ft       , Gs          , Hh          , Hh          , Hh          , Gs          , Hh          , Hh          , Hh          , Gs          , Dd          , Dd          , Hd          , Md          , Dd          , Md          , Md          , Md^Xm       , Md          , Md          , Hd          , Rd          , Dd^Vdt      , Dd          , Ce          , Ce          , Ds          , Hd          , Hd          , Dd          , Dd          , Hd          , Dd          , Dd          , Md^Xm       , Md          , Hd          , Dd          , Rd          , Dd          , Rd          , Dd          , Dd          , Dd          , Dd          , Rd          , Rd          , Rd          , Rd          , Rd          , Md          , Md          , Md          , Md          , Md^Xm       , Rd          , Hd          , Dd          , Dd          , Rd          , Dd^Dc       , Rd          
Gs^Ft       , Gs^Ft       , Hh          , Hh          , Gs          , Hh          , Hh          , Hh          , Hh          , Gs^Ft       , Gs^Ft       , Dd          , Dd          , Dd          , Dd          , Md          , Md^Xm       , Md^Xm       , Md          , Hd          , Hd          , Dd          , Ds          , Dd          , Ds          , 4 Ke        , Ce          , Dd          , Rd          , Rd          , Ds          , Dd          , Hd          , Hd          , Md          , Dd          , Rd          , Rd          , Rd          , Dd          , Rd          , Dd          , Dd          , Dd          , Rd          , Dd          , Dd          , Rd          , Dd^Dc       , Hd          , Hd          , Hd          , Hd          , Md          , Md          , Md^Xm       , Md          , Hd          , Hd          , Dd          , Dd          , Dd          
Gs^Ft       , Gs^Ft       , Gs          , Gg          , Gs          , Ggf         , Hh          , Hh          , Gs^Ft       , Gs^Ft       , Gs^Ft       , Gs          , Dd          , Hd          , Md          , Md          , Md^Xm       , Md^Xm       , Md          , Hd          , Ds          , Ds          , Dd^Vdt      , Ds          , Dd          , Ce          , Ds          , Ds          , Rd          , Ds          , Rd          , Hd          , Md          , Md          , Hd          , Hd          , Hd          , Hd          , Rd          , Rd          , Dd          , Hd          , Hd          , Rd          , Rd          , Hd          , Dd          , Dd          , Ds          , Hd          , Ds          , Ds          , Dd          , Hd          , Dd          , Md          , Md^Xm       , Md          , Hd          , Dd          , Dd          , Dd          
Hh          , Gs          , Hh          , Gs          , Gs^Ft       , Ggf         , Hh          , Hh          , Hh          , Gs          , Dd          , Dd          , Ds          , Hd          , Md          , Md          , Md^Xm       , Md^Xm       , Md          , Hd          , Hd          , Dd          , Hd          , Dd          , Dd          , Rd          , Rd          , Dd          , Rd          , Rd          , Dd          , Hd          , Md          , Rd          , Hd          , Rd          , Ds          , Rd          , Hd          , Dd          , Rd          , Dd          , Dd          , Rd          , Rd          , Ds          , Rd          , Hd          , Ds          , Ds          , Rd          , Rd          , Ds          , Dd          , Hd          , Md          , Md^Xm       , Md          , Hd          , Dd          , Dd          , Dd          
Hh          , Hh          , Gs^Ft       , Gs          , Hh          , Hh          , Gs          , Ggf         , Gs          , Gs          , Dd          , Hd          , Ds          , Dd          , Md          , Md          , Md          , Md^Xm       , Md          , Md          , Md          , Hd          , Rd          , Rd          , Rd          , Dd^Vdt      , Rd          , Dd          , Hd          , Rd          , Md          , Md          , Rd          , Rd          , Dd          , Hd          , Ds          , Dd          , Rd          , Rd          , Ds          , Dd          , Hd          , Hd          , Rd          , Ds          , Hd          , Rd          , Ds          , Dd          , Rd          , Dd          , Ds          , Hd          , Hd          , Md^Xm       , Md^Xm       , Md          , Dd          , Dd          , Hd          , Md          
Hh          , Hh          , Gs^Ft       , Hh          , Hh          , Hh          , Gg          , Hh          , Gs^Ft       , Gs          , Dd          , Ds          , Hd          , Hd          , Md          , Md          , Md^Xm       , Md^Xm       , Md          , Md          , Dd^Dc       , Md          , Rd          , Rd          , Hd          , Dd          , Rd          , Rd          , Dd          , Md          , Dd          , Hd          , Dd          , Hd          , Dd^Dc       , Dd          , Rd          , Ds          , Dd          , Rd          , Ds          , Ds          , Rd          , Rd          , Hd          , Ds          , Dd          , Ds          , Dd          , Dd          , Hd          , Hd          , Ds          , Md          , Md^Xm       , Md          , Md          , Hd          , Dd          , Dd          , Md          , Md          
Hh          , Hh          , Hh          , Gs          , Gs          , Gg          , Gs^Ft       , Hh          , Hh          , Gs          , Dd          , Dd          , Hd          , Md          , Md          , Md          , Md          , Md^Xm       , Md^Xm       , Md          , Md          , Md          , Hd          , Hd          , Md          , Hd          , Rd          , Rd          , Rd          , Md          , Hd          , Hd          , Rd          , Dd          , Hd          , Dd          , Rd          , Dd          , Dd          , Dd          , Hd          , Rd          , Rd          , Rd          , Hd          , Ds          , Ds          , Dd          , Dd          , Hd          , Ds          , Ds          , Hd          , Md          , Md          , Hd          , Dd          , Md^Xm       , Md^Xm       , Hd          , Dd          , Md          
Gs          , Hh          , Gs^Ft       , Gs          , Gs^Ft       , Gs          , Gs          , Gs^Ft       , Hh          , Hh          , Dd          , Hd          , Dd          , Md          , Md          , Md^Xm       , Md          , Md^Xm       , Md^Xm       , Md          , Md          , Hd          , Md          , Md          , Hd          , Md          , Hd          , Rd          , Rd          , Hd          , Dd^Vdt      , Dd          , Rd          , Rd          , Dd          , Rd          , Rd          , Dd          , Dd          , Dd          , Dd          , Hd          , Rd          , Rd          , Rd          , Hd          , Hd          , Hd          , Dd          , Hd          , Hd          , Md          , Md          , Md          , Hd          , Hd          , Ds          , Ds          , Dd          , Hd          , Ds          , Dd          
Gs          , Gs^Ft       , Gs^Ft       , Hh          , Hh          , Hh          , Ggf         , Gs^Ft       , Hh          , Hh          , Hd          , Dd          , Md          , Md          , Md^Xm       , Md^Xm       , Md          , Md          , Md          , Md^Xm       , Md^Xm       , Md          , Md          , Hd          , Hd          , Hd          , Hd          , Rd          , Rd          , Rd          , Dd          , Dd          , Dd          , Hd          , Dd          , Hd          , Hd          , Hd          , Dd          , Dd          , Dd          , Dd          , Dd          , Hd          , Hd          , Dd          , Hd          , Dd          , Hd          , Hd          , Dd          , Md          , Md          , Hd          , Hd          , Dd          , Hd          , Dd          , Ds          , Ds          , Ds          , Ds          
Hh          , Hh          , Hh          , Hh          , Hh          , Gs          , Gs          , Gg          , Hh          , Hh          , Hh          , Md          , Md          , Md          , Md          , Md          , Md          , Md          , Md          , Md          , Md          , Md          , Md          , Md          , Md          , Md          , Hd          , Hd          , Rd          , Rd          , Hd          , Hd          , Hd          , Md          , Md          , Md          , Md          , Md          , Hd          , Hd          , Hd          , Hd          , Hd          , Hd          , Hd          , Md          , Md          , Md          , Md          , Md          , Md          , Md          , Md          , Md          , Md          , Md          , Md          , Dd          , Dd          , Ds          , Ds          , Ds          
