border_size=1
usage=map

Md^Xm, Md, Hd, Re, Rd, Rd, Ds, Dd, Hd, Hd, Md, Md^Xm, Md^Xm, Md^Xm, Xu, Xu, Xu, Xu, Uu^Uf, Uu, Uu, Uu, Uu^Uf, Xu, Xu, Xu, Xu, Uu^Uf, Uu^Uf, Uu^Uf
Md^Xm, Md, Hd, Dd, Dd, Rd, Rd, Dd, Dd, Hd, Hd, Md^Xm, Md, Md^Xm, Md^Xm, Xu, Xu, Xu, Uh, Uu^Uf, Uu^Vud, Uu, Uu^Uf, Uu^Uf, Uu^Uf, Uu^Vud, Uu, Uu^Uf, Uu, Uu
Xu, Md^Xm, Md, Hd, Hd, Re, Re, Rd, Dd, Re, Rd, Dd, Dd, Hd, Md^Xm, Md^Xm, Xu, Xu, Uh, Uu^Uf, Uu^Uf, Uu, Cud, Cud, Cud, Uu, Uu, Rd, Uu^Vu, Uu
Xu, Md^Xm, Md^Xm, Md, Hd, Re, Ds, Rd, Dd, Dd, Re, Rd, Dd, Dd, Md^Xm, Md^Xm, Xu, Xu, Xu, Uh, Uu^Vu, Rd, Cud, 3 Kud, Cud, Rd, Uu^Uf, Qxu, Qxu, Xu
Xu, Xu, Md^Xm, Md, Hd, Ds, Hd, Dd, Ds, Dd, Hd, Rd, Rd, Hd, Dd, Md^Xm, Md^Xm, Xu, Uu, Uh, Rd, Uu, Uu, Cud, Uu, Rd, Uu, Uh, Qxu, Xu
Xu, Xu, Xu, Md^Xm, Md, Md, Md^Xm, Dd, Re, Hd, Dd^Dr, Re, Rd, Hd, Md^Xm, Md^Xm, Md, Md, Md, Rd, Uu^Uf, Uu, Rd, Uu, Uu, Uu^Vu, Uh, Qxu^Bs\, Uu, Qxu
Wo, Xu, Xu, Md^Xm, Md^Xm, Dd^Vda, Md, Rd, Re, Dd^Es, Hd, Dd, Ds, Hd, Hd, Md, Dd^Vda, Hd, Md, Uu, Uu^Uf, Uu^Uf, Rd, Uu, Uu^Uf, Uh, Uh, Qxu, Uh, Qxu
Xu, Wo, Wo, Xu, Md^Xm, Md^Xm, Re, Hd, Re, Re, Rr, Re, Rd, Dd^Dr, Hd, Hd, Hd, Md^Xm, Md, Xu, Xu, Xu, Uu, Rd, Uh, Xu, Xu, Qxu, Qxu^Bs|, Qxu^Bs\
Xu, Xu, Xu, Wo, Ww, Md^Xm, Gd, Hd, Dd^Dr, Re, Rd, Rr, Ds, Rd, Re, Rd, Rd, Hd, Md, Md^Xm, Md^Xm, Xu, Md, Md, Md^Xm, Xu, Xu, Xu, Uu, Qxu
Xu, Xu, Xu, Xu, Xu, Wwf, Ww, Gd, Re, Ds, Rd, Re, Ds, Rd, Rd, Rd, Dd, Rd, Hd, Hd, Hd, Md, Hd, Md, Md^Xm, Xu, Xu, Xu, Uu, Xu
Xu, Xu, Xu, Xu, Xu, Md^Xm, Ww, Gd, Dd, Dd, Re, Dd, Dd^Dr, Ds, Rd, Dd, Gd, Gd, Dd, Re, Ds, Ds, Dd, Hd, Hd, Md^Xm, Md^Xm, Xu, Uu, Xu
Xu, Uh, Xu, Xu, Xu, Md^Xm, Md^Xm, Wwf, Wwf, Dd, Re, Dd, Rd, Rr, Dd^Es, Re, Rd, Gd, Ds, Re, Dd, Ds^Es, Dd^Es, Dd, Md, Md^Xm, Md^Xm, Xu, Xu, Uu
Xu, Uh, Uh, Xu, Xu, Xu, Xu, Dd, Ww, Gd, Gd, Ds, Ds, Dd, Dd^Es, Ds^Es, Ds, Gd, Gd, Re, Re, Dd^Es, Dd^Dr, Hd, Md, Md^Xm, Xu, Xu, Xu, Uu
Xu, Uu^Vu, Uh, Yhs^Xp, Uu^Uf, Qxu, Uu^Vud, Xu, Uu, Wwf, Gd, Gd, Dd, Re, Dd, Dd, Ds, Rr, Gd, Ds, Ds, Rd, Rd, Hhd, Hhd, Md^Xm, Xu, Xu, Xu, Xu
Xu, Ur, Ur, Uu, Ur, Qxu, Uu, Uu, Cud, Wwf, Wwf, Hd, Md, Dd, Dd, Md, Hd, Dd, Dd^Es, Re, Gd, Gd, Gd, Hhd, Hhd, Md, Wo, Wo, Wo, Wo
Xu, Xu, Xu, Uu^Vu, Uu, Qxu, Uu, Cud, 2 Kud, Cud, Md, Ww, Gs, Hd, Md, Md^Xm, Md, Re, Gd, Ds, Gd, Gs, Gs, Gs, Wwf, Wwf, Md, Xu, Xu, Xu
Xu, Xu, Urb^Z\, Uu^Uf, Ur, Qxu^Bs/, Uu^Vu, Cud, Cud, Cud, Md, Wwf, Ww, Gs, Md^Xm, Md^Xm, Md^Xm, Hhd, Hhd, Gd, Gs, Rd, Rd, Ww, Gs, Hhd, Hhd, Md^Xm, Md^Xm, Xu
Xu, Wwf, Wwf, Urb^Z\, Xu, Uu^Uf, Uu^Uf, Uu, Uu^Uf, Uu^Vu, Xu, Xu, Xu, Xu, Xu, Xu, Xu, Md, Wwf, Gs, Ww, Gd, Ww, Wwf, Gs, Rd, Re, Md, Md^Xm, Md^Xm
Xu, Uh, Ur, Uu^Uf, Xu, Uu^Uf, Uu^Uf, Uh, Xu, Uh, Xu, Xu, Xu, Xu, Gs, Ww, Wwf, Ww, Gs, Wwf, Gs, Ww, Gs, Hhd, Re, Rd, Rd, Gd, Md, Md^Xm
Xu, Uu^Ii, Uu^Ii, Uh^Ii, Xu, Uh, Xu, Qxu, Qxu, Xu, Md^Xm, Md^Xm, Md^Xm, Md, Hhd, Gs, Ww, Gs, Hhd, Hhd, Hhd, Gs, Gd, Hhd, Re, Rd, Re, Hhd, Hhd, Md^Xm
Xu, Uu^Ufi, Uu^Ufi, Uu^Ufi, Xu, Xu, Xu, Xu, Md^Xm, Md^Xm, Md^Xm, Md^Xm, Hhd, Hhd, Gd, Gs, Gs, Ww, Wwf, Gd^Vda, Gd^Dr, Hhd, Re, Rr, Gd, Gd, Hhd, Hhd, Md, Md^Xm
Xu, Xu, Xu, Xu, Wo, Xu, Md^Xm, Md, Hd, Hd, Hd, Hhd, Hhd, Gd, Rd, Gd, Gs, Ww, Wwf, Gs, Gd, Gd, Re, Rr, Re, Hhd, Md, Md, Md^Xm, Md^Xm
Wo, Xu, Wo, Wo, Ww, Md^Xm, Hd, Hd, Ds, Dd, Rd, Gd, Rr, Re, Gd, Rd, Re, Gs, Ww, Gs, Gd, Gd, Rd, Re, Md, Rd, Rd, Md, Xu, Xu
Ww, Wo, Wo, Ww, Gs, Hd, Dd, Re, Rd, Dd^Vda, Ds^Es, Re, Re, Gd, Hhd, Re, Hhd, Gs, Wwf, Hhd, Hhd, Rd, Hhd, Re, Md^Xm, Hhd, Uh, Uu, Xu, Xu
Hhd, Ww, Ww, Ww, Gd, Gd, Gd, Ds, Rd, Re, Dd, Dd, Hhd, Hhd, Md^Xm, Md, Md, Gs, Ww, Wwf, Ww, Hhd, Md, Md^Xm, Md^Xm, Xu, Yhs^Xp, Re, Uh, Xu
Md, Hhd, Gd, Gs, Gd, Re, Gd, Gd, Dd, Dd^Es, Re, Re, Md, Hhd, Md^Xm, Md^Xm, Xu, Uu, Re, Uh, Xu, Wo, Xu, Md^Xm, Xu, Xu, Re, Uu^Vu, Re, Xu
Mm^Xm, Hhd, Md, Hhd, Re, Ds, Ds, Gd, Rd, Rd, Ds, Hd, Md^Xm, Md^Xm, Md^Xm, Md^Xm, Xu, Uu^Uf, Uu^Vu, Uu, Uu, Xu, Yhs^Xp, Xu, Uu^Vu, Re, Rd, Uu, Uu, Rd
Xu, Md, Md, Hd, Hd, Rd, Ds, Rd, Ds, Re, Hd, Hd, Md, Md^Xm, Md^Xm, Md^Xm, Xu, Uu^Uf, Uu^Uf, Re, Yhs^Xp, Uu, Re, Uu^Uf, Re, Re, Xu, Yhs^Xp, Md^Xm, Uu^Uf
Xu, Xu, Md^Xm, Md, Hd, Dd^Vda, Dd, Ds, Dd^Dr, Rd, Hd, Dd^Vda, Md, Md^Xm, Md, Md^Xm, Md^Xm, Xu, Md^Xm, Xu, Xu, Xu, Re, Uu, Uu^Vu, Yhs^Xp, Xu, Md^Xm, Wo, Wo
Xu, Xu, Xu, Md, Md^Xm, Hd, Hd, Re, Re, Rd, Rd, Ds, Re, Md, Hd, Md^Xm, Hd, Md^Xm, Md^Xm, Md^Xm, Md^Xm, Xu, Uu^Uf, Uu, Xu, Xu, Md^Xm, Md^Xm, Wo, Md^Xm
Yhs, Xu, Xu, Xu, Md, Hd, Hd, Re, Rd, Rd, Re, Dd, Ds, Hd, Rd^Es, Dd^Dr, Dd^Es, Hd, Hd, Md, Hd, Md^Xm, Ds, Uu, Md^Xm, Md^Xm, Wo, Wo, Md^Xm, Md^Xm
Xu, Yhs^Xp, Yhs, Urb, Urb, Md, Hd, Rd, Rd, Re, Ds, Re, Ds, Rd, Ds, Rd^Es, Re, Ds, Ds, Re, Md, Hd, Hd, Ds, Gs, Ww, Wwf, Md^Xm, Md, Md^Xm
Yhs, Yhs, Yhs, Yhs, Xu, Md^Xm, Md, Hd, Hd, Ds, Rd, Re, Dd, Ds, Re, Rd, Rd, Re, Rd, Dd, Dd, Hd, Hd, Gs, Dd^Vdt, Ww, Gs^Ecf, Gs, Dd^Dr, Md
Yhs, Yhs, Xu, Xu, Yhs^Xp, Xu, Xu, Md^Xm, Md^Xm, Hd, Hd, Hd, Hd, Dd, Hd, Dd, Re, Dd, Rd, Dd^Es, Re, Ds, Dd, Gs, Wwf, Wwf, Gs, Hd, Hd, Hd
Xu, Yhs, Yhs, Uzw, Xu, Xu, Yhs^Xp, Xu, Xu, Md^Xm, Md^Xm, Hd, Md^Xm, Hd, Md^Xm, Hd, Hd, Hd, Rd, Re, Dd, Rd, Ds, Ww, Ce, Ce, Ce, Gs, Ds, Hd
Xu, Yhs^Xp, Yhs, Yhs, Yhs, Uzw, Xu, Xu, Xu, Xu, Xu, Md^Xm, Md^Xm, Md^Xm, Md^Xm, Md^Xm, Md^Xm, Md, Ds, Hd, Gs, Rd, Dd^Vdt, Wwf, Ce, 1 Ke, Ce, Ds, Dd^Vdt, Hd
Yhs, Yhs, Xu, Xu, Yhs, Yhs, Yhs, Xu, Xu, Xu, Yhs^Xp, Xu, Xu, Md^Xm, Md^Xm, Md^Xm, Md^Xm, Md, Hd, Gs, Wo, Wwf, Ww, Wwf, Gs, Ce, Dd, Dd, Hd, Ds
Xu, Xu, Xu, Xu, Yhs, Xu, Xu, Yhs, Yhs, Uzw, Xu, Xu, Xu, Xu, Xu, Xu, Xu, Md^Xm, Wo, Wo, Wo, Wwf, Gs, Gs^Ecf, Dd, Dd, Re, Dd^Dr, Hd, Ds
