Gd, Gd, Gd, Hh, Hh, Hhd^Fdw, Hh^Fdw, Mm, Mm, Mm, Mm^Xm, Md^Xm, Xue, Xue, Xue, Xue, Xue, Xue, Xue, Xue, Xue, Xue, Xue, Xue, Xue, Xue, Xue, Xue, Xue, Xue, Xue, Xue, Xue, Xue, Xue, Xue, Xue, Xue, Xue, Xue, Xue, Xue, Xue, Xue, Xue, Xue, Xue, Xue, Xue, Xue, Xue, Xue, Xue, Xue
Gs, Re, Gd^Es, Re, Gd, Hh^Fdw, Hh, Hh, Hh, Mm, Mm, Mm^Xm, Xue, Xue, Xue, Xue, Xue, Xue, Xue, Xue, Xue, Xue, Xue, Xue, Xue, Xue, Xue, Xue, Xue, Xue, Xue, Xue, Xue, Xue, Xue, Xue, Xue, Xue, Xue, Xue, Xue, Xue, Xue, Xue, Xue, Xue, Xue, Xue, Xue, Xue, Xue, Xue, Xue, Xue
Gs, Gs, Gs, Gd, Re, Gs, Gd, Gs, Hh, Mm, Hh, Mm, Xue, Xue, Xue, Xue, Xue, Xue, Xue, Xue, Uue, Xue, Xue, Xue, Xue, Xue, Xue, Xue, Xue, Xue, Xue, Xue, Xue, Xue, Xue, Xue, Xue, Xue, Xue, Xue, Xue, Xue, Xue, Xue, Xue, Xue, Xue, Xue, Xue, Xue, Xue, Xue, Xue, Xue
Gd, Gs, Gs, Gd, Gd, Re, Re, Gs^Fts, Gs^Fds, Hh^Fdw, Hh, Hh, Hh, Xue, Xue, Xue, Xue, Xue, Uhe, Uhe, Uue, Xue, Uue, Uue, Uue, Xue, Xue, Xue, Uue, Xue, Xue, Xue, Xue, Xue, Xue, Xue, Xue, Xue, Xue, Xue, Xue, Xue, Uhe, Uhe, Uhe, Xue, Xue, Xue, Xue, Xue, Xue, Xue, Xue, Xue
Re, Gs, Gd, Gs, Gs, Gs, Gd, Gd, Gd^Fts, Gd^Fts, Gd, Hh, Hh, Xue, Xue, Xue, Uue, Uue, Uhe, Uue, Re^Es, Re, Uue^Uf, Uhe, Uue, Xue, Xue, Xue, Xue, Uue, Uue, Xue, Xue, Xue, Xue, Xue, Xue, Xue, Uhe, Xue, Uue, Xue, Uue, Uue, Uhe, Xue, Xue, Xue, Xue, Xue, Xue, Xue, Xue, Xue
Gs^Fts, Gs, Gs, Gd^Es, Gs, Gs, Rd, Gd, Gs, Gd, Gs, Hh, Hh, Hh, Xue, Xue, Uue, Uue, Re, Uue, Re, Re^Em, Re^Uf, Uue^Uf, Uue, Xue, Xue, Xue, Xue, Uhe, Uue, Xue, Uue^Vud, Xue, Uhe, Xue, Xue, Uhe, Uue, Uhe, Xue, Uue, Uue, Uue, Uue, Uue, Xue, Xue, Xue, Xue, Xue, Xue, Xue, Xue
Gs^Fds, Gs, Gs^Fds, Rd, Re, Gs, Gs, Re, Gd^Es, Gs, Gs^Es, Gs, Gd, Hh, Xue, Xue, Uue, Re, Re, Uue, Uue^Vu, Uue, Uue, Re, Uue, Xue, Xue, Xue, Uue, Uue, Uue, Uue, Uue, Uhe, Uue, Uue, Uue, Uue, Uue, Xue, Xue, Xue, Xue, Xue, Uue, Uue, Xue, Xue, Xue, Xue, Xue, Xue, Xue, Xue
Hh, Gs^Fts, Gs^Fts, Gd, Gd, Re, Gs, Gs, Gd, Gd, Gd, Gs, Gd, Gd, Gd, Cud, Xue, Re, Uue, Re, Uue, Re, Re, Re, Re, Uue, Uue, Cud, Re, Uue, Cud, Cud, Cud, Uue, Re, Uue^Uf, Re, Xue, Uue, Uhe, Xue, Xue, Xue, Xue, Xue, Xue, Xue, Xue, Xue, Xue, Xue, Xue, Xue, Xue
Hh, Gs^Fds, Gs^Fds, Gs^Fds, Gd, Re, Gs, Gs, Gs, Gs^Fts, Gd, Gd, Gd, Gd, Xue, Xue, Xue, Uue, Uhe, Uue, Uue, Uue, Uue, Uue, Uue, Uue, Xue, Xue, Uue, Re, Cud, 4 Kud, Cud, Re, Uue, Re, Re, Re, Xue, Uue, Xue, Xue, Uue, Xue, Xue, Xue, Xue, Xue, Xue, Xue, Xue, Xue, Xue, Xue
Mm, Hh, Hh, Hh^Fds, Hh^Fds, Gs^Fts, Gs^Fds, Gd, Hh, Gd, Gs^Fds, Gd, Hh, Hh, Xue, Xue, Xue, Xue, Uue, Re, Xue, Xue, Xue, Uhe, Uhe, Uhe, Xue, Xue, Uhe, Uue, Uue, Cud, Uue, Uue, Xue, Uue, Uue, Re, Uue, Xue, Xue, Uue, Uue, Xue, Uhe, Xue, Xue, Xue, Xue, Xue, Xue, Xue, Xue, Xue
Mm, Hh, Hh^Fdw, Hh, Hh, Gs^Fds, Hh, Gs^Fts, Hh, Hh, Gs^Fds, Gs^Fds, Hh, Hh, Xue, Xue, Xue, Xue, Uue, Re, Uue, Xue, Xue, Xue, Xue, Xue, Xue, Xue, Uhe, Uue^Vud, Uhe, Uue, Uhe, Uue, Xue, Xue, Uue, Re, Re, Uue, Uue^Uf, Uue, Xue, Uhe, Xue, Xue, Xue, Xue, Xue, Xue, Xue, Xue, Xue, Xue
Mm, Mm, Mm, Mm, Mm, Hh^Fdw, Hh, Hh, Mm, Hh, Hh, Hh, Hh, Xue, Xue, Xue, Xue, Xue, Xue, Uue, Re^Em, Uue^Uf, Xue, Xue, Xue, Xue, Xue, Xue, Xue, Uue, Uue, Uue, Uhe, Uhe, Xue, Xue, Uue, Uue^Uf, Uue^Uf, Uue, Re, Uue, Xue, Uhe, Xue, Xue, Xue, Xue, Xue, Xue, Xue, Xue, Xue, Xue
Mm^Xm, Mm^Xm, Mm^Xm, Mm, Mm, Mm, Mm, Mm, Hh, Hh, Mm, Mm, Xue, Xue, Xue, Xue, Xue, Xue, Xue, Xue, Uue, Re^Em, Uue, Xue, Xue, Xue, Xue, Xue, Xue, Uue, Xue, Xue, Xue, Xue, Xue, Xue, Xue, Uue^Uf, Uhe, Uue, Re, Uhe, Uue, Xue, Xue, Xue, Xue, Xue, Xue, Xue, Xue, Xue, Xue, Xue
Mm^Xm, Mm^Xm, Mm, Mm, Mm, Mm, Mm^Xm, Mm, Mm, Mm, Mm, Mm^Xm, Mdd^Xm, Xue, Qxe^Xo, Qxe^Xo, Qxe^Xo, Qxe^Xo, Qxe^Xo, Qxe^Xo, Qxe^Xo, Uhe, Qxe^Xo, Xue, Qxe^Xo, Xue, Xue, Xue, Xue, Xue, Xue, Xue, Xue, Xue, Uue, Xue, Uhe, Xue, Uue, Uue, Re, Re, Xue, Xue, Xue, Xue, Xue, Xue, Xue, Xue, Xue, Xue, Xue, Xue
Mm^Xm, Mm^Xm, Mm^Xm, Mm^Xm, Mm^Xm, Mm^Xm, Mdd^Xm, Mm^Xm, Mm^Xm, Mm, Mm^Xm, Mm^Xm, Mdd^Xm, Mdd^Xm, Qxe^Xo, Qxe^Xo, Qxe^Xo, Qxe^Xo, Qxe^Xo, Qxe^Xo, Qxe^Xo, Qxe^Xo, Qxe^Xo, Qxe^Xo, Qxe^Xo, Qxe^Xo, Dd, Xue, Dd, Xue, Re, Uue, Re, Uue, Re, Re, Re, Re, Uue, Re, Uue, Uue, Uhe, Xue, Uhe, Xue, Cud, Xue, Xue, Xue, Xue, Xue, Xue, Xue
Mdd^Xm, Mdd^Xm, Mdd^Xm, Mdd^Xm, Mdd^Xm, Mdd^Xm, 3 Mdd^Xm, Mdd^Xm, Mdd^Xm, Mdd^Xm, Mdd^Xm, Mdd^Xm, Mdd^Xm, Mdd^Xm, Qxe^Xo, Qxe^Xo, Dd, Qxe^Xo, Dd, Qxe^Xo, Qxe^Xo, Qxe^Xo, Qxe^Xo, Qxe^Xo, Ds, Ds, Dd, Dd, Dd, Rd, Rd, Re, Uue, Uue, Uue, Uue, Xue, Uue, Uue, Uue^Vu, Uhe, Uue, Uhe, Uhe, Uue^Vu, Uhe, Xue, Xue, Xue, Xue, Xue, Xue, Xue, Xue
Mdd^Xm, Mdd^Xm, Mdd^Xm, Mdd^Xm, Mdd^Xm, Mdd^Xm, Mdd^Xm, Mdd^Xm, Mdd^Xm, Mdd^Xm, Mdd^Xm, Mdd^Xm, Mdd, Mdd^Xm, Hd, Hd, Ds, Ds^Edpp, Ds, Dd, Dd, Qxe^Xo, Cdr, Ds, Rd, Ds, Rd, Rd, Dd, Dd, Xue, Xue, Uhe, Uue^Uf, Uhe, Uhe, Xue, Uhe, Xue, Uue, Xue, Xue, Uhe, Uue, Re, Wwf, Uhe, Xue, Xue, Xue, Xue, Xue, Xue, Xue
Mdd^Xm, Mdd^Xm, Mdd^Xm, Mdd^Xm, Mdd, Mdd^Xm, Mdd, Mdd^Xm, Mdd^Xo, Mdd, Mdd, Mdd^Xm, Mdd, Mdd, Hd, Dd, Ds, Ds, Dd, Dd, Dd^Es, Ds, Cdr, Ds, Rd, Rd, Rd, Rd, Dd^Vdt, Qxe^Xo, Qxe^Xo, Xue, Xue, Uue, Cud, Xue, Xue, Xue, Xue, Xue, Xue, Xue, Xue, Wwf, Wwf, Wwf, Xue, Xue, Xue, Xue, Xue, Xue, Xue, Xue
Mdd^Xm, Mdd^Xm, Mdd^Xm, Mdd^Xm, Mdd, Mdd, Re, Re, Mdd^Xm, Hd, Cdr, Hd, Hd, Hd, Dd, Dd, Dd, Ds, Rd, Rd^Es, Rd, Rd, Ds, Kd, Ds, Ds, Ds, Dd, Dd, Qxe^Xo, Qxe^Xo, Qxe^Xo, Xue, Xue, Xue, Xue, Xue, Xue, Xue, Xue, Xue, Xue, Xue, Uhe, Uhe, Xue, Xue, Xue, Xue, Xue, Xue, Xue, Xue, Xue
Mdd^Xm, Mdd^Xm, Mdd^Xm, Mdd, Mdd, Re, Mdd, Mdd^Xm, Mdd^Xm, Hd, Dd, Rd, Dd, Hd, Ds, Dd, Dd, Rd, Dd, Rd, Dd, Ds, Qxe^Xo, Qxe^Xo, Qxe^Xo, Ds, Qxe^Xo, Cdr, Cdr, Qxe^Xo, Qxe^Xo, Qxe^Xo, Xue, Xue, Xue, Xue, Xue, Xue, Xue, Xue, Xue, Xue, Xue, Xue, Uhe, Uhe, Xue, Xue, Uhe, Xue, Xue, Xue, Xue, Xue
Xue, Xue, Xue, Xue, Mdd, Re, Mdd, Mdd^Xm, Mdd^Xm, Hd, Hd, Dd, Hd, Cdr, Rd, Ds, Rd, Dd, Dd^Dr, Dd^Es, Hd, Qxe^Xo, Qxe^Xo, Qxe^Xo, Qxe^Xo, Qxe^Xo, Dd, Dd, Dd^Es, Dd, Qxe^Xo, Qxe^Xo, Xue, Xue, Xue, Xue, Xue, Xue, Xue, Xue, Xue, Xue, Xue, Xue, Xue, Uhe, Uue, Uue, Uue, Uhe, Xue, Xue, Xue, Xue
Xue, Xue, Xue, Xue, Xue, Re, Xue, Xue, Xue, Mdd^Xm, Mdd^Xm, Hd, Mdd, Hd, Dd, Ds, Rd, Rd, Dd^Es, Dd, Hd, Qxe^Xo, Qxe^Xo, Qxe^Xo, Qxe^Xo, Qxe^Xo, Rd, Rd^Es, Dd, Qxe^Xo, Qxe^Xo, Qxe^Xo, Qxe^Xo, Xue, Xue, Xue, Qxe^Xo, Xue, Xue, Xue, Xue, Xue, Xue, Xue, Xue, Xue, Xue, Uue, Uue, Uhe, Xue, Xue, Xue, Xue
Xue, Xue, Xue, Xue, Xue, Re^Zz|, Xue, Xue, Xue, Mdd^Xm, Mdd^Xm, Mdd^Xm, Mdd, Hd, Hd, Dd, Dd, Rd, Rd, Dd, Dd, Qxe^Xo, Ds, Qxe^Xo, Rd, Ds, Rd, Rd, Qxe^Xo, Qxe^Xo, Qxe^Xo, Qxe^Xo, Qxe^Xo, Qxe^Xo, Qxe^Xo, Xue, Qxe^Xo, Xue, Xue, Xue, Xue, Xue, Xue, Xue, Xue, Xue, Xue, Uue, Xue, Xue, Xue, Xue, Xue, Xue
Xue, Xue, Xue, Xue, Uue, Re, Uue, Xue, Xue, Xue, Mdd^Xm, Mdd^Xm, Mdd^Xm, Mdd, Mdd, Hd, Ds, Dd, Rd, Rd, Ds, Cdr, Ds, Rd, Rd, Ds, Qxe^Xo, Qxe^Xo, Qxe^Xo, Qxe^Xo, Qxe^Xo, Qxe^Xo, Qxe^Xo, Qxe^Xo, Qxe^Xo, Qxe^Xo, Xue, Xue, Xue, Xue, Xue, Xue, Xue, Xue, Xue, Xue, Xue, Xue, Xue, Xue, Xue, Xue, Xue, Xue
Xue, Xue, Uue, Xue, Re^Es, Re, Yhs, Xue, Xue, Xue, Xue, Mdd^Xm, Mdd^Xm, Mdd^Xm, Mdd, Hd, Hd, Dd, Dd, Rd, Rd, Ds, Ds, Rd, Rd, Qxe^Xo, Qxe^Xo, Qxe^Xo, Qxe^Xo, Qxe^Xo, Qxe^Xo, Qxe^Xo, Qxe^Xo, Qxe^Xo, Qxe^Xo, Qxe^Xo, Xue, Xue, Xue, Xue, Xue, Xue, Xue, Xue, Qxe, Xue, Qxe, Xue, Xue, Xue, Xue, Xue, Xue, Xue
Xue, Xue, Yhs^Edt, Uue^Vud, Re^Edt, Re, Yhs, Yhs^Xp, Yhs^Dr, Xue, Xue, Xue, Mdd^Xm, Mdd^Xm, Mdd^Xm, Mdd, Mdd, Hd, Dd, Cdr, Ds, Rd, Dd, Ds, Rd, Qxe^Xo, Qxe^Xo, Qxe^Xo, Qxe^Xo, Qxe^Xo, Qxe^Xo, Qxe^Xo, Qxe^Xo, Qxe^Xo, Xue, Xue, Xue, Xue, Xue, Xue, Uue, Xue, Uue^Uf, Xue, Qxe, Qxe, Qxe, Qxe, Qxe, Xue, Xue, Xue, Xue, Xue
Xue, Xue, Xue, Yhs^Edt, Uue^Uf, Uue^Em, Re^Em, Yhs, Yhs^Xp, Uue, Xue, Xue, Xue, Mdd^Xm, Mdd^Xm, Mdd^Xm, Mdd^Xm, Mdd, Dd, Dd, Ds, Dd, Rd, Ds, Ds, Ds, Ds^Edp, Qxe^Xo, Hd, Qxe^Xo, Qxe^Xo, Qxe^Xo, Xue, Xue, Xue, Xue, Uhe, Xue, Xue, Uue, Re, Uue, Re^Em, Uhe, Uue^Uf, Uue^Vu, Uue, Qxe, Uhe, Xue, Xue, Xue, Xue, Xue
Xue, Xue, Xue, Yhs^Xp, Yhs^Xp, Uue^Uf, Re^Em, Uue^Em, Uue^Uf, Yhs, Uhe, Xue, Xue, Xue, Mdd^Xm, Mdd^Xm, Qxe^Xo, Qxe^Xo, Dd^Eff, Dd, Dd, Dd, Dd, Rd, Ds, Ds, Ds, Dd, Dd, Qxe^Xo, Qxe^Xo, Qxe^Xo, Xue, Xue, Xue, Xue, Uue, Uhe, Uue, Uue, Uue, Uue, Uue, Re^Uf, Uue, Uue, Cud, Uue, Uhe, Xue, Xue, Xue, Xue, Xue
Xue, Xue, Xue, Uue, Uhe, Uue^Uf, Yhs^Xp, Re^Edb, Uue^Edb, Uue, Uhe, Uhe, Xue, Xue, Xue, Qxe^Xo, Qxe^Xo, Qxe^Xo, Qxe^Xo, Dd^Eff, Dd^Eff, Dd, Dd, Rd, Rd, Rd, Ds, Ds, Dd, Qxe^Xo, Qxe^Xo, Xue, Xue, Xue, Uhe, Uhe, Re^Vud, Re^Em, Re, Uue, Cud, Xue, Uue, Re^Em, Re, Cud, 2 Kud, Cud, Uue, Uhe, Xue, Xue, Xue, Xue
Xue, Xue, Xue, Xue, Uhe, Uhe, Qxe, Yhs^Edb, Uue^Edb, Qxe, Uhe, Xue, Xue, Xue, Xue, Qxe^Xo, Qxe^Xo, Qxe^Xo, Qxe^Xo, Dd^Eff, Dd^Eff, Dd, Rd, Rd, Rd, Ds, Ds, Rd, Dd, Hd, Dd, Xue, Xue, Xue, Uue, Uue^Uf, Re, Re^Es, Uue, Xue, Xue, Xue, Xue, Uue, Uue, Cud, Cud, Cud, Uue, Uue^Uf, Xue, Xue, Xue, Xue
Xue, Xue, Xue, Xue, Xue, Uhe, Qxe, Qxe, Qxu^Bh|, Qxe, Xue, Xue, Xue, Xue, Xue, Qxe^Xo, Qxe^Xo, Qxe^Xo, Qxe^Xo, Qxe^Xo, Qxe^Xo, Dd, Dd, Rd, Dd, Ds, Rd, Rd, Rd, Dd, Dd, Xue, Cud, Uue, Re, Uue, Re^Em, Uue, Uue, Re, Uue^Emf, Xue, Xue, Uhe, Uhe, Uue, Uue, Uue, Uue, Uue, Qxe, Xue, Xue, Xue
Xue, Xue, Xue, Xue, Xue, Xue, Qxe, Qxe, Re, Qxe, Qxe, Xue, Xue, Xue, Qxe^Xo, Qxe^Xo, Qxe^Xo, Qxe^Xo, Hd, Qxe^Xo, Dd, Rd, Dd, Rd, Rd, Dd, Dd^Edp, Dd, Dd, Rd, Dd, Rd, Xue, Re, Uue, Re^Es, Uue^Uf, Re, Uue^Vu, Uue, Uue^Uf, Uhe, Xue, Xue, Xue, Uue, Qxe, Xue, Xue, Xue, Qxe, Qxe, Qxe, Qxe
Xue, Xue, Xue, Qxe, Qxe, Qxe, Uhe, Uue, Re^Em, Uue^Emf, Uhe, Qxe, Xue, Xue, Qxe^Xo, Qxe^Xo, Qxe^Xo, Hd, Hd, Cdr, Dd, Dd, Rd, Rd, Kdr, Hd, Dd, Hd, Qxe^Xo, Dd, Qxe^Xo, Dd, Xue, Xue, Xue, Uue, Uhe, Uue, Uue, Re^Em, Uue^Emf, Uue^Uf, Uhe, Xue, Xue, Qxe, Qxe, Xue, Xue, Xue, Qxe, Qxe, Qxe, Qxe
Xue, Xue, Xue, Qxe, Qxe, Qxe, Uhe, Uue, Uue, Uue^Uf, Qxe^Xo, Qxe^Xo, Qxe^Xo, Qxe^Xo, Qxe^Xo, Qxe^Xo, Qxe^Xo, Hd, Dd, Dd, Dd, Dd^Es, Rd, Dd, Cdr, Cdr, Qxe^Xo, Qxe^Xo, Qxe^Xo, Qxe^Xo, Qxe^Xo, Qxe^Xo, Qxe^Xo, Xue, Xue, Xue, Xue, Xue, Xue, Re^Em, Re^Em, Xue, Xue, Xue, Xue, Qxe, Uhe, Uhe, Uue, Xue, Xue, Qxe, Xue, Qxe
Xue, Xue, Xue, Xue, Xue, Qxe, Qxe^Xo, Qxe^Xo, Qxe^Xo, Qxe^Xo, Qxe^Xo, Qxe^Xo, Qxe^Xo, Qxe^Xo, Qxe^Xo, Qxe^Xo, Qxe^Xo, Qxe^Xo, Dd, Ds, Dd, Dd, Cdr, Dd, Ds, Hd, Qxe^Xo, Qxe^Xo, Qxe^Xo, Qxe^Xo, Qxe^Xo, Qxe^Xo, Qxe^Xo, Xue, Xue, Xue, Xue, Xue, Xue, Uue^Uf, Re, Uue, Xue, Xue, Qxe, Qxe, Xue, Uue, Uue, Xue, Xue, Xue, Xue, Xue
Xue, Xue, Xue, Xue, Xue, Xue, Qxe^Xo, Qxe^Xo, Qxe^Xo, Qxe^Xo, Qxe^Xo, Qxe^Xo, Ds^Eff, Qxe^Xo, Dd^Eff, Qxe^Xo, Qxe^Xo, Qxe^Xo, Qxe^Xo, Dd, Rd, Dd, Dd^Es, Dd, Ds, Qxe^Xo, Qxe^Xo, Qxe^Xo, Qxe^Xo, Qxe^Xo, Qxe^Xo, Qxe^Xo, Mdd^Xm, Mdd^Xm, Xue, Xue, Xue, Xue, Xue, Uue, Uue, Uue, Uhe, Qxe, Qxe, Xue, Xue, Uue, Uue^Uf, Uhe, Uhe, Xue, Xue, Xue
Xue, Xue, Xue, Xue, Xue, Qxe^Xo, Qxe^Xo, Qxe^Xo, Qxe^Xo, Qxe^Xo, Dd^Eff, Dd^Eff, Dd, Dd^Eff, Dd, Dd, Dd, Dd, Dd, Rd, Rd, Dd, Dd, Qxe^Xo, Qxe^Xo, Qxe^Xo, Qxe^Xo, Qxe^Xo, Qxe^Xo, Qxe^Xo, Qxe^Xo, Mdd^Xm, Mdd^Xm, Mdd^Xm, Mdd^Xm, Xue, Xue, Xue, Xue, Xue, Xue, Uhe, Xue, Qxe, Xue, Xue, Xue, Uhe, Xue, Uhe, Xue, Xue, Xue, Xue
Xue, Xue, Xue, Xue, Xue, Qxe^Xo, Qxe^Xo, Qxe^Xo, Qxe^Xo, Dd, Ds^Es, Ds, Dd, Dd, Dd^Es, Rd, Dd^Es, Dd, Rd, Rd, Dd^Es, Dd, Qxe^Xo, Qxe^Xo, Qxe^Xo, Qxe^Xo, Qxe^Xo, Qxe^Xo, Qxe^Xo, Qxe^Xo, Qxe^Xo, Mdd^Xm, Mdd^Xm, Mdd^Xm, Mdd^Xm, Mdd^Xm, Mdd^Xm, Xue, Xue, Xue, Xue, Xue, Xue, Xue, Xue, Xue, Xue, Xue, Xue, Xue, Xue, Xue, Xue, Xue
Xue, Xue, Xue, Xue, Xue, Xue, Qxe^Xo, Qxe^Xo, Qxe^Xo, Dd, Ds, Ds, Dd, Dd, Rd, Dd, Rd, Dd, Dd, Dd, Dd, Qxe^Xo, Qxe^Xo, Qxe^Xo, Qxe^Xo, Qxe^Xo, Dd, Qxe^Xo, Qxe^Xo, Qxe^Xo, Qxe^Xo, Mdd^Xm, Mdd^Xm, Mdd^Xm, Mdd^Xm, Mdd^Xm, Mdd^Xm, Mdd^Xm, Mdd^Xm, Mdd^Xm, Mdd^Xm, Xue, Mdd^Xm, Xue, Mdd^Xm, Xue, Mdd^Xm, Xue, Xue, Xue, Xue, Xue, Xue, Xue
Xue, Xue, Xue, Xue, Xue, Xue, Mdd^Xm, Qxe^Xo, Qxe^Xo, Qxe^Xo, Dd^Es, Dd, Dd, Dd^Edpp, Dd^Es, Rd, Rd, Dd, Rd, Dd, Ds, Dd, Qxe^Xo, Qxe^Xo, Ds^Es, Dd, Ds^Es, Dd, Dd, Qxe^Xo, Qxe^Xo, Qxe^Xo, Mdd, Mdd, Mdd, Mdd^Xm, Mdd^Xm, Mdd^Xm, Mdd^Xm, Mdd^Xm, Mdd^Xm, Mdd^Xm, Mdd^Xm, Mdd^Xm, Mdd^Xm, Mdd^Xm, Mdd^Xm, Mdd^Xm, Mdd^Xm, Mdd^Xm, Mdd^Xm, Mdd^Xm, Mdd^Xm, Xue
Xue, Xue, Xue, Xue, Xue, Xue, Mdd^Xm, Mdd, Mdd, Dd, Dd, Dd^Es, Dd, Dd, Dd, Rd, Dd, Dd, Dd, Ds^Edp, Dd, Dd, Qxe^Xo, Qxe^Xo, Ds, Ds, Ds, Dd, Dd, Qxe^Xo, Qxe^Xo, Mdd, Hd, Mdd, Hd, Mdd, Mdd^Xm, Mdd^Xm, Mdd^Xm, Mdd^Xm, Mdd^Xm, Mdd^Xm, Mdd^Xm, Mdd^Xm, Mdd^Xm, Mdd^Xm, Mdd^Xm, Mdd^Xm, Mdd^Xm, Mdd^Xm, Mdd^Xm, Mdd^Xm, Mdd^Xm, Mdd^Xm
Qxe, Xue, Qxe, Xue, Xue, Xue, Mdd^Xm, Mdd^Xm, Mdd, Hd, Hd, Dd, Hd, Dd^Es, Dd, Rd, Dd, Dd, Dd, Ds^Es, Dd, Qxe^Xo, Qxe^Xo, Qxe^Xo, Qxe^Xo, Ds^Es, Dd, Dd, Dd^Es, Dd, Hd, Hd, Hd, Hd, Hd, Hd, Hd, Mdd^Xm, Mdd^Xm, Mdd^Xm, Hd, Mdd^Xm, Mdd^Xm, Mdd^Xm, Hd, Mdd^Xm, Hd, Mdd^Xm, Mdd^Xm, Mdd^Xm, Hd, Mdd^Xm, Mdd^Xm, Mdd^Xm
Qxe, Qxe, Qxe, Qxe, Xue, Xue, Mdd^Xm, Mdd^Xm, Mdd^Xm, Mdd, Mdd, Hd, Dd, Dd, Dd, Dd, Dd, Rd, Rd, Dd, Rd, Dd, Dd, Qxe^Xo, Qxe^Xo, Dd, Hd, Dd, Dd, Dd, Dd, Hd, Dd, Hd, Hd, Hd, Hd, Mdd^Xm, Mdd^Xm, Mdd^Xm, Hd, Hd, Hd, Hd, Hd, Hd, Hd, Mdd^Xm, Dd, Hd, Hd, Hd, Dd, Mdd^Xm
Xue, Qxe, Qxe^Xo, Qxe^Xo, Xue, Xue, Xue, Mdd^Xm, Xue, Mdd, Mdd, Hd, Dd, Rd, Hd, Cdr, Dd, Rd, Rd, Dd^Es, Dd, Dd, Qxe^Xo, Qxe^Xo, Qxe^Xo, Hd, Hd, Dd, Ds^Es, Dd, Ds, Dd, Dd, Dd, Dd, Dd, Dd, Dd, Hd, Hd, Dd, Dd, Dd, Hd, Dd, Hd, Dd, Dd, Dd, Hd, Dd, Dd, Dd, Dd
Xue, Qxe^Xo, Uue, Uue, Xue, Xue, Xue, Xue, Xue, Xue, Xue, Hd, Hd, Hd, Hd, Kdr, Hd, Dd, Dd, Rd, Rd, Dd, Qxe^Xo, Qxe^Xo, Dd, Dd, Dd, Dd, Ds, Ds, Dd, Dd, Dd, Dd, Dd, Dd, Ds^Es, Dd, Dd, Dd, Dd, Dd, Dd, Dd, Dd, Dd, Hd, Dd, Dd, Dd, Dd, Dd, Dd, Dd
Xue, Xue, Xue, Uue, Uue^Uf, Uue^Vu, Uue, Xue, Uue, Xue, Cud, Hd, Mdd, Mdd, Mdd, Hd, Hd, Hd, Qxe^Xo, Dd, Rd, Dd, Dd, Cdr, Dd, Hd, Hd, Dd, Dd, Ds, Dd, Hd, Dd, Dd, Ds, Ds, Dd, Dd, Dd, Dd, Dd, Hd, Dd, Dd, Dd, Dd, Dd, Dd, Dd, Dd, Ds, Ds, Dd, Dd
Xue, Xue, Xue, Uue^Emf, Uue^Uf, Uue, Cud, Uue, Re, Uue, Re, Xue, Xue, Mdd^Xm, Mdd^Xm, Mdd, Hd, Hd, Qxe^Xo, Dd, Dd, Dd, Rd, Dd, Dd, Dd, Dd, Dd^Es, Dd, Dd, Dd, Dd, Ds^Es, Dd, Dd, Ds^Es, Dd, Dd, Dd, Dd, Dd, Dd, Ds, Dd, Dd, Dd, Hd, Dd, Dd, Dd, Ds, Dd, Ds, Dd
Xue, Xue, Uhe, Uue, Uue, Uue, Uue, Re, Uue, Uue^Em, Uue, Uue^Vud, Xue, Xue, Mdd^Xm, Mdd, Mdd, Qxe^Xo, Qxe^Xo, Dd, Dd, Dd^Es, Dd, Rd, Rd, Dd, Dd, Rd, Rd, Dd, Dd, Dd, Ds^Es, Dd, Dd, Dd, Dd, Dd, Dd, Dd, Dd, Ds, Ds, Dd, Ds, Dd, Ds, Ds, Dd, Ds, Dd, Dd, Dd, Dd
Xue, Xue, Uhe, Uhe, Wwf, Wwf, Uue, Re, Re^Uf, Uue^Uf, Uhe, Xue, Xue, Xue, Mdd^Xm, Mdd^Xm, Mdd^Xm, Qxe^Xo, Qxe^Xo, Qxe^Xo, Mdd, Dd, Dd, Rd, Dd, Rd, Dd, Dd, Rd, Dd, Rd, Dd, Dd, Dd, Dd, Dd, Dd, Hd, Dd, Dd, Ds^Vdt, Ds, Ds, Ds^Es, Ds^Es, Dd, Ds^Es, Ds, Dd, Dd, Dd, Dd, Dd, Dd
Xue, Xue, Xue, Uue^Uf, Xue, Wwf, Xue, Uue^Uf, Uhe, Uue^Uf, Uhe, Xue, Xue, Mdd^Xm, Mdd^Xm, Mdd^Xm, Mdd^Xm, Qxe^Xo, Mdd^Xm, Mdd, Mdd, Dd, Dd, Cdr, Dd, Dd, Dd, Rd, Dd, Rd, Dd, Rd, Rd, Dd, Rd, Dd, Rd, Dd, Re, Dd, Dd, Dd, Ds, Ds^Es, Ds, Ds^Es, Ds^Es, Ds, Dd, Dd, Dd, Dd^Es, Dd, Dd
Xue, Xue, Xue, Xue, Xue, Xue, Xue, Uue, Xue, Xue, Xue, Xue, Xue, Mdd^Xm, Mdd^Xm, Mdd^Xm, Qxe^Xo, Qxe^Xo, Mdd^Xm, Mdd, Mdd, Mdd, Dd, Hd, Hd, Ds, Ds^Es, Dd, Dd, Dd, Dd, Dd, Dd, Dd, Dd, Rd, Rd, Re, Ce, Ce, Ce, Dd, Dd, Ds, Ds, Ds^Es, Ds, Dd, Dd, Dd, Dd, Dd, Dd, Dd
Xue, Xue, Xue, Xue, Uhe, Xue, Re, Xue, Xue, Xue, Xue, Xue, Mdd^Xm, Mdd^Xm, Mdd^Xm, Mdd^Xm, Mdd^Xm, Mdd^Xm, Mdd^Xm, Mdd^Xm, Mdd, Mdd, Hd, Dd, Hd, Dd, Dd, Dd, Hd, Hd, Hd, Dd, Dd, Dd, Dd, Dd, Dd, Re, Ce, 1 Ke, Ce, Re, Dd^Vdt, Dd, Dd, Dd, Dd, Dd, Rd, Rd, Rd, Rd, Dd, Rd
Xue, Xue, Uhe, Uue^Emf, Uue^Emf, Uue, Qxe, Xue, Xue, Xue, Xue, Xue, Mdd^Xm, Mdd^Xm, Mdd^Xm, Mdd^Xm, Mdd^Xm, Mdd^Xm, Mdd^Xm, Mdd, Mdd, Hd, Dd, Dd, Hd, Hd, Dd, Hd, Hd, Hd, Hd, Dd, Dd^Es, Dd, Dd, Dd, Dd, Dd, Dd, Ce, Re, Re, Rd, Dd, Rd, Dd, Dd, Rd, Dd, Rd, Dd, Dd, Hd, Dd
Xue, Xue, Uhe, Re^Uf, Re^Uf, Qxe, Qxe, Qxe, Qxe, Xue, Xue, Xue, Mdd^Xm, Mdd^Xm, Mdd^Xm, Mdd^Xm, Mdd^Xm, Mdd^Xm, Mdd, Mdd, Hd, Hd, Dd, Dd, Hd, Hd, Hd, Hd, Dd, Dd, Dd, Dd, Dd, Dd, Dd, Dd, Dd, Dd^Vdt, Dd, Dd, Dd, Rd, Dd, Rd, Dd, Rd, Dd, Dd, Hd, Dd, Dd, Hd, Dd, Hd
Xue, Xue, Xue, Uue^Emf, Uhe, Uhe, Qxe, Qxe, Qxe, Qxe, Xue, Xue, Xue, Mdd^Xm, Mdd^Xm, Mdd^Xm, Mdd^Xm, Mdd, Mdd, Hd, Dd, Hd, Dd, Dd, Dd, Hd, Dd, Hd, Dd, Dd, Dd, Dd, Dd, Dd, Dd, Dd, Dd, Dd, Dd, Ds, Dd, Dd, Dd, Dd, Dd, Dd, Dd, Hd, Dd, Dd, Hd, Hd, Dd, Dd
Xue, Xue, Xue, Xue, Xue, Xue, Qxe, Qxe, Qxe, Qxe, Xue, Xue, Xue, Mdd^Xm, Mdd^Xm, Mdd^Xm, Mdd^Xm, Mdd^Xm, Mdd, Hd, Hd, Dd, Dd, Hd, Hd, Hd, Dd, Dd, Hd, Dd, Dd, Dd, Dd, Dd, Dd, Hd, Hd, Dd, Dd, Dd, Dd, Dd, Dd, Dd^Edb, Dd, Hd, Dd, Hd, Dd, Hd, Dd, Dd, Dd, Dd
Xue, Xue, Xue, Xue, Xue, Xue, Qxe, Qxe, Qxe, Xue, Xue, Xue, Xue, Xue, Xue, Mdd^Xm, Mdd^Xm, Mdd^Xm, Mdd, Mdd, Mdd, Dd, Dd, Dd, Hd, Dd, Dd, Hd, Hd, Hd, Hd, Dd, Hd, Dd, Dd^Es, Dd, Hd, Dd, Hd, Dd, Dd, Hd, Hd, Dd, Hd, Hd, Hd, Hd, Dd, Dd, Dd^Es, Dd, Dd, Dd
Xue, Xue, Xue, Xue, Xue, Qxe, Qxe, Qxe, Xue, Qxe, Uhe, Uue, Uue, Xue, Xue, Xue, Xue, Mdd^Xm, Mdd^Xm, Mdd, Mdd^Xm, Dd, Dd, Hd, Hd, Hd, Dd, Hd, Hd, Hd, Dd, Dd, Dd, Dd, Dd, Dd, Dd, Dd, Dd, Dd, Dd, Dd, Dd, Hd, Dd, Dd, Dd, Hd, Dd, Dd, Dd, Dd, Dd, Dd
Xue, Xue, Xue, Xue, Xue, Xue, Xue, Xue, Xue, Xue, Xue, Xue, Xue, Uue, Xue, Xue, Xue, Mdd^Xm, Mdd^Xm, Mdd^Xm, Mdd^Xm, Mdd^Xm, Mdd^Xm, Hd, Mdd, Dd, Dd, Dd, Dd, Dd, Hd, Dd, Dd, Dd, Dd, Dd, Dd, Dd, Dd, Hd, Dd, Dd, Hd, Dd, Dd, Dd, Dd, Dd, Dd, Dd, Hd, Hd, Dd, Dd
Xue, Xue, Xue, Xue, Xue, Xue, Xue, Xue, Xue, Xue, Xue, Xue, Xue, Xue, Xue, Xue, Xue, Xue, Xue, Mdd^Xm, Mdd^Xm, Mdd^Xm, Mdd^Xm, Mdd, Mdd, Mdd, Mdd, Hd, Hd, Hd, Hd, Hd, Hd, Hd, Hd, Hd, Dd, Dd, Dd, Dd, Dd, Dd, Dd, Hd, Hd, Hd, Dd, Dd, Dd, Dd, Dd, Hd, Hd, Hd
Xue, Xue, Xue, Xue, Xue, Xue, Xue, Xue, Xue, Xue, Xue, Xue, Xue, Xue, Xue, Xue, Xue, Xue, Xue, Xue, Mdd^Xm, Mdd^Xm, Mdd^Xm, Mdd^Xm, Mdd, Mdd, Mdd, Mdd, Mdd, Hd, Hd, Hd, Dd, Hd, Hd, Hd, Dd, Dd, Dd, Dd, Dd, Dd, Dd, Hd, Dd, Dd, Dd, Dd, Dd, Dd, Dd, Dd, Dd, Dd
