border_size=1
usage=map

Md^Xm       , Md          , Hd          , Re          , Rd          , Rd          , Ds          , Dd          , Hd          , Hd          , Md          , Md^Xm       , Md^Xm       , Md^Xm       , Xu          , Xu          , Xu          , Xu          , Uu^Uf       , Uu          , Uu          , Uu          , Uu^Uf       , Xu          , Xu          , Xu          , Xu          , Uu^Uf       , Uu^Uf       , Uu^Uf       
Md^Xm       , Md          , Hd          , Dd          , Dd          , Rd          , Rd          , Dd          , Dd          , Hd          , Hd          , Md^Xm       , Md          , Md^Xm       , Md^Xm       , Xu          , Xu          , Xu          , Uh          , Uu^Uf       , Uu^Vud      , Uu          , Uu^Uf       , Uu^Uf       , Uu^Uf       , Uu^Vud      , Uu          , Uu^Uf       , Uu          , Uu          
Xu          , Md^Xm       , Md          , Hd          , Hd          , Re          , Re          , Rd          , Dd          , Re          , Rd          , Dd          , Dd          , Hd          , Md^Xm       , Md^Xm       , Xu          , Xu          , Uh          , Uu^Uf       , Uu^Uf       , Uu          , Uu^Cd       , Uu^Cd       , Uu^Cd       , Uu          , Uu          , Rd          , Uu^Vu       , Uu          
Xu          , Md^Xm       , Md^Xm       , Md          , Hd          , Re          , Ds          , Rd          , Dd          , Dd          , Re          , Rd          , Dd          , Dd          , Md^Xm       , Md^Xm       , Xu          , Xu          , Xu          , Uh          , Uu^Vu       , Rd          , Uu^Cd       , 3 Uu^Kd     , Uu^Cd       , Rd          , Uu^Uf       , Qxu         , Qxu         , Xu          
Xu          , Xu          , Md^Xm       , Md          , Hd          , Ds          , Hd          , Dd          , Ds          , Dd          , Hd          , Rd          , Rd          , Hd          , Dd          , Md^Xm       , Md^Xm       , Xu          , Uu          , Uh          , Rd          , Uu          , Uu          , Uu^Cd       , Uu          , Rd          , Uu          , Uh          , Qxu         , Xu          
Xu          , Xu          , Xu          , Md^Xm       , Md          , Md          , Md^Xm       , Dd          , Re          , Hd          , Dd^Dr       , Re          , Rd          , Hd          , Md^Xm       , Md^Xm       , Md          , Md          , Md          , Rd          , Uu^Uf       , Uu          , Rd          , Uu          , Uu          , Uu^Vu       , Uh          , Qxu^Bs\     , Uu          , Qxu         
Wo          , Xu          , Xu          , Md^Xm       , Md^Xm       , Dd^Vda      , Md          , Rd          , Re          , Dd          , Hd          , Dd          , Ds          , Hd          , Hd          , Md          , Dd^Vda      , Hd          , Md          , Uu          , Uu^Uf       , Uu^Uf       , Rd          , Uu          , Uu^Uf       , Uh          , Uh          , Qxu         , Uh          , Qxu         
Xu          , Wo          , Wo          , Xu          , Md^Xm       , Md^Xm       , Re          , Hd          , Re          , Re          , Rr          , Re          , Rd          , Dd^Dr       , Hd          , Hd          , Hd          , Md^Xm       , Md          , Xu          , Xu          , Xu          , Uu          , Rd          , Uh          , Xu          , Xu          , Qxu         , Qxu^Bs|     , Qxu^Bs\     
Xu          , Xu          , Xu          , Wo          , Ww          , Md^Xm       , Gs          , Hd          , Dd^Dr       , Re          , Rd          , Rr          , Ds          , Rd          , Re          , Rd          , Rd          , Hd          , Md          , Md^Xm       , Md^Xm       , Xu          , Md          , Md          , Md^Xm       , Xu          , Xu          , Xu          , Uu          , Qxu         
Xu          , Xu          , Xu          , Xu          , Xu          , Wwf         , Ww          , Gs          , Re          , Ds          , Rd          , Re          , Ds          , Rd          , Rd          , Rd          , Dd          , Rd          , Hd          , Hd          , Hd          , Md          , Hd          , Md          , Md^Xm       , Xu          , Xu          , Xu          , Uu          , Xu          
Xu          , Xu          , Xu          , Xu          , Xu          , Md^Xm       , Ww          , Gs          , Dd          , Dd          , Re          , Dd          , Dd^Dr       , Ds          , Rd          , Dd          , Re          , Rd          , Dd          , Re          , Ds          , Ds          , Dd          , Hd          , Hd          , Md^Xm       , Md^Xm       , Xu          , Uu          , Xu          
Xu          , Uh          , Xu          , Xu          , Xu          , Md^Xm       , Md^Xm       , Wwf         , Wwf         , Dd          , Re          , Dd          , Rd          , Rr          , Dd          , Re          , Rd          , Re          , Ds          , Re          , Dd          , Ds          , Dd          , Dd          , Md          , Md^Xm       , Md^Xm       , Xu          , Xu          , Uu          
Xu          , Uh          , Uh          , Xu          , Xu          , Xu          , Xu          , Dd          , Ww          , Gs          , Re          , Ds          , Ds          , Dd          , Dd          , Ds          , Ds          , Rd          , Rd          , Re          , Re          , Dd          , Dd^Dr       , Hd          , Md          , Md^Xm       , Xu          , Xu          , Xu          , Uu          
Xu          , Uu^Vu       , Uh          , Yhs^Xp      , Uu^Uf       , Qxu         , Uu^Vud      , Xu          , Uu          , Wwf         , Gs          , Re          , Dd          , Re          , Dd          , Dd          , Ds          , Rr          , Rd          , Ds          , Ds          , Rd          , Rd          , Hd          , Hd          , Md^Xm       , Xu          , Xu          , Xu          , Xu          
Xu          , Ur          , Ur          , Uu          , Ur          , Qxu         , Uu          , Uu          , Uu^Cd       , Wwf         , Wwf         , Hd          , Md          , Dd          , Dd          , Md          , Hd          , Dd          , Dd          , Re          , Ds          , Rr          , Rr          , Hd          , Hd          , Md          , Wo          , Wo          , Wo          , Wo          
Xu          , Xu          , Xu          , Uu^Vu       , Uu          , Qxu         , Uu          , Uu^Cd       , 2 Uu^Kd     , Uu^Cd       , Md          , Ww          , Gs          , Hd          , Md          , Md^Xm       , Md          , Re          , Dd          , Ds          , Ds          , Rr          , Gs          , Gs          , Wwf         , Wwf         , Md          , Xu          , Xu          , Xu          
Xu          , Xu          , Ryd^Z\      , Uu^Uf       , Ur          , Qxu^Bs/     , Uu^Vu       , Uu^Cd       , Uu^Cd       , Uu^Cd       , Md          , Wwf         , Ww          , Gs          , Md^Xm       , Md^Xm       , Md^Xm       , Hd          , Hd          , Dd          , Gs          , Rd          , Rd          , Ww          , Gs          , Hd          , Hd          , Md^Xm       , Md^Xm       , Xu          
Xu          , Wwf         , Wwf         , Ryd^Z\      , Xu          , Uu^Uf       , Uu^Uf       , Uu          , Uu^Uf       , Uu^Vu       , Xu          , Xu          , Xu          , Xu          , Xu          , Xu          , Xu          , Md          , Wwf         , Gs          , Ww          , Gs          , Ww          , Wwf         , Gs          , Rd          , Re          , Md          , Md^Xm       , Md^Xm       
Xu          , Uh          , Ur          , Uu^Uf       , Xu          , Uu^Uf       , Uu^Uf       , Uh          , Xu          , Uh          , Xu          , Xu          , Xu          , Xu          , Gs          , Ww          , Wwf         , Ww          , Gs          , Wwf         , Gs          , Ww          , Gs          , Hd          , Re          , Rd          , Rd          , Dd          , Md          , Md^Xm       
Xu          , Uu^Ii       , Uu^Ii       , Uh^Ii       , Xu          , Uh          , Xu          , Qxu         , Qxu         , Xu          , Md^Xm       , Md^Xm       , Md^Xm       , Md          , Hd          , Gs          , Ww          , Gs          , Hd          , Hd          , Hd          , Gs          , Dd          , Hd          , Re          , Rd          , Re          , Hd          , Hd          , Md^Xm       
Xu          , Uu^Ufi      , Uu^Ufi      , Uu^Ufi      , Xu          , Xu          , Xu          , Xu          , Md^Xm       , Md^Xm       , Md^Xm       , Md^Xm       , Hd          , Hd          , Ds          , Gs          , Gs          , Ww          , Wwf         , Dd^Vda      , Dd^Dr       , Hd          , Re          , Rr          , Ds          , Ds          , Hd          , Hd          , Md          , Md^Xm       
Xu          , Xu          , Xu          , Xu          , Wo          , Xu          , Md^Xm       , Md          , Hd          , Hd          , Hd          , Re          , Ds          , Dd^Dr       , Rd          , Ds          , Gs          , Ww          , Wwf         , Gs          , Rd          , Rd          , Re          , Rr          , Re          , Hd          , Md          , Md          , Md^Xm       , Md^Xm       
Wo          , Xu          , Wo          , Wo          , Ww          , Md^Xm       , Hd          , Hd          , Ds          , Dd          , Rd          , Dd          , Rr          , Re          , Dd          , Rd          , Re          , Gs          , Ww          , Gs          , Dd          , Dd          , Rd          , Re          , Md          , Rd          , Rd          , Md          , Xu          , Xu          
Ww          , Wo          , Wo          , Ww          , Gs          , Hd          , Dd          , Re          , Rd          , Dd^Vda      , Ds          , Re          , Re          , Dd          , Hd          , Re          , Hd          , Gs          , Wwf         , Hd          , Hd          , Rd          , Hd          , Re          , Md^Xm       , Hd          , Uh          , Uu          , Xu          , Xu          
Gs          , Ww          , Ww          , Ww          , Dd          , Rd          , Rd          , Ds          , Rd          , Re          , Dd          , Dd          , Hd          , Hd          , Md^Xm       , Md          , Md          , Gs          , Ww          , Wwf         , Ww          , Hd          , Md          , Md^Xm       , Md^Xm       , Xu          , Yhs^Xp      , Re          , Uh          , Xu          
Mm^Xm       , Gs          , Ds          , Gs          , Re          , Re          , Rd          , Re          , Dd          , Dd          , Re          , Re          , Md          , Hd          , Md^Xm       , Md^Xm       , Xu          , Uu          , Re          , Uh          , Xu          , Wo          , Xu          , Md^Xm       , Xu          , Xu          , Re          , Uu^Vu       , Re          , Xu          
Mm^Xm       , Mm^Xm       , Md^Xm       , Dd          , Re          , Ds          , Ds          , Rd          , Rd          , Rd          , Ds          , Hd          , Md^Xm       , Md^Xm       , Md^Xm       , Md^Xm       , Xu          , Uu^Uf       , Uu^Vu       , Uu          , Uu          , Xu          , Yhs^Xp      , Xu          , Uu^Vu       , Re          , Rd          , Uu          , Uu          , Rd          
Xu          , Mm^Xm       , Md^Xm       , Hd          , Hd          , Rd          , Ds          , Rd          , Ds          , Re          , Hd          , Hd          , Md          , Md^Xm       , Md^Xm       , Md^Xm       , Xu          , Uu^Uf       , Uu^Uf       , Re          , Yhs^Xp      , Uu          , Re          , Uu^Uf       , Re          , Re          , Xu          , Yhs^Xp      , Md^Xm       , Uu^Uf       
Xu          , Xu          , Md^Xm       , Md          , Hd          , Dd^Vda      , Dd          , Ds          , Dd^Dr       , Rd          , Hd          , Dd^Vda      , Md          , Md^Xm       , Md          , Md^Xm       , Md^Xm       , Xu          , Md^Xm       , Xu          , Xu          , Xu          , Re          , Uu          , Uu^Vu       , Yhs^Xp      , Xu          , Md^Xm       , Wo          , Wo          
Xu          , Xu          , Xu          , Md          , Md^Xm       , Hd          , Hd          , Re          , Re          , Rd          , Rd          , Ds          , Re          , Md          , Hd          , Md^Xm       , Hd          , Md^Xm       , Md^Xm       , Md^Xm       , Md^Xm       , Xu          , Uu^Uf       , Uu          , Xu          , Xu          , Md^Xm       , Md^Xm       , Wo          , Md^Xm       
Yhs         , Xu          , Xu          , Xu          , Md          , Hd          , Hd          , Re          , Rd          , Rd          , Re          , Dd          , Ds          , Hd          , Rd          , Dd^Dr       , Dd          , Hd          , Hd          , Md          , Hd          , Md^Xm       , Ds          , Uu          , Md^Xm       , Md^Xm       , Wo          , Wo          , Md^Xm       , Md^Xm       
Xu          , Yhs^Xp      , Yhs         , Ryd         , Ryd         , Md          , Hd          , Rd          , Rd          , Re          , Ds          , Re          , Ds          , Rd          , Ds          , Rd          , Re          , Ds          , Ds          , Re          , Md          , Hd          , Hd          , Ds          , Gs          , Ww          , Wwf         , Md^Xm       , Md          , Md^Xm       
Yhs         , Yhs         , Yhs         , Yhs         , Xu          , Md^Xm       , Md          , Hd          , Hd          , Ds          , Rd          , Re          , Dd          , Ds          , Re          , Rd          , Rd          , Re          , Rd          , Dd          , Dd          , Hd          , Hd          , Gs          , Dd^Vdt      , Ww          , Gs^Zi       , Gs          , Dd^Dr       , Md
Yhs         , Yhs         , Xu          , Xu          , Yhs^Xp      , Xu          , Xu          , Md^Xm       , Md^Xm       , Hd          , Hd          , Hd          , Hd          , Dd          , Hd          , Dd          , Re          , Dd          , Rd          , Dd          , Re          , Ds          , Dd          , Gs          , Wwf         , Wwf         , Gs          , Hd          , Hd          , Hd          
Xu          , Yhs         , Yhs         , Zw          , Xu          , Xu          , Yhs^Xp      , Xu          , Xu          , Md^Xm       , Md^Xm       , Hd          , Md^Xm       , Hd          , Md^Xm       , Hd          , Hd          , Hd          , Rd          , Re          , Dd          , Rd          , Ds          , Ww          , Ce          , Ce          , Ce          , Gs          , Ds          , Hd          
Xu          , Yhs^Xp      , Yhs         , Yhs         , Yhs         , Zw          , Xu          , Xu          , Xu          , Xu          , Xu          , Md^Xm       , Md^Xm       , Md^Xm       , Md^Xm       , Md^Xm       , Md^Xm       , Md          , Ds          , Hd          , Gs          , Rd          , Dd^Vdt      , Wwf         , Ce          , 1 Ke        , Ce          , Ds          , Dd^Vdt      , Hd          
Yhs         , Yhs         , Xu          , Xu          , Yhs         , Yhs         , Yhs         , Xu          , Xu          , Xu          , Yhs^Xp      , Xu          , Xu          , Md^Xm       , Md^Xm       , Md^Xm       , Md^Xm       , Md          , Hd          , Gs          , Wo          , Wwf         , Ww          , Wwf         , Gs          , Ce          , Dd          , Dd          , Hd          , Ds          
Xu          , Xu          , Xu          , Xu          , Yhs         , Xu          , Xu          , Yhs         , Yhs         , Zw          , Xu          , Xu          , Xu          , Xu          , Xu          , Xu          , Xu          , Md^Xm       , Wo          , Wo          , Wo          , Wwf         , Gs          , Gs^Zi       , Dd          , Dd          , Re          , Dd^Dr       , Hd          , Ds
