border_size=1
usage=map

Xue, Xue, Xue, Xue, Xue, Xue, Xue, Xue, Xue, Xue, Xue, Xue, Xue, Xue, Xue, Xue, Xue, Mm^Xm, Mm^Xm, Mm^Xm, Mm^Xm, Mm^Xm, Mm^Xm, Mm^Xm, Mm^Xm, Mm^Xm, Mm^Xm, Mm^Xm, Mm^Xm, Mm^Xm, Mm^Xm, Mm^Xm, Mm^Xm, Mm^Xm, Mm^Xm, Mm^Xm, Mm^Xm, Mm^Xm, Mm^Xm, Mm^Xm, Ai, Mm^Xm, Mm^Xm, Mm^Xm, Mm^Xm, Mm^Xm, Mm^Xm, Mm^Xm, Mm^Xm, Mm^Xm, Mm^Xm, Mm^Xm, Mm^Xm, Mm^Xm, Mm^Xm, Mm^Xm, Mm^Xm, Mm^Xm, Mm^Xm, Mm^Xm, Mm^Xm, Mm^Xm, Mm^Xm, Mm^Xm
Qxe, Xue, Xue, Xue, Xue, Xue, Qxe, Xue, Xue, Xue, Xue, Xue, Xue, Xue, Xue, Xue, Xue, Mm^Xm, Mm^Xm, Mm^Xm, Mm^Xm, Mm^Xm, Mm^Xm, Mm^Xm, Mm^Xm, Mm^Xm, Mm, Mm, Mm^Xm, Mm, Mm, Mm, Mm^Xm, Mm^Xm, Mm, Mm^Xm, Mm, Mm^Xm, Mm, Mm, Ai, Mm, Mm, Mm^Xm, Ai, Mm, Ai, Mm, Mm, Mm, Mm, Mm^Xm, Mm^Xm, Mm^Xm, Mm^Xm, Mm^Xm, Mm^Xm, Mm^Xm, Mm^Xm, Mm^Xm, Mm^Xm, Mm, Mm^Xm, Mm^Xm
Qxe, Qxe, Qxe, Qxe, Qxe, Qxe, Uhe^Ii, Qxe, Qxe, Xue, Xue, Xue, Xue, Xue, Xue, Xue, Xue, Mm^Xm, Mm^Xm, Mm^Xm, Mm, Mm, Mm, Mm^Xm, Mm^Xm, Mm^Xm, Mm, Mm, Mm, Mm^Xm, Mm, Mm^Xm, Mm^Xm, Mm^Xm, Mm, Mm, Mm, Mm, Mm, Mm^Xm, Ai, Mm^Xm, Ai, Ai, Ai, Ai, Ai, Ai, Ai, Mm, Mm, Mm^Xm, Mm^Xm, Mm^Xm, Mm^Xm, Mm^Xm, Mm^Xm, Mm^Xm, Mm^Xm, Mm^Xm, Mm^Xm, Mm, Mm, Mm^Xm
Uue, Uhe^Ii, Urb, Qxe, Uue, Uue^Ii, Uhe^Ii, Uhe^Ii, Uhe^Ii, Qxe, Xue, Xue, Xue, Xue, Xue, Xue, Xue, Mm, Mm^Xm, Mm^Xm, Mm, Mm, Mm^Xm, Mm^Xm, Mm, Mm, Mm^Xm, Mm, Mm, Mm, Mm^Xm, Mm, Mm, Mm, Mm^Xm, Mm^Xm, Mm, Mm, Mm, Mm^Xm, Ai, Ai, Mm, Ai, Ai, Ai, Ai, Ai, Mm, Mm, Mm, Mm^Xm, Mm^Xm, Mm^Xm, Mm^Xm, Mm^Xm, Mm^Xm, Mm^Xm, Mm^Xm, Mm^Xm, Mm^Xm, Mm^Xm, Mm^Xm, Mm
Urb, Urb, Uhe^Ii, Urb, Rd, Uue^Ii, Uue, Uue^Ii, Uhe, Qxe, Xue, Xue, Xue, Xue, Xue, Xue, Xue, Mm^Xm, Mm, Mm, Mm^Xm, Mm^Xm, Mm, Mm, Mm, Mm^Xm, Mm, Hh, Hh, Mm, Mm, Mm, Mm, Mm^Xm, Mm^Xm, Mm^Xm, Hh, Mm, Mm^Xm, Mm, Ai, Mm^Xm, Mm^Xm, Mm^Xm, Mm^Xm, Mm, Mm, Mm, Mm^Xm, Mm, Mm^Xm, Mm^Xm, Mm^Xm, Mm^Xm, Mm^Xm, Mm^Xm, Mm^Xm, Mm^Xm, Ww, Ww, Mm^Xm, Mm^Xm, Mm, Mm
Uhe, Uue^Uf, Re^Uf, Uue^Ii, Re^Uf, Urb, Uue, Uue, Uue^Uf, Qxe, Uue, Uhe^Ii, Uhe^Ii, Xue, Xue, Xue, Xue, Mm, Mm, Mm, Hh, Mm^Xm, Hh, Mm, Mm^Xm, Mm, Mm, Mm, Hh, Mm, Mm, Mm, Mm, Mm^Xm, Mm, Mm, Hh^Fms, Mm, Mm^Xm, Mm, Ww, Mm^Xm, Mm^Xm, Mm^Xm, Mm, Mm, Mm, Mm^Xm, Mm^Xm, Mm^Xm, Mm^Xm, Mm^Xm, Mm, Mm^Xm, Mm^Xm, Mm^Xm, Mm^Xm, Mm, Ww, Mm^Xm, Mm, Mm^Xm, Mm^Xm, Mm
Uue, Uue^Em, Uue^Ii, Qxe, Uue, Urb, Rd, Re^Emf, Uue^Uf, Qxe, Qxe, Uue^Ii, Uhe^Ii, Uhe^Ii, Uue^Ii, Xue, Xue, Mm, Mm, Mm, Hh, Hh, Re^Gvs, Hh, Hh, Hh^Fms, Hh^Fms, Hh^Fms, Hh^Fms, Mm, Hh, Hh, Hh^Fms, Mm, Hh, Mm, Hh, Mm, Mm, Mm^Xm, Ww, Mm, Mm, Mm^Xm, Mm, Mm, Hh, Mm^Xm, Hh, Hh, Hh, Mm, Mm, Mm, Mm, Hh, Hh, Mm, Ww, Mm^Xm, Mm, Mm, Mm, Mm
Uhe, Uue, Uue^Vud, Qxe, Uue, Uue, Urb, Re^Em, Uue, Uue^Ii, Uue, Uue^Vud, Rd, Re^Uf, Uue^Ii, Xue, Xue, Mm, Mm, Hh, Hh, Hh, Re^Gvs, Re^Gvs, Re^Gvs, Hh^Fms, Gs^Fds, Hh^Fms, Gs^Fds, Hh^Fms, Hh, Hh^Fms, Hh^Fms, Hh, Hh, Hh^Vo, Re^Gvs, Re^Gvs, Re^Gvs, Mm, Ww, Mm, Hh, Mm, Hh, Mm, Hh, Mm, Hh^Fms, Hh, Gs, Chr, Chr, Mm, Mm, Hh, Mm, Mm, Ww, Mm, Mm, Mm, Mm, Mm
Xue, Qxe, Qxe, Qxe, Uhe, Uue^Uf, Uue, Urb, Rd, Uue^Ii, Uue, Uue, Cud, Uue, Uhe, Uhe^Ii, Xue, Mm^Xm, Chr, Hh, Hh, Mm, Hh, Re^Gvs, Gg^Efm, Gs, Re^Gvs, Re^Gvs, Re^Gvs, Hh^Fms, Hh, Hh, Gg, Chr, Ch, Re^Gvs, Re^Gvs, Re^Gvs, Ww, Ww, Hh, Ww, Ww, Hh, Re^Gvs, Hh, Hh, Hh^Fms, Gs^Fms, Gs^Fms, Chw, Chr, Chw, Hh, Mm, Mm, Ww, Ww, Hh, Mm, Mm, Mm, Mm, Mm
Xue, Xue, Qxe, Uhe^Ii, Uhe, Qxe, Qxe, Uue, Urb, Uue, Rd, Cud, 3 Kud, Cud, Cud, Uue^Ii, Hh, Hh, Gg, Gg, Gs^Fms, Gs^Fms, Gs^Fms, Gg^Efm, Re^Gvs, Re^Gvs, Re^Gvs, Re^Gvs, Re, Re^Gvs, Re^Gvs, Gs, Gs^Fds, Gs^Fds, Re^Gvs, Gg^Efm, Gs^Fds, Ww, Hh^Fms, Hh, Re^Gvs, Re^Gvs, Re^Gvs, Ww, Re^Gvs, Re^Gvs, Hh, Gs^Fds, Ww, Gs^Fds, Ww, Ww, Ww, Chw, Ww, Ww, Hh, Mm, Hh, Mm, Mm, Mm, Hh, Mm
Xue, Xue, Qxe, Uhe^Ii, Uhe^Ii, Uhe, Uue^Ii, Uue^Em, Uue^Uf, Urb, Rd, Cud, Cud, Cud, Re, Hh, Re, Gg, Re, Gg, Re^Gvs, Re^Gvs, Re^Gvs, Gs^Fms, Gs, Re^Gvs, Re, Re^Gvs, Re, Re^Gvs, Ww, Ww, Ww, Re^Gvs, Re^Gvs, Re^Gvs, Ww, Ww, Hh, Hh, Re^Gvs, Re^Gvs, Chr, Ww, Hh^Vo, Hh, Ww, Ww, Gg^Efm, Ww, Gs^Fds, Hh, Hh, Ww, Chr, Hh, Gg, Gg, Hh, Mm, Hh, Mm, Hh^Fp, Mm
Xue, Xue, Xue, Qxe, Qxe, Qxe, Qxe, Uhe, Uhe, Urb, Urb, Uue, Uue^Ii, Cud, Hh, Re, Gg^Efm, Re, Gg, Re, Re, Re^Gvs, Re, Gg, Gs, Gs^Fds, Re^Gvs, Re^Gvs, Ww, Ww, Gg, Gs^Fms, Gs^Fds, Ww, Ww, Ww, Hh, Hh, Gll^Fp, Re^Gvs, Chr, 2 Khr, Ch, Ww, Ww, Ww, Gs^Fp, Gg, Gg, Gg, Gg, Gs^Fp, Gs^Fms, Chr, Hh^Fds, Gg, Hh, Gg, Gs^Fms, Hh, Hh, Mm, Hh, Hh
Xue, Xue, Xue, Xue, Xue, Xue, Xue, Xue, Xue, Uue^Uf, Uue^Vu, Uue^Ii, Rr, Hh, Gs^Fds, Gs^Fds, Gs, Gg^Efm, Gg, Gg, Re^Gvs, Re, Re, Re, Re, Re^Gvs, Re^Gvs, Re^Gvs, Re^Gvs, Gs, Gs^Fp, Gg^Efm, Re^Gvs, Gs^Fds, Ww, Ww, Gs^Fp, Gll, Hh^Fms, Re^Gvs, Re^Gvs, Re, Re^Gvs, Re^Gvs, Gs^Fms, Gg^Efm, Gs, Gg, Gs^Fms, Gs^Fp, Gg, Gg, Gs^Fms, Hh^Fds, Hh, Hh^Fds, Hh^Fms, Gg, Gs^Fms, Hh^Fp, Hh^Fp, Hh, Mm, Hh
Xue, Xue, Xue, Xue, Xue, Xue, Xue, Xue, Xue, Xue, Xue, Uue^Ii, Hh, Hh, Gg^Efm, Gs^Fds, Gs, Chr, Gg, Re^Gvs, Re^Gvs, Re, Gs, Gs^Fds, Gs^Fds, Re, Re, Re^Gvs, Gs, Gs, Re^Gvs, Re^Gvs, Re^Gvs, Ww, Gs^Fds, Gs^Fds, Gg^Vo, Gs^Fms, Hh^Fp, Hh^Fms, Hh^Fp, Re, Hh^Fms, Hh^Fp, Gg, Gg, Gg, Gg, Gs^Fds, Gg^Efm, Gs, Gs, Hh, Hh, Gg, Gs^Fms, Hh, Gs^Fms, Gg, Hh, Hh, Hh, Mm, Hh
Mm^Xm, Xue, Xue, Xue, Xue, Xue, Xue, Xue, Xue, Xue, Xue, Xue, Hh, Gg, Gg^Efm, Gg^Efm, Re^Gvs, Gs, Gs^Fms, Gg^Efm, Gg, Gs, Gd, Gs^Fds, Re, Re, Re, Re, Gs, Gd, Re^Gvs, Re^Gvs, Gs^Fp, Ww, Gs^Fp, Gs^Fds, Gs^Fms, Gs^Fms, Gg^Efm, Gll^Fp, Re, Re, Gs^Fms, Gs^Fp, Gg, Gg^Vo, Gg, Gg, Re^Gvs, Gg, Gs, Gs, Hh, Gg, Gg, Hh, Gs, Gg, Hh, Hh^Fp, Mm, Mm, Hh^Fp, Hh^Fp
Mm^Xm, Mm^Xm, Mm^Xm, Mm^Xm, Mm^Xm, Mm, Mm, Mm^Xm, Mm^Xm, Mm, Mm, Hh, Hh, Chr, Re^Gvs, Re^Gvs, Re^Gvs, Re, Re^Gvs, Gg, Gg, Gs, Re, Re, Ch, Chr, Gs^Fms, Re, Re, Gs, Re^Gvs, Re^Gvs, Ww, Ww, Gg, Gs^Fms, Gs^Fms, Chr, Gg, Gll^Fms, Re, Gs^Fms, Gs^Fds, Gg, Gg, Gg, Re^Gvs, Re^Gvs, Re^Gvs, Re^Gvs, Gg^Efm, Gs, Gg, Gs, Gg^Vc, Gg, Gs, Gs, Hh, Hh, Mm, Hh, Mm, Hh^Fp
Mm^Xm, Mm^Xm, Mm^Xm, Mm^Xm, Mm, Mm, Mm^Xm, Mm^Xm, Mm^Xm, Mm, Mm^Xm, Mm^Xm, Hh, Re, Re^Gvs, Re, Re^Gvs, Gg^Vo, Re^Gvs, Re^Gvs, Re^Gvs, Hh, Re, Re, Gs, Chr, Gs^Fp, Gs, Re^Gvs, Re, Re^Gvs, Ww, Re^Gvs, Gs^Fp, Gs^Fms, Gg, Gg, Gg, Gs^Fp, Gs^Fms, Re, Gs^Fds, Chr, Gg, Gg, Re^Gvs, Re^Gvs, Re^Gvs, Gg, Gs, Hh, Gg, Hh, Gs, Hh, Gg, Gg, Gg, Gg, Gg, Gg, Hh, Mm, Mm
Mm^Xm, Mm^Xm, Mm, Mm^Xm, Mm, Mm, Mm^Xm, Mm^Xm, Mm^Xm, Mm^Xm, Mm^Xm, Mm^Xm, Hh, Hh, Re^Gvs, Re^Gvs, Re^Gvs, Re^Gvs, Re^Gvs, Re, Re^Gvs, Re^Gvs, Re, Re, Gs^Fds, Gs, Gd, Gs, Re^Gvs, Re, Re, Ww, Re^Gvs, Re^Gvs, Gg, Gs^Fms, Gg^Efm, Gs, Re^Gvs, Gg, Gs^Fds, Re, Gs^Fds, Gs^Fds, Gs^Fds, Gg^Efm, Gg^Efm, Gs^Fds, Gs, Gg, Hh, Hh, Gg, Gg, Gs, Hh, Gg, Gg^Fms, Gs, Gg, Hh, Hh^Fp, Mm, Mm
Mm^Xm, Mm^Xm, Mm, Mm, Mm, Mm, Mm, Mm^Xm, Mm^Xm, Mm^Xm, Mm, Mm^Xm, Mm, Hh, Hh, Re^Gvs, Re^Gvs, Re^Gvs, Re, Re, Gs, Gs, Re, Re, Gs^Fds, Gs^Fds, Gs^Fds, Gs, Re, Re, Wwf, Wwf, Re^Gvs, Re^Gvs, Gll, Gll^Fms, Gs^Fms, Re^Gvs, Re^Gvs, Re^Gvs, Re^Gvs, Rp, Gg, Gg, Gg, Gs, Gg, Gg, Gs^Vo, Gs, Gs, Gg^Efm, Gg, Gs, Gs, Gs, Gs^Vo, Gs^Fms, Gs, Hh, Hh, Mm, Mm, Mm
Mm^Xm, Mm, Mm, Mm, Mm^Xm, Mm, Mm, Mm^Xm, Mm, Mm, Mm^Xm, Mm, Mm^Xm, Mm, Hh, Re, Re^Gvs, Re^Gvs, Gg, Gs, Rr, Rr, Gs, Gs, Gs, Re^Gvs, Re^Gvs, Re, Re, Re^Gvs, Ww, Re, Gg, Gg, Gll^Fms, Gll^Fms, Gs^Fp, Gs^Fms, Gg, Re^Gvs, Rp, Rp, Re^Gvs, Re^Gvs, Re^Gvs, Gg, Gs, Gs, Gs, Gs, Gs, Gg, Gg, Gg, Gs, Gg, Gs, Gg, Hh^Fmw, Hh, Mm, Mm, Mm, Mm
Mm^Xm, Mm^Xm, Mm, Mm, Mm, Mm, Mm, Mm, Mm^Xm, Mm, Mm, Mm^Xm, Mm, Mm, Hh, Hh^Fms, Gg, Chr, 4 Khr, Chr, Rr, Gg^Efm, Gg, Gd, Re^Gvs, Re^Gvs, Re^Gvs, Re, Ww, Ww^Bw\, Rp, Re, Re, Gs^Fp, Re, Gg, Gg^Vo, Gg, Rr, Rr, Gg, Re^Gvs, Re^Gvs, Re^Gvs, Gg^Efm, Gg, Hh, Gs, Gg, Gs, Gs, Gs, Gs, Gg, Gs, Gs, Gg, Hh, Gs^Fms, Hh^Fms, Hh, Hh, Hh, Mm
Mm^Xm, Mm^Xm, Mm, Mm^Xm, Mm, Mm^Xm, Mm, Mm, Mm, Mm, Mm^Xm, Mm, Mm, Mm, Hh, Hh, Hh, Gg, Gg, Chr, Re, Gg^Vo, Re^Gvs, Gs^Fms, Gs^Fms, Re^Gvs, Ww, Ww, Gg^Efm, Gg, Gg, Gg, Gs^Fp, Re, Gg^Efm, Rr, Re, Gg^Efm, Re, Re, Gg, Chr, Gg^Efm, Gs^Fds, Gs^Fds, Gg, Hh, Hh, Gg, Gs, Gs, Gg, Gs, Gd^Vo, Gg, Gg, Co, Co, Co, Gg, Gs, Gs, Hh^Fp, Hh
Mm^Xm, Mm, Mm^Xm, Mm, Mm, Mm, Mm, Mm, Mm, Mm^Xm, Mm^Xm, Mm, Mm, Hh, Hh, Hh, Hh, Gg, Gs^Fp, Re, Re^Gvs, Re^Gvs, Re^Gvs, Re^Gvs, Ww, Ww, Gg, Gg, Gs^Fms, Gll^Fp, Gs^Fms, Gs^Fms, Gs^Fds, Gs^Fms, Gg, Gg^Efm, Gg, Re, Gg, Re, Re, Gg, Gg, Gg, Gg, Gg, Gg, Hh, Gg, Gg^Ecf, Gg^Efm, Gg, Gs, Gs, Gs, Gg, Co, 1 Ko, Co, Co, Gs, Hh, Gll^Fp, Gd^Fmw
Mm^Xm, Mm^Xm, Mm, Mm, Mm, Mm, Mm, Mm, Mm^Xm, Mm, Mm, Mm, Hh, Hh, Hh^Fms, Hh, Hh^Fms, Hh^Fms, Gs^Fp, Re, Re^Gvs, Gs^Fp, Ww, Ww, Re^Gvs, Re^Gvs, Re^Gvs, Gll^Fp, Gll, Gll^Fp, Gg^Efm, Gs^Fms, Gs, Gs^Fp, Gs, Gg, Gs^Fp, Gg^Efm, Gs^Fms, Gg, Gg, Rp, Rp, Gg^Efm, Re, Gg, Gg, Gg, Gs, Gg, Gg, Gg, Gg, Gg, Gs, Gg, Co, Co, Gg, Gs, Gs^Fp, Gg, Gg, Hh
Mm^Xm, Mm, Mm, Mm^Xm, Mm^Xm, Mm, Mm, Mm, Mm^Xm, Mm^Xm, Mm, Mm, Hh, Hh, Hh, Hh^Fms, Hh^Fms, Hh^Fms, Gg, Re, Re, Re^Gvs, Ww, Re^Gvs, Re^Gvs, Re^Gvs, Gll^Fp, Gll^Fp, Gll^Fms, Gg, Gs, Gs, Re, Re^Gvs, Re^Gvs, Gs, Gg, Gg, Gg, Gs^Fms, Gg, Re, Chr, Re, Rr, Rp, Re, Gs, Re, Gs, Gg, Gg, Re, Gg^Efm, Gg^Efm, Gg, Gg, Gg^Efm, Gg, Gs^Fp, Gs^Fp, Gg, Gs^Fp, Gg
Mm^Xm, Mm^Xm, Mm, Mm^Xm, Mm^Xm, Mm, Mm, Mm^Xm, Mm, Mm, Mm, Mm, Hh, Hh, Hh, Hh^Fms, Hh, Hh, Hh, Gg, Re, Re^Gvs, Ww, Re^Gvs, Gg, Gg, Gs^Fp, Gs^Fds, Gs^Fp, Gs, Re^Gvs, Re, Re^Gvs, Re^Gvs, Gg^Vc, Gs, Re^Gvs, Re^Gvs, Re^Gvs, Gs^Fds, Gs^Fms, Gg, Ch, Re, Gs^Fms, Gs^Fms, Gg^Efm, Rr, Gg^Vo, Re, Re, Re, Re, Rp, Rp, Rp, Re, Gg, Gs, Re, Re, Re, Re, Re
Ai, Mm^Xm, Mm^Xm, Mm, Mm, Mm, Mm, Mm, Mm, Mm, Mm^Xm, Mm, Mm, Mm^Xm, Mm^Xm, Hh, Hh, Hh^Fms, Ww, Ww, Ww, Ww^Bw\, Re, Gs^Fp, Gs^Fds, Gg, Gg^Efm, Gs^Fms, Re^Gvs, Re^Gvs, Re^Gvs, Re, Re^Gvs, Re^Gvs, Re^Gvs, Re^Gvs, Re^Gvs, Re^Gvs, Re^Gvs, Re^Gvs, Gs^Fms, Gg^Efm, Re, Re, Re, Gg, Gs, Gg^Efm, Gg, Gs, Gg, Gg, Gg, Gg, Gg, Re, Gg, Rp, Gs, Gg, Gs^Fp, Re, Gg^Efm, Re
Mm^Xm, Ai, Ai, Mm, Mm^Xm, Mm^Xm, Mm^Xm, Mm, Mm^Xm, Mm, Mm, Mm^Xm, Mm^Xm, Mm^Xm, Mm, Hh, Hh^Fms, Hh, Ww, Hh, Hh, Gg, Gg, Re, Gg, Gs^Fms, Gs^Fms, Gg, Gs^Fds, Re^Gvs, Re^Gvs, Re^Gvs, Re^Gvs, Re^Gvs, Re^Gvs, Re^Gvs, Re^Gvs, Re^Gvs, Gs, Gs^Fms, Re, Re, Re^Gvs, Re^Gvs, Re, Re^Gvs, Re^Gvs, Gs^Fms, Gs^Fms, Gs, Gg, Hh, Hh, Hh, Gg, Gg^Efm, Gg, Gs^Fp, Gll^Fp, Gg, Gs^Fp, Gs^Fp, Co, Gg
Mm^Xm, Mm^Xm, Mm^Xm, Ai, Ai, Mm, Mm^Xm, Mm, Mm^Xm, Mm^Xm, Mm^Xm, Mm, Mm, Mm^Xm, Mm, Mm, Hh, Hh, Ww, Hh, Hh^Fms, Hh, Hh, Re, Chr, Gg, Gg, Gs^Fms, Hh^Fms, Gs^Fp, Hh, Re^Gvs, Gg, Gs^Fms, Gs, Re^Gvs, Gs, Gs, Gd, Re, Re, Re^Gvs, Gg^Vo, Re^Gvs, Re^Gvs, Re^Gvs, Re^Gvs, Re^Gvs, Gg, Gg, Gg, Gg, Gg, Hh, Gg, Gg, Gs, Gs, Gs^Fms, Gll^Fp, Gg, Co, Co, Co
Mm^Xm, Mm^Xm, Mm, Mm, Mm^Xm, Ai, Ww, Mm^Xm, Mm^Xm, Mm, Mm^Vc, Mm, Mm, Mm, Mm, Hh, Ww, Ww, Hh, Hh, Hh^Fms, Hh, Chr, 5 Khr, Chr, Hh, Hh, Hh, Hh^Fms, Hh, Hh, Hh, Gs, Gll^Fp, Gll, Gs, Gs, Gs, Gd, Re, Re, Re^Gvs, Re^Gvs, Re^Gvs, Re^Gvs, Re^Gvs, Gg, Gg, Hh, Gg, Gg, Gg, Gg, Gg, Gg, Gg, Gg, Gll^Fp, Gs^Fds, Gs^Fms, Hh, Gg, Hh, Co
Mm^Xm, Mm^Xm, Mm, Mm^Xm, Mm, Mm^Xm, Ww, Mm^Xm, Ww, Mm, Ww, Mm, Mm, Mm, Ww, Ww, Mm^Xm, Mm^Xm, Mm, Hh, Hh, Hh, Hh, Hh, Mm, Hh, Mm, Hh, Hh, Hh, Hh, Hh, Hh, Gs, Gs, Gs, Gll, Gs, Gs, Gd, Gs, Re, Re^Gvs, Re^Gvs, Gg^Efm, Gg^Efm, Gg, Hh, Gg, Gg, Hh, Hh, Hh, Hh, Hh, Hh, Hh, Gg, Gll^Fp, Gg^Fp, Gs, Hh, Hh^Fmw, Hh
Mm^Xm, Mm^Xm, Mm^Xm, Mm, Mm, Mm, Mm^Xm, Ww, Wo, Ww, Wo, Ww, Ww, Ww, Mm, Mm, Mm, Mm^Xm, Mm, Mm, Mm, Mm, Mm, Mm, Mm, Hh, Hh, Hh, Mm, Hh, Mm, Hh, Hh, Hh, Hh, Gll^Fp, Gll, Gs, Gs, Gs, Gs, Gs, Gs^Fms, Gs^Fds, Chr, Gg, Gg, Hh, Hh, Hh, Gg, Hh, Hh, Hh, Hh^Fp, Gg, Gg, Gg, Hh, Hh^Fms, Hh, Gg, Hh, Hh^Fp
Mm^Xm, Mm^Xm, Mm^Xm, Mm, Mm, Mm, Mm^Vc, Ww, Wo, Wo, Mm, Wo, Wo, Ww, Mm, Mm^Xm, Mm, Mm, Mm, Mm, Mm^Xm, Mm^Xm, Mm, Mm^Xm, Mm^Xm, Mm, Hh, Mm, Mm, Mm^Vhh, Mm, Hh, Hh, Hh, Hh, Hh, Gs, Gs, Hh, Hh^Fds, Gg, Gg^Efm, Gs^Fms, Gg, Gg, Gg, Gg, Gg, Gg, Gg, Gg, Gg, Gg, Hh, Hh^Fp, Hh, Gg, Gg, Hh, Mm, Hh, Gg, Hh^Fp, Hh^Fp
Mm^Xm, Mm^Xm, Mm, Mm, Ai, Ai, Ww, Ww, Ww, Wo, Wo, Wo, Wo, Ww, Ww, Ww, Ww, Mm, Mm, Mm, Mm^Xm, Mm, Mm, Mm^Xm, Mm^Xm, Mm, Mm, Mm, Mm, Hh, Mm, Hh, Hh, Hh^Vo, Hh, Hh, Hh, Gg, Hh, Hh, Gg, Gg, Gs^Fds, Gg, Gg, Gg^Efm, Gg, Gg, Gg, Gg^Efm, Gg, Gg^Efm, Gg, Gg, Gg, Hh, Hh, Hh^Fp, Hh^Fp, Mm, Mm, Hh, Hh^Fp, Hh
Mm^Xm, Mm, Mm, Mm, Mm^Xm, Mm^Xm, Mm^Xm, Mm^Xm, Ww, Wo, Wo, Wo, Wo, Ww, Mm^Vc, Mm, Ai, Mm, Ww, Mm, Mm, Mm, Mm, Mm, Mm^Xm, Mm, Mm, Mm, Mm, Mm, Mm, Mm, Hh, Mm, Mm, Hh, Hh, Hh, Hh, Gg, Gg^Efm, Gg^Efm, Gg, Gg, Hh^Vo, Gg, Gg, Gs^Fds, Gs^Fp, Gg, Gs^Fds, Gg, Gg, Gg, Gll, Hh, Gg, Gg, Hh^Fp, Hh, Mm, Mm, Hh, Hh
Mm^Xm, Mm, Mm, Mm, Mm, Mm^Xm, Mm^Xm, Mm^Xm, Ww, Ww, Ww, Ww, Ww, Ww, Mm^Xm, Mm^Xm, Mm^Xm, Ww, Mm^Xm, Ww, Ai, Mm^Xm, Mm^Xm, Mm^Xm, Mm^Xm, Mm, Mm^Xm, Mm, Mm, Mm, Mm, Mm, Mm, Mm, Mm, Hh, Hh, Hh, Hh^Fds, Hh^Fds, Hh^Fms, Gg, Gg, Hh^Fds, Mm, Hh, Gs^Fms, Gs^Fms, Gs^Fds, Gs^Fds, Gg, Gs^Fds, Gll, Gll^Fp, Gll^Fds, Gg, Gg, Gg, Hh, Mm, Mm, Mm, Mm, Hh^Fp
Mm^Xm, Mm, Mm, Mm, Ai, Mm^Xm, Ww, Ww, Mm^Xm, Mm, Mm^Xm, Mm^Xm, Mm^Xm, Ww, Mm^Xm, Mm^Xm, Mm^Xm, Mm^Xm, Mm, Mm, Mm, Ai, Ai, Mm^Xm, Mm^Xm, Mm^Xm, Mm^Xm, Mm, Mm, Mm, Mm, Mm, Mm^Xm, Mm, Mm, Mm, Hh, Hh, Hh, Hh^Fds, Hh^Fds, Hh, Hh, Hh, Mm, Gg, Gg, Gg^Efm, Gg^Efm, Gll^Fp, Gg^Efm, Gll^Fp, Gll^Fp, Gll^Fms, Gll^Fds, Gll^Fms, Gg, Gg, Hh^Fp, Hh, Mm, Mm, Mm, Hh
Mm^Xm, Mm^Xm, Mm^Xm, Mm, Mm^Xm, Ai, Mm^Xm, Mm^Xm, Mm^Xm, Mm^Xm, Mm^Xm, Mm^Xm, Mm^Xm, Ww, Mm^Xm, Mm^Xm, Mm^Xm, Mm^Xm, Mm, Mm, Mm^Xm, Mm^Xm, Mm^Xm, Ww, Mm^Xm, Mm^Xm, Mm^Xm, Mm, Mm, Mm, Mm^Xm, Mm^Xm, Mm, Mm, Mm, Hh, Mm, Hh, Mm, Hh, Hh, Hh^Fms, Hh, Mm, Mm, Hh, Hh, Hh^Fds, Gg^Efm, Gg, Gs^Fms, Gg, Gll^Fms, Gll^Fds, Gll^Fds, Gll^Fms, Gs^Fms, Hh, Mm, Hh, Mm, Mm^Xm, Mm, Mm
Mm^Xm, Mm^Xm, Mm^Xm, Mm^Xm, Mm^Xm, Mm^Xm, Mm^Xm, Mm^Xm, Mm^Xm, Mm^Xm, Mm^Xm, Mm^Xm, Mm^Xm, Ww, Ai, Mm^Xm, Mm^Xm, Mm^Xm, Mm^Xm, Mm^Xm, Mm^Xm, Mm^Xm, Mm^Xm, Ai, Ai, Ww, Ww, Ai, Ai, Mm^Xm, Mm^Xm, Mm, Mm^Xm, Mm^Xm, Mm, Mm^Xm, Mm^Xm, Hh, Mm, Mm, Mm, Hh, Hh, Hh, Mm, Mm, Hh^Fds, Hh, Gg^Efm, Gg, Gs^Fms, Gs^Fms, Gll^Fms, Gll^Fp, Gll^Fms, Gll^Fp, Gll^Fp, Hh, Hh, Mm, Mm, Mm^Xm, Mm^Xm, Mm
Mm^Xm, Mm^Xm, Mm^Xm, Mm^Xm, Mm^Xm, Mm^Xm, Mm^Xm, Mm^Xm, Mm^Xm, Mm^Xm, Mm^Xm, Mm^Xm, Mm^Xm, Mm^Xm, Mm^Xm, Ai, Ai, Mm^Xm, Mm^Xm, Mm^Xm, Mm^Xm, Mm^Xm, Mm^Xm, Mm^Xm, Mm^Xm, Mm^Xm, Mm^Xm, Mm^Xm, Mm^Xm, Ai, Ai, Mm^Xm, Mm^Xm, Mm, Mm^Xm, Mm^Xm, Mm^Xm, Mm^Xm, Mm, Mm^Xm, Mm, Mm, Mm^Xm, Hh, Hh, Hh, Hh, Hh, Hh^Fds, Hh, Hh^Fds, Gs^Fp, Gll^Fp, Gll^Fp, Gg, Gg, Gll^Fp, Gg, Gg, Mm, Mm, Mm, Mm^Xm, Mm
Mm^Xm, Mm^Xm, Mm^Xm, Mm^Xm, Mm^Xm, Mm^Xm, Mm^Xm, Mm^Xm, Mm^Xm, Mm^Xm, Mm^Xm, Mm^Xm, Mm^Xm, Mm^Xm, Mm^Xm, Mm^Xm, Ai, Mm^Xm, Mm^Xm, Mm^Xm, Mm^Xm, Mm^Xm, Mm^Xm, Mm^Xm, Mm^Xm, Mm^Xm, Mm^Xm, Mm^Xm, Mm^Xm, Mm^Xm, Mm^Xm, Ai, Ai, Mm^Xm, Mm^Xm, Mm^Xm, Mm^Xm, Mm^Xm, Mm^Xm, Mm, Mm, Mm^Xm, Mm, Mm^Xm, Mm, Hh, Hh, Hh, Mm, Mm, Hh^Fds, Hh, Gg, Hh, Hh, Gg, Gg, Hh, Mm, Mm, Mm, Mm^Xm, Mm^Xm, Mm^Xm
Mm^Xm, Mm^Xm, Mm^Xm, Mm^Xm, Mm^Xm, Mm^Xm, Mm^Xm, Mm^Xm, Mm^Xm, Mm^Xm, Mm^Xm, Mm^Xm, Mm^Xm, Mm^Xm, Mm^Xm, Mm^Xm, Ai, Mm^Xm, Mm^Xm, Mm^Xm, Mm^Xm, Mm^Xm, Mm^Xm, Mm^Xm, Mm^Xm, Mm^Xm, Mm^Xm, Mm^Xm, Mm^Xm, Mm^Xm, Mm^Xm, Mm^Xm, Mm^Xm, Ai, Ai, Mm^Xm, Mm^Xm, Mm^Xm, Mm^Xm, Mm^Xm, Mm^Xm, Mm^Xm, Mm^Xm, Mm^Xm, Mm^Xm, Mm, Mm, Mm, Hh, Hh, Hh, Hh, Hh, Hh, Hh, Hh, Mm, Mm, Mm, Mm, Mm, Mm, Mm, Mm^Xm
