border_size=1
usage=map

Xos         , Xos         , Xos         , Xos         , Xos         , Xos         , Xos         , Xos         , Xos         , Xos         , Xos         , Xos         , Xos         , Xos         , Xu          , Xu          , Xu          , Xu          , Xu          , Xos         , Xos         , Xos         , Xos         , Xu          , Xu          , Xu          , Xu          , Xu          , Xu          , Xu          , Xu          , Xu          , Xu          , Xu          , Xu          , Ryd         , Ryd         , Ryd         , Ryd         , Xu          , Xu          , Xu          
Xos         , Xos         , Xos         , Xos         , Uu          , Xos         , Uu^Ii       , Xos         , Uu^Ii       , Xos         , Uu^Ii       , Xos         , Uu^Ii       , Xu          , Uu          , Xu          , Uu          , Xu          , Uu^Ii       , Xu          , Uu          , Xos         , Uh          , Xos         , Xos         , Xu          , Xu          , Xu          , Xu          , Xu          , Xu          , Xu          , Xu          , Xu          , Ryd         , Ryd         , Ryd         , Ryd         , Xu          , Xu          , Xu          , Xu          
Xos         , Xos         , Xos         , Xos         , Uu          , Ur          , Ur          , Ur          , Ur^Ii       , Ur^Ii       , Ur^Ii       , Ur^Ii       , Ur^Ii       , Ur^Ii       , Ur          , Ur          , Ur          , Ur          , Ur          , Ur^Ii       , Ur^Ii       , Ur          , Ur          , Uu          , Uu          , Xu          , Xu          , Xu          , Uh          , Xu          , Uh^Ii       , Xu          , Xu          , Xu          , Ryd         , Ryd         , Ryd         , Xu          , Xu          , Xu          , Xu          , Xu          
Xos         , Xos         , Xos         , Xos         , Uu^Ii       , Ur          , Uu          , Uu          , Xu          , Uu^Ii       , Xu          , Uu^Ii       , Xu          , Uu^Ii       , Xu          , Uu          , Xu          , Uu          , Xu          , Uu^Ii       , Xu          , Uu          , Uu          , Ur          , Ur          , Uh          , Uu          , Uu^Uf       , Uh          , Uu^Ii       , Uu^Ii       , Uu^Ii       , Uh          , Ryd         , Ryd         , 1 Ryd       , Ryd         , Xu          , Xu          , Xu          , Xu          , Xu          
Xos         , Xos         , Xos         , Xos         , Uu^Ii       , Ur^Ii       , Uu          , Xu          , Xu          , Xu          , Xu          , Xu          , Xu          , Xu          , Xu          , Xu          , Xu          , Xu          , Xu          , Xu          , Xu          , Xu          , Xos         , Uh          , Uh          , Ur          , Ur          , Uu          , Uu          , Uh          , Uh          , Uu^Ii       , Ryd^Ii      , Ryd         , Ryd         , Ryd         , Xu          , Xu          , Xu          , Xu          , Xu          , Xu          
Xos         , Xos         , Xos         , Xos         , Uu^Ii       , Ur^Ii       , Uu^Ii       , Xu          , Xu          , Xu          , Xu          , Xu          , Qxu         , Qxu         , Qxu         , Qxu         , Qxu         , Xu          , Xu          , Xu          , Xu          , Xos         , Xos         , Uh          , Uh          , Uu          , Uu          , Ur          , Ur          , Uh          , Ur          , Ryd^Ii      , Ur^Ii       , Ur          , Uu          , Uu          , Xu          , Xu          , Xu          , Xu          , Xu          , Xu          
Xos         , Xos         , Xos         , Xos         , Uu^Ii       , Ur^Ii       , Uu^Ii       , Xu          , Xu          , Xu          , Uu^Zb       , Xu          , Qxu         , Qxu         , Uu^Ii       , Qxu         , Qxu         , Xu          , Xu          , Xu          , Xu          , Xos         , Xos         , Xos         , Xos         , Xos         , Xos         , Uu          , Ur          , Ur          , Ur          , Ur^Ii       , Uh^Ii       , Uu^Ii       , Ryd         , Uh^Ii       , Xu          , Xu          , Xu          , Xu          , Xu          , Xu          
Xos         , Xos         , Xos         , Qxu^Ii      , Uu^Ii       , Ur          , Uu          , Xu          , Xu          , Xu          , Qxu         , Xu          , Qxu         , Qxu         , Qxu^Bs|     , Qxu         , Qxu         , Xu          , Xu          , Xu          , Xu          , Xu          , Xos         , Xos         , Xos         , Xos         , Uu^Uf       , Xos         , Ur          , Ur          , Uu^Uf       , Uu^Uf       , Uh^Ii       , Uu^Ii       , Uh^Ii       , Ryd         , Xu          , Xu          , Xu          , Xu          , Xu          , Xu          
Xos         , Xos         , Qxu         , Qxu^Ii      , Uu^Ii       , Ur          , Uu          , Qxu         , Xu          , Xu          , Qxu         , Xu          , Xu          , Qxu         , Qxu^Bs|     , Qxu         , Xu          , Xu          , Xu          , Xu          , Xu          , Xu          , Qxu         , Xos         , Uh          , Xos         , Uu^Uf       , Ur          , Ur          , Ur          , Uu^Uf       , Uu^Uf       , Xu          , Ryd^Ii      , Uh^Ii       , Uh^Ii       , Xu          , Ryd         , Uu          , Xu          , Xu          , Xu          
Xos         , Qxu         , Qxu         , Qxu         , Qxu         , Qxu^Bs|     , Qxu         , Qxu         , Qxu         , Qxu         , Xu          , Xu          , Xu          , Qxu         , Xu          , Qxu         , Xu          , Xu          , Xu          , Xu          , Xu          , Xu          , Qxu         , Xos         , Uu^Uf       , Uh          , Ryd         , Ur          , Qxu         , Qxu         , Xu          , Xu          , Xu          , Xu          , Xu          , Xu          , Xu          , Ryd         , Uu          , Xu          , Xu          , Xu          
Xos         , Qxu         , Qxu         , Qxu         , Qxu         , Qxu^Bs|     , Qxu         , Qxu         , Qxu         , Qxu         , Xu          , Xu          , Xos         , Xu          , Ryd         , Xu          , Xu          , Xu          , Xu          , Xu          , Xu          , Qxu         , Uh          , Uu^Uf       , Uu^Uf       , Ryd         , Uu^Uf       , Uh          , Qxu         , Xos         , Xu          , Xu          , Xu          , Xu          , Qxu         , Xu          , Xu          , Ryd         , Uu          , Xu          , Xu          , Xu          
Xos         , Qxu         , Qxu         , Qxu         , Qxu         , Qxu^Bs|     , Qxu         , Qxu         , Qxu         , Qxu         , Xu          , Xos         , Ryd         , Ryd         , Ryd         , Ryd         , Ryd         , Uu^Ii       , Xu          , Xu          , Xu          , Qxu         , Uu^Uf       , Uh          , Ryd         , Ryd         , Uh          , Uu^Uf       , Xos         , Xos         , Xu          , Xu          , Xu          , Xu          , Qxu         , Qxu         , Xu          , Ryd         , Uu          , Xu          , Xu          , Xu          
Xos         , Qxu         , Xos         , Qxu         , Ur          , Qxu^Bs|     , Uu          , Qxu         , Xu          , Qxu         , Xu          , Ryd         , Ryd         , Ryd         , Xu          , Ryd         , Ryd         , Ryd         , Ryd         , Xu          , Xu          , Uh          , Ryd         , Ryd         , Uu^Uf       , Uu^Uf       , Qxu         , Uh          , Xu          , Xu          , Xu          , Xu          , Xu          , Qxu         , Qxu         , Uu          , Uu          , Ryd         , Ryd         , Xu          , Xu          , Xu          
Xu          , Xos         , Xos         , Xos         , Ur          , Ryd         , Ur          , Xu          , Xu          , Xu          , Xu          , Ryd         , Ryd         , Xu          , Qxv         , Xu          , Xu          , Ryd         , Ryd         , Ryd         , Ryd         , Xu          , Xu          , Uh          , Uu^Uf       , Uh          , Qxu         , Xu          , Xu          , Xu          , Xu          , Xu          , Xu          , Xu          , Qxu         , Qxu         , Uu          , Uu          , Ryd         , Qxu         , Xu          , Xu          
Xu          , Xu          , Xu          , Xu          , Uu^Ii       , Ryd         , Uu^Ii       , Uh          , Xu          , Xu          , Xos         , Ryd         , Ryd         , Xu          , Qxv         , Qxv         , Uu          , Xu          , Xu          , Ryd         , Ryd         , Ryd         , Ryd         , Xu          , Xu          , Uh          , Xu          , Qxu         , Xu          , Xu          , Xu          , Xu          , Xu          , Qxu         , Uu          , Qxu         , Uu          , Uu          , Ryd         , Qxu         , Xu          , Xu          
Xu          , Xu          , Uu^Ii       , Uh          , Uu^Ii       , Zw          , Uh^Ii       , Uu^Ii       , Uh^Ii       , Xu          , Xu          , Ryd         , Ryd         , Xu          , Uu          , Uu          , Uu          , Uu          , Qxv         , Xu          , Xu          , Ryd         , Ryd         , Ryd         , Ryd         , Xos         , Xos         , Xu          , Xu          , Xu          , Xu          , Xu          , Xu          , Qxu         , Qxu         , Qxu^Bs\     , Ryd         , Ryd         , Qxu         , Qxu         , Qxu         , Xu          
Xu          , Xu          , Uh          , Uu^Ii       , Uh          , Ryd         , Uh^Ii       , Uh          , Uh^Ii       , Uh          , Xu          , Ryd         , Ryd         , Xu          , Xu          , Uu          , Xu          , Qxv         , Xu          , Qxv         , Xu          , Xu          , Xu          , Ryd         , Ryd         , Ryd         , Xos         , Xu          , Xu          , Xu          , Xu          , Xu          , Xu          , Xu          , Qxu         , Ryd         , Uu          , Qxu         , Qxu^Bs/     , Uu          , Qxu         , Qxu         
Xu          , Xu          , Uh          , Uh^Ii       , Uh          , Ryd^Ii      , Zw^Ii       , Uh          , Uh          , Uh          , Xu          , Ryd         , Ryd         , Xu          , Ryd         , Xu          , Ryd         , Xu          , Ryd         , Xu          , Ryd         , Xu          , Ryd         , Xu          , Ryd         , Ryd         , Xos         , Xu          , Xu          , Xu          , Xu          , Xu          , Xu          , Xu          , Xu          , Ryd         , Xu          , Uu          , Uu          , Qxu         , Qxu         , Qxu         
Xu          , Xu          , Uh          , Uh^Ii       , Uh          , Uu^Uf       , Ryd^Ii      , Uu^Ii       , Uh          , Xu          , Xu          , Ryd         , Ryd         , Ryd         , Ryd         , Ryd         , Ryd         , Ryd         , Ryd         , Ryd         , Ryd         , Ryd         , Ryd         , Ryd         , Ryd         , Ryd         , Xos         , Xu          , Xu          , Xu          , Xu          , Xu          , Xu          , Ryd         , Xu          , Xu          , Xu          , Qxu         , Qxu         , Qxu         , Qxu         , Qxu         
Xu          , Xu          , Xu          , Uh          , Xu          , Xu          , Ryd         , Uu^Uf       , Xu          , Xu          , Ryd         , Ryd         , Xos         , Xos         , Xu          , Xu          , Uu^Ii       , Xu          , Xu          , Xu          , Xu          , Xu          , Xu          , Xu          , Xos         , Xos         , Xu          , Xu          , Xu          , Xu          , Xu          , Ryd         , Xu          , Xu          , Xu          , Xu          , Xu          , Xu          , Qxu         , Qxu         , Qxu         , Qxu         
Xu          , Xu          , Xu          , Xu          , Xu          , Xu          , Ryd         , Xu          , Xu          , Xos         , Xos         , Xos         , Xu          , Xu          , Xu          , Xu          , Xu          , Xu          , Qxv         , Uu          , Ur          , Ur          , Ur          , Uu          , Xos         , Xu          , Xu          , Xu          , Qxu         , Xu          , Xu          , Xu          , Xu          , Xu          , Qxu         , Xu          , Xu          , Xu          , Xu          , Qxu         , Qxu         , Qxu         
Xu          , Xu          , Xu          , Xu          , Xu          , Xu          , Ur          , Uu^Uf       , Uu^Uf       , Xu          , Xu          , Xu          , Xu          , Xu          , Xu          , Xu          , Xu          , Xu          , Qxv         , Uu          , Ur          , Qxv         , Uu          , Ur          , Xos         , Xu          , Xu          , Xu          , Qxu         , Qxu         , Xu          , Ryd         , Xu          , Qxu         , Qxu         , Xu          , Xu          , Xu          , Xu          , Qxu         , Qxu         , Qxu         
Xu          , Xu          , Xu          , Uu^Ii       , Uu          , Ur          , Ur          , Ur          , Xu          , Xu          , Xu          , Xu          , Xu          , Xu          , Xu          , Xu          , Xu          , Qxv         , Qxv         , Uu          , Ur          , Qxv         , Uu          , Ur          , Uu          , Xos         , Xu          , Xu          , Qxu         , Qxu         , Qxu         , Xu          , Qxu         , Qxu         , Qxu         , Xu          , Xu          , Xu          , Uu          , Xu          , Qxu         , Qxu         
Xu          , Xu          , Xu          , Xu          , Xu          , Ur          , Xu          , Xu          , Xu          , Xu          , Xu          , Xu          , Xu          , Xu          , Xu          , Xu          , Xu          , Qxv         , Qxv         , Uu          , Ur          , Qxv         , Qxv         , Uu^Uf       , Uu          , Xos         , Xu          , Xu          , Qxu         , Qxu         , Qxu         , Qxu^Bs|     , Qxu         , Qxu         , Qxu         , Xu          , Uu          , Uu          , Uu          , Xu          , Xu          , Qxu         
Xu          , Xu          , Xu          , Xu          , Xu          , Uu          , Xu          , Xu          , Xu          , Xu          , Uh^Ii       , Xu          , Qxv         , Xu          , Xu          , Xu          , Xu          , Qxv         , Qxv         , Uu          , Ur          , Uu          , Uu          , Uu^Uf       , Uu          , Qxv         , Xu          , Xu          , Qxu         , Qxu         , Qxu         , Uu^Ii       , Qxu         , Qxu         , Qxu         , Xu          , Xu          , Uu          , Xu          , Xu          , Xu          , Xu          
Xu          , Xu          , Xu          , Xu          , Xu          , Xu          , Qxv         , Rd^Ii       , Rd^Ii       , Uu^Ii       , Uu^Ii       , Uh^Ii       , Qxv         , Qxv         , Xu          , Xu          , Xu          , Xu          , Qxv         , Qxv         , Qxv         , Ur          , Uu          , Ur          , Ur          , Qxv         , Qxv         , Xu          , Xu          , Qxu         , Qxu         , Qxu         , Qxu         , Qxu         , Qxu         , Xu          , Xu          , Xu          , Xu          , Xu          , Xu          , Xu          
Xu          , Xu          , Qxv         , Xu          , Qxv         , Qxv         , Qxv         , Uu^Ii       , Uu^Ii       , Ryd^Ii      , Uu^Ii       , Uu^Ii       , Qxv         , Qxv         , Qxv         , Xu          , Xu          , Xu          , Xu          , Uh          , Qxv         , Uu          , Uu^Uf       , Ur          , Uh          , Ur          , Qxv         , Xu          , Xu          , Qxu         , Qxu         , Qxu         , Qxu         , Qxu         , Xu          , Xu          , Xu          , Ryd         , Xu          , Xu          , Xu          , Xu          
Xu          , Xu          , Xu          , Qxv         , Qxv         , Qxv         , Qxv         , Uh^Ii       , Uh^Ii       , Uu^Ii       , Qxv         , Qxv         , Qxv         , Qxv         , Xu          , Xu          , Xu          , Qxv         , Xu          , Uh          , Uh          , Uh          , Uh          , Uu^Uf       , Ur          , Ur          , Ur          , Qxv         , Xu          , Xu          , Xu          , Xu          , Xu          , Xu          , Xu          , Xu          , Xu          , Ryd         , Xu          , Xu          , Xu          , Xu          
Xu          , Xu          , Xu          , Xu          , Qxv         , Qxv         , Xu          , Qxv         , Qxv         , Qxv         , Qxv         , Qxv         , Xu          , Xu          , Xu          , Xu          , Xu          , Qxv         , Uu^Uf       , Xu          , Uh          , Ur          , Ur          , Uu^Uf       , Xu          , Xu          , Uh          , Uh          , Xu          , Xu          , Xu          , Xu          , Qxv         , Xu          , Xu          , Xu          , Xu          , Ryd         , Ryd         , Xu          , Xu          , Xu          
Xu          , Xu          , Xu          , Xu          , Xu          , Xu          , Xu          , Xu          , Qxv         , Qxv         , Xu          , Xu          , Xu          , Xu          , Qxv         , Xu          , Ur          , Re^Uf       , Uu^Uf       , Uu^Ii       , Uh          , Ur          , Uh          , Uh          , Uh          , Uu^Uf       , Uh          , Uh          , Ur          , Uh          , Uh^Ii       , Qxv         , Xu          , Xu          , Xu          , Xu          , Xu          , Xu          , Xu          , Ryd         , Xu          , Xu          
Xu          , Xu          , Xu          , Xu          , Xu          , Xu          , Xu          , Xu          , Xu          , Xu          , Xu          , Xu          , Xu          , Qxv         , Uh^Ii       , Uh          , Ur          , Ur          , Re^Uf       , Uh          , Ur          , Ur          , Ur          , Ur          , Ur          , Ur          , Uu          , Xu          , Ur          , Uh          , Uh^Ii       , Qxv         , Xu          , Xu          , Xu          , Xu          , Xu          , Xu          , Xu          , Ryd         , Ryd         , Xu          
Xu          , Xu          , Xu          , Xu          , Xu          , Xu          , Xu          , Xu          , Xu          , Xu          , Xu          , Xu          , Uu^Ii       , Uu^Ii       , Uh^Ii       , Uh          , Uh          , Ur          , Uu          , Uh          , Ur          , Uh          , Uu          , Ur          , Ur          , Uu          , Uu^Ii       , Uh          , Ur          , Ur          , Uu^Ii       , Qxv         , Xu          , Xu          , Xu          , Xu          , Xu          , Xu          , Xu          , Xu          , Xu          , Ryd         
Xu          , Xu          , Xu          , Xu          , Xu          , Xu          , Xu          , Xu          , Xu          , Xu          , Xu          , Qxu         , Uh          , Uu^Ii       , Uh          , Uh^Ii       , Uh^Ii       , Uu^Ii       , Uu^Ii       , Uu^Uf       , Re^Uf       , Uu^Ii       , Ur^Ii       , Ur^Ii       , Ur          , Uu^Uf       , Uu^Ii       , Uu^Ii       , Uh          , Ur          , Uh          , Xu          , Xu          , Xu          , Uh          , Uu^Uf       , Xu          , Xu          , Xu          , Xu          , Xu          , Xu          
Xu          , Xu          , Xu          , Xu          , Xu          , Xu          , Xu          , Xu          , Xu          , Xu          , Xu          , Qxu         , Uh          , Uu^Uf       , Uu^Uf       , Uu^Uf       , Uh          , Uu^Ii       , Uu^Ii       , Re^Uf       , Re^Uf       , Ur^Ii       , Uh^Ii       , Uu^Ii       , Ur          , Ur          , Uu^Ii       , Uh^Ii       , Uh^Ii       , Ur          , Uh          , Xu          , Qxu         , Qxu         , Uh          , Uh          , Xu          , Xu          , Xu          , Xu          , Xu          , Xu          
Xu          , Xu          , Xu          , Xu          , Xu          , Xu          , Xu          , Xu          , Xu          , Xu          , Xu          , Xu          , Uh          , Uu^Uf       , Uh          , Uh          , Uu          , Uh^Ii       , Uh          , Uu^Uf       , Uu          , Uu^Ii       , Uh^Ii       , Uh^Ii       , Ur^Ii       , Ur^Ii       , Uu^Ii       , Uh^Ii       , Uh^Ii       , Uh          , Uu^Ii       , Xu          , Qxu         , Uh          , Uu          , Uu^Uf       , Xu          , Xu          , Xu          , Xu          , Xu          , Xu          
Xu          , Xu          , Xu          , Xu          , Xu          , Xu          , Xu          , Xu          , Xu          , Xu          , Xu          , Xu          , Ur          , Uh          , Uh          , Uh          , Uu^Ii       , Uu^Ii       , Uh          , Uh          , Uh          , Ur          , Ur^Ii       , Uh^Ii       , Ur^Ii       , Ur^Ii       , Uu^Ii       , Uh^Ii       , Uu^Ii       , Uh^Ii       , Uh          , Qxu         , Uu          , Uu^Uf       , Uu^Uf       , Xu          , Xu          , Xu          , Xu          , Xu          , Xu          , Xu          
Xu          , Xu          , Xu          , Xu          , Xu          , Xu          , Uu^Uf       , Ur          , Ur          , Ur          , Ur          , Xu          , Uu^Ii       , Ur          , Uh          , Uh          , Uh^Ii       , Uu^Ii       , Uu^Ii       , Uh^Ii       , Re^Uf       , Uu          , Ur^Ii       , Uu^Ii       , Uu          , Ur          , Ur          , Uu          , Uu^Uf       , Uu^Uf       , Uh          , Qxu^Bs/     , Qxu         , Uu          , Xu          , Xu          , Uu^Uf       , Xu          , Uh          , Xu          , Uh          , Xu          
Xu          , Xu          , Xu          , Xu          , Xu          , Xu          , Ur          , Ur          , Xu          , Uu^Uf       , Ur          , Xu          , Uh^Ii       , Ur^Ii       , Uh^Ii       , Uh          , Uh^Ii       , Uh          , Uu^Ii       , Uh^Ii       , Re^Uf       , Re^Uf       , Uu^Ii       , Uu^Ii       , Uh^Ii       , Uh^Ii       , Ur          , Ur          , Uh^Ii       , Re^Uf       , Uu^Uf       , Qxu         , Qxu         , Uh          , Xu          , Uu          , Ryd         , Uh          , Uu^Uf       , Uu^Uf       , Rd          , Ryd         
Xu          , Xu          , Uu^Uf       , Uh          , Ur          , Ur          , Ur          , Xu          , Xu          , Xu          , Xu          , Xu          , Qxv^Ii      , Uh^Ii       , Ur^Ii       , Uh^Ii       , Uh^Ii       , Uh          , Uh          , Uh          , Ur          , Uu          , Uu^Ii       , Uh^Ii       , Uu^Ii       , Uu^Ii       , Uu^Ii       , Ur          , Uh^Ii       , Uu^Ii       , Uu^Uf       , Uh          , Qxu         , Uu^Ii       , Xu          , Ryd         , Uu^Uf       , Rd          , Rd          , Re          , Uh          , Uu          
Xu          , Xu          , Ur          , Ur          , Uh          , Uh          , Xu          , Xu          , Xu          , Xu          , Xu          , Xu          , Qxv^Ii      , Qxv^Ii      , Qxv^Ii      , Ur^Ii       , Uh^Ii       , Uh          , Uu          , Uu          , Uu^Ii       , Ur^Ii       , Ur          , Ur          , Ur          , Re^Uf       , Uu^Uf       , Uh^Ii       , Uh          , Uh          , Uh          , Uu          , Uh          , Uh          , Xu          , Re^Uf       , Re^Uf       , Uu^Uf       , Re^Uf       , Uu^Uf       , Re^Uf       , Uu^Uf       
Uu          , Uu^Uf       , Ur          , Xu          , Xu          , Xu          , Xu          , Xu          , Qxv^Ii      , Xu          , Qxv^Ii      , Qxv^Ii      , Qxv^Ii      , Qxv^Ii      , Qxv^Ii      , Qxv^Ii      , Qxv         , Uu          , Qxv         , Uu^Ii       , Qxv         , Uu^Ii       , Uu          , Uu          , Qxv         , Uu^Uf       , Qxv         , Uu^Uf       , Qxv         , Uh          , Qxv         , Qxv         , Qxv         , Qxv         , Qxv         , Xu          , Xu          , Xu          , Xu          , Xu          , Xu          , Re          
Ur          , Ur          , Xu          , Xu          , Xu          , Xu          , Qxv^Ii      , Qxv^Ii      , Qxv^Ii      , Qxv^Ii      , Qxv^Ii      , Qxv^Ii      , Qxv^Ii      , Qxv^Ii      , Qxv^Ii      , Qxv         , Qxv         , Qxv         , Qxv         , Qxv         , Qxv         , Xu          , Xu          , Qxv         , Qxv         , Qxv         , Qxv         , Qxv         , Xu          , Xu          , Xu          , Qxv         , Qxv         , Qxv         , Qxv         , Qxv         , Qxv         , Xu          , Xu          , Xu          , Xu          , Xu          
