Xu, Xu, Xu, Xu, Xu, Xu, Xu, Xu, Xu, Xu, Xos, Xos, Xos, Xu, Xu, Xu, Xuc, Xu, Xu, Xos, Xos, Xos, Xos, Xos, Xos, Xos, Xos, Xos, Xu, Xu, Xu, Xu, Xu, Xu, Xu, Urb, Urb, Urb, Urb, Xu, Xu, Xu, Xu, Xu
Xu, Xu, Xu, Xu, Xu, Xu, Xu, Xu, Xos, Xos, Xos, Xos, Xuc, Xuc, Xuc, Xuc, Uu, Xu, Uu^Ii, Xu, Uu, Xos, Uh, Xos^Efs, Xos^Efs, Xos, Xu, Xu, Xuc, Xu, Xuc, Xu, Xu, Xu, Urb, Urb, Urb, Urb, Xu, Xu, Xu, Xu, Xu, Xu
Xos, Xu, Xu, Xu, Xu, Xu, Xos, Xos, Xos^Efs, Xos^Efs, Ur, Ur, Ur^Ii, Cud, Ur, Ur, Ur, Ur, Ur, Ur^Ii, Ur^Ii, Ur, Ur, Uu, Uu, Xu, Xu, Xuc, Uh, Xuc, Uh^Ii, Xu, Xu, Xu, Urb, Urb, Urb, Xu, Xu, Xu, Xu, Xu, Xu, Xu
Xos, Xos, Xos, Xu, Xos, Xos, Xos, Xos, Uu, Cud, 5 Kud, Cud, Uu, Uu^Ii, Uu, Uu^Uf, Uu, Uu, Uu, Uu^Ii, Xu, Uu, Uu^Em, Ur, Ur, Uh, Uu, Uu^Uf, Uh, Uu^Ufi, Uu^Ufi, Uu^Ii, Uh, Urb, Urb, 1 Urb, Urb, Xu, Xu, Xu, Xu, Xu, Xu, Xu
Xos, Xos, Xos, Xos, Xos, Xos, Uu^Uf, Uu^Uf, Uu, Cud, Uu, Cud, Uu, Cud, Uu^Uf, Uu^Uf, Xuc, Uu^Uf, Xu, Xu, Xu, Xuc, Xuc, Uh, Uu^Uf, Ur, Ur, Uu^Em, Uu, Uh, Uh, Uu^Ii, Urb^Ii, Urb, Urb, Urb, Xu, Xu, Xu, Xu, Xu, Xu, Xu, Xu
Xos, Xos, Xos, Xos, Xos^Efs, Cud, Uu, Uu^Uf, Uh, Uu, Uh, Uu, Cud, Uu, Uu^Uf, Uu, Xuc, Xu, Xu, Xu, Xu, Xu, Xuc, Uh, Uu^Uf, Uu, Uh, Ur, Ur, Uh, Ur, Urb^Ii, Ur^Ii, Ur, Uu, Uu, Xuc, Xu, Xu, Xu, Xu, Xu, Xu, Xu
Xos, Xos, Xos, Xos^Efs, Wog, Wwg, Wwg, Uu^Ii, Uu, Uu, Cud, Uh, Xos, Xos, Xos, Xu, Xu, Xu, Xu, Xu, Xu, Xu, Xu, Xu, Xu, Xu, Xu, Uu^Uf, Uu, Ur, Ur, Ur^Ii, Uh^Ii, Uu^Ii, Uh^Ii, Uh^Ii, Xuc, Xu, Xu, Xu, Xu, Xu, Xu, Xu
Xos, Xos, Xos^Efs, Uu, Uu, Wwf, Wwrg, Wwf, Wwg, Wwf, Wwg, Xos^Efs, Xos^Efs, Xos, Xos, Xos, Xos, Xu, Xu, Xu, Xos, Xos, Xos, Xu, Xuc, Xu, Xu, Uh, Uu^Uf, Uu^Em, Uu^Uf, Uu^Uf, Uh^Ii, Uu^Ii, Uh^Ii, Uh^Ii, Xuc, Xu, Xu, Xu, Xu, Xu, Xu, Xu
Xu, Xos^Efs, Uh, Uh, Uu^Em, Ur, Ur, Wwrg, Wwg, Wwf, Wog, Wog, Wog, Xos, Xos, Xos, Xu, Xu, Xu, Xos, Xos, Xos, Xos, Xos, Uh, Xuc, Xu, Xu, Xu, Uh, Xu, Uu^Uf, Xu, Uh^Ii, Xu, Xuc, Xu, Xu, Xu, Xu, Xu, Xu, Xu, Xu
Xu, Xu, Uh, Uh, Ur, Uu^Em, Xu, Ur, Wwf, Wog, Xu, Xu, Xuc, Xu, Xuc, Xu, Xu, Xu, Xu, Xos, Xos, Xu, Uh, Xos^Efs, Uu^Uf, Uh, Uu^Uf, Xu, Uh, Xu, Xu, Xu, Xu, Xu, Xu, Xu, Xu, Xu, Xu, Xu, Xu, Xu, Xu, Xu
Xu, Xuc, Uu, Uu^Uf, Ur, Xuc, Xuc, Uh, Ur, Wwrg, Xu, Xuc, Wog, Xuc, Wwf, Xu, Xuc, Xuc, Xu, Xu, Xu, Uh, Uh, Uu^Uf, Uu^Uf, Ur, Uu^Uf, Uh, Ur^Br\, Xos, Xos, Xu, Xu, Xu, Xu, Xu, Xu, Xu, Xu, Xu, Xu, Xu, Xu, Xu
Xu, Xuc, Xuc, Ur, Uu^Uf, Uu^Uf, Xuc, Ur, Uu^Uf, Uu^Uf, Xu, Xos, Wwg, Wwg, Wwf, Urb, Urb, Uu^Ii, Xuc, Xu, Xu, Uh, Uu^Uf, Uh, Ur, Ur, Uh, Uu^Uf, Xos, Xos^Uov, Xos^Uov, Xu, Xu, Xu, Xu, Xu, Xu, Xu, Xu, Xu, Xu, Xu, Xu, Xu
Xu, Xuc, Xuc, Ur, Ur, Ur, Ur, Uu, Uh, Xos, Xos, Rb, Urb, Wwrg, Urb, Urb, Urb, Urb, Rb, Xuc, Xu, Uh, Urb, Urb, Uu^Uf, Uu^Uf, Uh, Uh, Xu, Xos, Xu, Xu^Uov, Xu, Xu, Xu, Xu, Xu, Xu, Xu, Xu, Xu, Xu, Xu, Xu
Xu, Xu, Xu, Xuc, Ur, Urb, Ur, Uh, Uu^Uf, Xu, Xu, Rb, Urb, Urb, Xu, Xu, Xu, Urb, Rb, Rb, Rb^Ii, Rb, Urb, Uh, Uu^Uf, Uh, Uh, Xuc, Xuc, Xu, Xu, Xu^Gov, Xu, Xu, Xu, Xu, Xu, Xu, Xu, Xu, Xu, Xu, Xu, Xu
Xu, Xu, Xuc, Xu, Uu^Ii, Urb, Uu^Ii, Uh, Uh, Xos, Xos, Urb, Urb, Urb, Xu, Rb, Urb^Ii, Xu, Xu, Urb, Urb, Urb, Urb, Xu, Xu, Uh, Xu, Uh, Xuc, Xu, Xu, Xu^Uov, Xu, Xu, Xu, Xu, Xu, Xu, Xu, Xu, Xu, Xu, Xu, Xu
Xu, Xuc, Uu^Ii, Uh, Uu^Ii, Uh, Uh^Ii, Uu^Ii, Uh^Ii, Xu, Xu, Rb, Rb, Urb, Xu, Rb, Urb^Ii, Urb^Ii, Rb, Xu, Xu, Urb, Urb, Urb, Urb, Xu, Xos, Xu, Xu, Xu, Xu, Xu^Gov, Xu, Xu, Xu, Xu, Xu, Xu, Xu, Xu, Xu, Xu, Xu, Xu
Xu, Xuc, Uh, Uu^Ii, Uh, Urb, Uh^Ii, Uh, Uh^Ii, Xos, Xos, Urb^Ii, Rb, Urb, Xu, Urb, Xu, Urb, Xu, Urb^Ii, Xu, Xu, Urb, Rb, Urb, Urb, Xos, Xos, Xu, Xu, Xu, Xu^Uov, Xu^Gov, Xu, Xu, Xu, Xu, Xu, Xu, Xu, Xu, Xu, Xu, Xu
Xu, Xu, Uh, Uh^Ii, Uh, Ur, Ur, Uh, Uh, Xu, Xu, Urb, Urb, Urb, Urb, Xu, Rb, Xu, Urb, Xu, Urb, Urb, Rb, Urb^Ii, Urb, Urb, Xos, Xos, Xu, Xu, Xu, Xu, Xu^Uov, Xu, Xu, Xu, Xu, Xu, Xu, Xu, Xu, Xu, Xu, Xu
Xu, Xu, Uh, Uh^Ii, Uh, Uu^Uf, Ur, Uu^Ii, Uh, Xu, Xu, Rb, Urb, Urb, Urb, Rb, Rb, Rb, Urb, Urb, Urb, Rb, Rb, Urb, Urb, Rb, Xos, Xos, Xu, Xu, Xuc, Xu, Xuc^Gov, Xu, Xu, Xu, Xu, Xu, Xu, Xu, Xu, Xu, Xu, Xu
Xu, Xu, Xu, Uh, Xu, Xu, Urb, Uu^Uf, Xos, Xos, Urb, Urb, Xos, Xos, Xos, Xu, Xu, Xu, Xos, Xos, Xos, Xos, Xos, Xos, Xos, Xos, Xos, Xos, Xu, Wog^Xo, Wog^Xo, Xuc, Ur^Em, Xuc, Xuc, Xu, Xuc, Xu, Xu, Xu, Xuc, Xu, Xu, Xu
Xu, Xu, Xu, Xu, Xu, Xuc, Urb, Xos, Xos, Xos, Xos, Xos, Xos, Xos, Xos, Xu, Xos, Xos, Qxu, Uu, Ur, Ur, Ur, Uu, Xos, Xos, Xu, Xu, Xu, Xu, Xuc, Wog, Wwrg, Uh, Xu, Xu, Uh, Xuc, Xuc, Uu, Uu^Uf, Xu, Wog, Wog
Xu, Xu, Xuc, Xu, Xuc, Xuc, Ur, Uu^Uf, Uu^Uf, Xos, Xos, Xos, Xos, Xos, Xos, Xos, Xuc, Xuc, Qxu, Uu, Ur, Qxu, Uu, Ur, Qxu, Xu, Xu, Xu, Xu, Xu, Xu, Ur, Xuc, Wwrg, Wwrg, Wwg, Wwg, Xu, Wog, Uh, Wog, Wog, Xu, Xu
Xu, Xu, Xuc, Uu^Ii, Uu, Ur, Ur, Ur, Qxu, Xu, Xu, Xos, Xos, Xos, Xu, Xu, Xuc, Qxu, Qxu, Uu, Ur, Qxu, Uu, Ur, Uu, Qxu, Xu, Xu, Xuc, Xuc, Uu^Uf, Uu^Uf, Uu^Uf, Uh, Xu, Xu, Xu, Wog, Xu, Wog, Uh, Xu, Xu, Xu
Xu, Xu, Xu, Xuc, Xuc, Qxu, Qxu, Qxu, Qxu, Xu, Xu, Xu, Xu, Xu, Xu, Xu, Xu, Qxu, Qxu, Uu^Ii, Ur^Ii, Qxu, Qxu, Uu^Uf, Uu, Qxu, Xu, Xu, Xuc, Uh, Uu^Uf, Ur, Uu, Xu, Xu, Xu, Xu, Xu, Xu, Uh, Xu, Xu, Xu, Xu
Xu, Xu, Xu, Xu, Xu, Qxu^Xo, Qxu^Xo, Qxu^Xo, Xu, Xu, Xu, Xu, Xu, Xu, Xu, Xu, Xu, Qxu, Qxu, Uu, Ur, Uu, Uu^Em, Uu^Uf, Uu, Qxu, Xuc, Xu, Xu, Uh, Uu, Ur^Ii, Uu, Xu, Xu, Xu, Xu, Xu, Xuc, Xuc, Xu, Xu, Xu, Xu
Xu, Xu, Xu, Xu, Qxu, Qxu, Qxu, Qxu, Xu, Xu, Xu, Xu, Xu, Xu, Xu, Xu, Xu, Xu, Qxu, Qxu, Qxu, Ur, Uu, Ur, Ur^Ii, Qxu, Qxu, Xuc, Xu, Uh, Uu, Uu^Uf, Xu, Xuc, Xu, Xu, Xu, Xu, Xu, Xu, Xu, Xu, Xu, Xu
Xu, Xu, Xu, Qxu, Xu, Qxu, Xu, Xu, Xu, Xu, Xu, Xu, Xu, Xu, Xu, Xu, Xu, Xuc, Xuc, Uh, Qxu, Uu^Em, Uu^Uf, Ur, Uh, Ur, Qxu, Xuc, Xu, Xuc, Uh, Xu, Xu, Xu, Xuc, Xuc, Xuc, Xu, Xu, Xu, Xu, Xu, Xu, Xu
Xu, Xu, Xu, Xu, Xu, Xu, Xu, Xu, Xu, Xu, Xu, Xu, Xu, Xu, Xu, Xu, Xu, Qxu, Xuc, Uh, Uh, Uh, Uh, Uu^Uf, Ur, Ur, Ur, Xu, Xu, Xuc, Xu, Xu, Xuc, Xuc, Wog^Xo, Wog, Xu, Xuc, Xu, Xu, Xu, Xuc, Xu, Xu
Xu, Xu, Xu, Xu, Xu, Xu, Xu, Xu, Xu, Xu, Xu, Xu, Xu, Xu, Xu, Xu, Xu, Qxu, Uu^Uf, Xuc, Uh, Ur^Em, Ur, Uu^Uf, Xu, Xuc, Uh, Uh, Xu, Xu, Xu, Xuc, Wwg, Wog, Xu, Xu, Xu, Xu, Xu, Xuc, Xu, Xu, Xu, Xu
Xu, Xu, Xu, Xu, Xu, Xu, Xu, Xu, Xu, Xu, Xu, Xu, Xu, Xu, Qxu, Xuc, Ur^Em, Re^Uf, Uu^Uf, Uu^Ii, Uh, Ur, Uh, Uh, Uh, Uu^Uf, Uh, Uh, Ur, Uh, Wwg, Wwg, Xu, Xu, Xu, Xu, Xu, Xu, Xu, Xuc, Xu, Xu, Xu, Xu
Xu, Xu, Xu, Xu, Xu, Xu, Xu, Xu, Xu, Xu, Xu, Xu, Xu, Qxu, Uh, Uh, Ur^Emf, Ur^Em, Re^Uf, Uh, Ur, Ur, Ur, Ur, Ur, Ur, Uu, Xu, Wwrg, Wwg, Uh^Ii, Xu, Xu, Xu, Xu, Xu, Xu, Xu, Xu, Xu, Xu, Xu, Xu, Xu
Xu, Xu, Xu, Xu, Xu, Xu, Xu, Xu, Xu, Xu, Xuc, Xuc, Uu, Uu, Uh, Uh, Uh, Ur^Em, Uu, Uh, Yhs, Uh, Uu, Ur^Em, Wwf, Wwg, Wwg, Wwrg, Ur, Ur, Uu, Xu, Qxu, Xu, Xu, Xu, Xu, Xu, Xu, Xu, Xu, Xu, Xu, Xu
Xu, Xu, Xu, Xu, Xu, Xu, Xu, Xu, Xu, Xu, Xuc, Qxu, Uh, Uu, Uh, Uh, Wwrg, Uu^Ii, Wwg, Yhs, Wwf, Yhs, Wwg, Wwf, Yhs, Yhs, Wwg, Uu^Em, Uh, Ur, Uh, Qxu, Xu, Xu, Xu, Xu, Xu, Xu, Xu, Xu, Xu, Xu, Xu, Xu
Xu, Xu, Xu, Xu, Xu, Xu, Xu, Xu, Xu, Xu, Xu, Qxu, Uh, Uu^Uf, Yhs, Yhs, Wwf, Wwf, Uu, Wwf, Yhs, Wwf, Uh, Uu, Ur, Ur, Wwrg, Uh, Uh, Ur, Uh, Qxu, Qxu, Xu, Xu, Xu, Xu, Xu, Xu, Xu, Xu, Xu, Xu, Xu
Xu, Xu, Xu, Xu, Xu, Xu, Xu, Uh, Uh, Xu, Xu, Xu, Uh, Uu^Em, Yhs, Wwg, Wwg, Uh, Uh, Uu^Uf, Uu, Uu, Uh, Uh, Ur, Ur, Uu, Wwrg, Wwg, Uh, Uu, Qxu, Xu, Xu, Xu, Xu, Xu, Xu, Xu, Xu, Xu, Xu, Xu, Xu
Xu, Xu, Xu, Xu, Xu, Xu, Uh, Uh, Uh, Xu, Uu, Xu, Ur, Uh, Wwrg, Wwf, Yhs, Yhs, Uh, Uh, Uh, Ur, Uu, Uh, 2 Ur^Ii, Ur, Uu, Uh, Wwg, Uh, Uh, Xu, Xu, Xu, Xu, Xu, Xu, Xu, Xu, Xu, Xu, Xu, Xu, Xu
Xu, Xu, Xu, Uh, Uh, Xu, Uu^Uf, Ur^Emf, Ur^Em, Ur^Em, Ur, Uu^Xo, Uu, Ur, Wwg, Wwf, Uu, Uu, Uu, Uh, Re^Uf, Uu^Em, Uu, Uu, Uu, Ur, Ur, Uu^Emf, Uu^Uf, Wwrg, Wwg, Xuc, Xuc, Xu, Xu, Xu, Xu, Xu, Xu, Xu, Xu, Xu, Xu, Xu
Xu, Xu, Xu, Uh, Uh, Uu, Ur, Ur^Em, Uh, Uu^Uf, Ur, Uu^Xo, Uh, Uu, Wwf, Uh, Uh, Uu, Uu, Uh, Re^Uf, Re^Emf, Uu, Uu, Uh, Uh, Ur, Ur^Em, Uh, Re^Uf, Uu^Uf, Wog, Wog, Xu, Xu, Xu, Xu, Xu, Xu, Xu, Xu, Xu, Xu, Xu
Uu, Xu, Uu^Uf, Uh, Ur, Ur, Ur, Uh, Uh, Uu^Em, Xu, Xu, Wwf, Wwrg, Wwf, Uh, Uh^Ii, Uh, Uh, Uh, Ur^Em, Uu^Em, Uu, Uh, Uu^Emf, Uu, Uu, Xu, Xuc, Uu^Ii, Uu^Uf, Uh, Xu, Wog^Xo, Wog^Xo, Xu, Xu, Xu, Xu, Xu, Xu, Xu, Xu, Xu
Uu^Uf, Uu^Emf, Ur^Em, Ur, Uh, Uh, Xu, Xu, Xu, Xu, Xu, Xu, Wwg, Wwg, Xu, Xu, Xuc, Uh, Uu, Uu, Uu, Ur^Em, Ur, Ur, Ur^Em, Re^Uf, Uu^Uf, Xu, Xuc, Uh, Uh, Uu, Xu, Xu, Xu, Wog, Wog, Xu, Xu, Xu, Xu, Xu, Xu, Xu
Uu, Uu^Uf, Ur, Xu, Xu, Xu, Xu, Xu, Xu, Xu, Wog^Xo, Wog^Xo, Xu, Xu, Xu, Xu, Xu, Xuc, Xu, Xu, Xu, Uu, Uu, Uu, Xu, Uu^Uf, Xu, Xu, Xu, Xuc, Xu, Xu, Xu, Xu, Xu, Xu, Xu, Xu, Xu, Xu, Xu, Xu, Xu, Xu
Ur, Ur, Xu, Xu, Xu, Xu, Xu, Xu, Wog, Wog, Xu, Xu, Xu, Xu, Xu, Xu, Xu, Xu, Xu, Xu, Xu, Xu, Xu, Xu, Xu, Xu, Xu, Xu, Xu, Xu, Xu, Xu, Xu, Xu, Xu, Xu, Xu, Xu, Xu, Xu, Xu, Xu, Xu, Xu
Xu, Xu, Xu, Xu, Xu, Xu, Xu, Xu, Xu, Xu, Xu, Xu, Xu, Xu, Xu, Xu, Xu, Xu, Xu, Xu, Xu, Xu, Xu, Xu, Xu, Xu, Xu, Xu, Xu, Xu, Xu, Xu, Xu, Xu, Xu, Xu, Xu, Xu, Xu, Xu, Xu, Xu, Xu, Xu
Xu, Xu, Xu, Xu, Xu, Xu, Xu, Xu, Xu, Xu, Xu, Xu, Xu, Xu, Xu, Xu, Xu, Xu, Xu, Xu, Xu, Xu, Xu, Xu, Xu, Xu, Xu, Xu, Xu, Xu, Xu, Xu, Xu, Xu, Xu, Xu, Xu, Xu, Xu, Xu, Xu, Xu, Xu, Xu
