border_size=1
usage=map

Xu, Xu, Xu, Xu, Xu, Xu, Xu, Xu, Xu, Xu, Xos, Xos, Xos, Xu, Xu, Xu, Xu, Xu, Xu, Xos, Xos, Xos, Xos, Xos, Xos, Xos, Xos, Xos, Xu, Xu, Xu, Xu, Xu, Xu, Xu, Urb, Urb, Urb, Urb, Xu, Xu, Xu, Xu, Xu
Xu, Xu, Xu, Xu, Xu, Xu, Xu, Xu, Xos, Xos, Xos, Xos, Xu, Xu, Xu, Xu, Uu, Xu, Uu^Ii, Xu, Uu, Xos, Uh, Xol, Xol, Xos, Xu, Xu, Xu, Xu, Xu, Xu, Xu, Xu, Urb, Urb, Urb, Urb, Xu, Xu, Xu, Xu, Xu, Xu
Xos, Xu, Xu, Xu, Xu, Xu, Xos, Xos, Xol, Xol, Ur, Ur, Ur^Ii, Cud, Ur, Ur, Ur, Ur, Ur, Ur^Ii, Ur^Ii, Ur, Ur, Uu, Uu, Xu, Xu, Xu, Uh, Xu, Uh^Ii, Xu, Xu, Xu, Urb, Urb, Urb, Xu, Xu, Xu, Xu, Xu, Xu, Xu
Xos, Xos, Xos, Xu, Xos, Xos, Xos, Xos, Uu, Cud, 5 Kud, Cud, Uu, Uu^Ii, Uu, Uu^Uf, Uu, Uu, Uu, Uu^Ii, Xu, Uu, Uu^Em, Ur, Ur, Uh, Uu, Uu^Uf, Uh, Uu^Ufi, Uu^Ufi, Uu^Ii, Uh, Urb, Urb, 1 Urb, Urb, Xu, Xu, Xu, Xu, Xu, Xu, Xu
Xos, Xos, Xos, Xos, Xos, Xos, Uu^Uf, Uu^Uf, Uu, Cud, Uu, Cud, Uu, Cud, Uu^Uf, Uu^Uf, Xu, Uu^Uf, Xu, Xu, Xu, Xu, Xu, Uh, Uu^Uf, Ur, Ur, Uu^Em, Uu, Uh, Uh, Uu^Ii, Urb^Ii, Urb, Urb, Urb, Xu, Xu, Xu, Xu, Xu, Xu, Xu, Xu
Xos, Xos, Xos, Xos, Xol, Cud, Uu, Uu^Uf, Uh, Uu, Uh, Uu, Cud, Uu, Uu^Uf, Uu, Xu, Xu, Xu, Xu, Xu, Xu, Xu, Uh, Uu^Uf, Uu, Uh, Ur, Ur, Uh, Ur, Urb^Ii, Ur^Ii, Ur, Uu, Uu, Xu, Xu, Xu, Xu, Xu, Xu, Xu, Xu
Xos, Xos, Xos, Xol, Wog, Wwg, Wwg, Uu^Ii, Uu, Uu, Cud, Uh, Xos, Xos, Xos, Xu, Xu, Xu, Xu, Xu, Xu, Xu, Xu, Xu, Xu, Xu, Xu, Uu^Uf, Uu, Ur, Ur, Ur^Ii, Uh^Ii, Uu^Ii, Uh^Ii, Uh^Ii, Xu, Xu, Xu, Xu, Xu, Xu, Xu, Xu
Xos, Xos, Xol, Uu, Uu, Wwf, Wwg, Wwf, Wwg, Wwf, Wwg, Xol, Xol, Xos, Xos, Xos, Xos, Xu, Xu, Xu, Xos, Xos, Xos, Xu, Xu, Xu, Xu, Uh, Uu^Uf, Uu^Em, Uu^Uf, Uu^Uf, Uh^Ii, Uu^Ii, Uh^Ii, Uh^Ii, Xu, Xu, Xu, Xu, Xu, Xu, Xu, Xu
Xu, Xol, Uh, Uh, Uu^Em, Ur, Ur, Wwg, Wwg, Wwf, Wog, Wog, Wog, Xos, Xos, Xos, Xu, Xu, Xu, Xos, Xos, Xos, Xol, Xos, Uh, Xu, Xu, Xu, Xu, Uh, Xu, Uu^Uf, Xu, Uh^Ii, Xu, Xu, Xu, Xu, Xu, Xu, Xu, Xu, Xu, Xu
Xu, Xu, Uh, Uh, Ur, Uu^Em, Xu, Ur, Wwf, Wog, Xu, Xu, Xu, Xu, Xu, Xu, Xu, Xu, Xu, Xos, Xos, Xu, Uh, Xol, Uu^Uf, Uh, Uu^Uf, Xu, Uh, Xu, Xu, Xu, Xu, Xu, Xu, Xu, Xu, Xu, Xu, Xu, Xu, Xu, Xu, Xu
Xu, Xu, Uu, Uu^Uf, Ur, Xu, Xu, Uh, Ur, Wog, Xu, Xu, Wog, Xu, Wwf, Xu, Xu, Xu, Xu, Xu, Xu, Uh, Uh, Uu^Uf, Uu^Uf, Ur, Uu^Uf, Uh, Uh, Xos, Xos, Xu, Xu, Xu, Xu, Xu, Xu, Xu, Xu, Xu, Xu, Xu, Xu, Xu
Xu, Xu, Xu, Ur, Uu^Uf, Uu^Uf, Xu, Ur, Uu^Uf, Uu^Uf, Xu, Xos, Wwg, Wwg, Wwf, Urb, Urb, Uu^Ii, Xu, Xu, Xu, Uh, Uu^Uf, Uh, Ur, Ur, Uh, Uu^Uf, Xos, Xos, Xos, Xu, Xu, Xu, Xu, Xu, Xu, Xu, Xu, Xu, Xu, Xu, Xu, Xu
Xu, Xu, Xu, Ur, Ur, Ur, Ur, Uu, Uh, Xos, Xos, Rb, Urb, Wwg, Urb, Urb, Urb, Urb, Rb, Xu, Xu, Uh, Urb, Urb, Uu^Uf, Uu^Uf, Uh, Uh, Xu, Xos, Xu, Xu, Xu, Xu, Xu, Xu, Xu, Xu, Xu, Xu, Xu, Xu, Xu, Xu
Xu, Xu, Xu, Xu, Ur, Urb, Ur, Uh, Uu^Uf, Xu, Xu, Rb, Urb, Urb, Xu, Xu, Xu, Urb, Rb, Rb, Rb^Ii, Rb, Urb, Uh, Uu^Uf, Uh, Uh, Xu, Xu, Xu, Xu, Xu, Xu, Xu, Xu, Xu, Xu, Xu, Xu, Xu, Xu, Xu, Xu, Xu
Xu, Xu, Xu, Xu, Uu^Ii, Urb, Uu^Ii, Uh, Uh, Xos, Xos, Urb, Urb, Urb, Xu, Rb, Urb^Ii, Xu, Xu, Urb, Urb, Urb, Urb, Xu, Xu, Uh, Xu, Uh, Xu, Xu, Xu, Xu, Xu, Xu, Xu, Xu, Xu, Xu, Xu, Xu, Xu, Xu, Xu, Xu
Xu, Xu, Uu^Ii, Uh, Uu^Ii, Uh, Uh^Ii, Uu^Ii, Uh^Ii, Xu, Xu, Rb, Rb, Urb, Xu, Rb, Urb^Ii, Urb^Ii, Rb, Xu, Xu, Urb, Urb, Urb, Urb, Xu, Xos, Xu, Xu, Xu, Xu, Xu, Xu, Xu, Xu, Xu, Xu, Xu, Xu, Xu, Xu, Xu, Xu, Xu
Xu, Xu, Uh, Uu^Ii, Uh, Urb, Uh^Ii, Uh, Uh^Ii, Xos, Xos, Urb^Ii, Rb, Urb, Xu, Urb, Xu, Urb, Xu, Urb^Ii, Xu, Xu, Urb, Rb, Urb, Urb, Xos, Xos, Xu, Xu, Xu, Xu, Xu, Xu, Xu, Xu, Xu, Xu, Xu, Xu, Xu, Xu, Xu, Xu
Xu, Xu, Uh, Uh^Ii, Uh, Ur, Ur, Uh, Uh, Xu, Xu, Urb, Urb, Urb, Urb, Xu, Rb, Xu, Urb, Xu, Urb, Urb, Rb, Urb^Ii, Urb, Urb, Xos, Xos, Xu, Xu, Xu, Xu, Xu, Xu, Xu, Xu, Xu, Xu, Xu, Xu, Xu, Xu, Xu, Xu
Xu, Xu, Uh, Uh^Ii, Uh, Uu^Uf, Ur, Uu^Ii, Uh, Xu, Xu, Rb, Urb, Urb, Urb, Rb, Rb, Rb, Urb, Urb, Urb, Rb, Rb, Urb, Urb, Rb, Xos, Xos, Xu, Xu, Xu, Xu, Xu, Xu, Xu, Xu, Xu, Xu, Xu, Xu, Xu, Xu, Xu, Xu
Xu, Xu, Xu, Uh, Xu, Xu, Urb, Uu^Uf, Xos, Xos, Urb, Urb, Xos, Xos, Xos, Xu, Xu, Xu, Xos, Xos, Xos, Xos, Xos, Xos, Xos, Xos, Xos, Xos, Xu, Wog^Xo, Wog^Xo, Xu, Uh, Xu, Xu, Xu, Xu, Xu, Xu, Xu, Xu, Xu, Xu, Xu
Xu, Xu, Xu, Xu, Xu, Xu, Urb, Xos, Xos, Xos, Xos, Xos, Xos, Xos, Xos, Xu, Xos, Xos, Qxu, Uu, Ur, Ur, Ur, Uu, Xos, Xos, Xu, Xu, Xu, Xu, Xu, Wog, Wwg, Uh, Xu, Xu, Uh, Xu, Xu, Uu, Uu^Uf, Xu, Wog, Wog
Xu, Xu, Xu, Xu, Xu, Xu, Ur, Uu^Uf, Uu^Uf, Xos, Xos, Xos, Xos, Xos, Xos, Xos, Xu, Xu, Qxu, Uu, Ur, Qxu, Uu, Ur, Qxu, Xu, Xu, Xu, Xu, Xu, Xu, Uh, Xu, Wwg, Wwg, Wwg, Wwg, Xu, Wog, Uh, Wog, Wog, Xu, Xu
Xu, Xu, Xu, Uu^Ii, Uu, Ur, Ur, Ur, Xu, Xu, Xu, Xos, Xos, Xos, Xu, Xu, Xu, Qxu, Qxu, Uu, Ur, Qxu, Uu, Ur, Uu, Qxu, Xu, Xu, Xu, Xu, Uu^Uf, Uu^Uf, Uu^Uf, Uh, Xu, Xu, Xu, Wog, Xu, Wog, Uh, Xu, Xu, Xu
Xu, Xu, Xu, Xu, Xu, Xu, Xu, Xu, Xu, Xu, Xu, Xu, Xu, Xu, Xu, Xu, Xu, Qxu, Qxu, Uu^Ii, Ur^Ii, Qxu, Qxu, Uu^Uf, Uu, Qxu, Xu, Xu, Xu, Uh, Uu^Uf, Uu^Uf, Uu, Xu, Wwf, Uu^Uf, Uh, Xu, Xu, Uh, Xu, Xu, Wog, Wog
Xu, Xu, Xu, Xu, Xu, Xu, Xu, Xu, Xu, Xu, Xu, Xu, Xu, Xu, Xu, Xu, Xu, Qxu, Qxu, Uu, Ur, Uu, Uu^Em, Uu^Uf, Uu, Qxu, Xu, Xu, Xu, Uh, Uu, Uu^Ii, Uu, Xu, Wwg, Uu, Uh, Xu, Xu, Xu, Wwg, Wwg, Xu, Xu
Xu, Xu, Xu, Xu, Xu, Xu, Xu, Xu, Xu, Xu, Xu, Xu, Xu, Xu, Xu, Xu, Xu, Xu, Qxu, Qxu, Qxu, Ur, Uu, Ur, Ur^Ii, Qxu, Qxu, Xu, Xu, Uh, Uu, Uu^Uf, Xu, Xu, Wwg, Wwf, Xu, Xu, Wwg, Wwg, Xu, Xu, Xu, Xu
Xu, Xu, Xu, Xu, Xu, Xu, Xu, Xu, Xu, Xu, Xu, Xu, Xu, Xu, Xu, Xu, Xu, Xu, Xu, Uh, Qxu, Uu^Em, Uu^Uf, Ur, Uh, Ur, Qxu, Xu, Xu, Xu, Uh, Xu, Xu, Wwg, Xu, Wwf, Wwg, Wwg, Wog, Uu^Uf, Urb, Xu, Xu, Xu
Xu, Xu, Xu, Xu, Xu, Xu, Xu, Xu, Xu, Xu, Xu, Xu, Xu, Xu, Xu, Xu, Xu, Qxu, Xu, Uh, Uh, Uh, Uh, Uu^Uf, Ur, Ur, Ur, Xu, Xu, Xu, Xu, Xu, Xu, Wwg, Xu, Wwg, Wog, Wwg, Xu, Uh, Xu, Xu, Xu, Xu
Xu, Xu, Xu, Xu, Xu, Xu, Xu, Xu, Xu, Xu, Xu, Xu, Xu, Xu, Xu, Xu, Xu, Qxu, Uu^Uf, Xu, Uh, Ur^Em, Ur, Uu^Uf, Xu, Xu, Uh, Uh, Xu, Xu, Xu, Xu, Wwg, Wwg, Xu, Wwg, Xu, Wog, Wog, Xu, Xu, Xu, Xu, Xu
Xu, Xu, Xu, Xu, Xu, Xu, Xu, Xu, Xu, Xu, Xu, Xu, Xu, Xu, Qxu, Xu, Ur^Em, Re^Uf, Uu^Uf, Uu^Ii, Uh, Ur, Uh, Uh, Uh, Uu^Uf, Uh, Uh, Ur, Uh, Wwg, Wwg, Xu, Xu, Xu, Wog, Xu, Xu, Wog, Xu, Xu, Xu, Xu, Xu
Xu, Xu, Xu, Xu, Xu, Xu, Xu, Xu, Xu, Xu, Xu, Xu, Xu, Qxu, Uh, Uh, Ur, Ur^Em, Re^Uf, Uh, Ur, Ur, Ur, Ur, Ur, Ur, Uu, Xu, Wwg, Wwg, Uh^Ii, Xu, Xu, Xu, Xu, Wog^Xo, Xu, Xu, Wog^Xo, Xu, Xu, Xu, Xu, Xu
Xu, Xu, Xu, Xu, Xu, Xu, Xu, Xu, Xu, Xu, Xu, Xu, Uu, Uu, Uh, Uh, Uh, Ur^Em, Uu, Uh, Yhs, Uh, Uu, Ur^Em, Wwf, Wwg, Wwg, Wwg, Ur, Ur, Uu, Xu, Qxu, Xu, Xu, Wog, Xu, Xu, Wog, Xu, Xu, Xu, Xu, Xu
Xu, Xu, Xu, Xu, Xu, Xu, Xu, Xu, Xu, Xu, Xu, Qxu, Uh, Uu, Uh, Uh, Wwf, Uu^Ii, Wwg, Yhs, Wwf, Yhs, Wwg, Wwf, Yhs, Yhs, Wwg, Uu^Em, Uh, Ur, Uh, Qxu, Xu, Xu, Xu, Wog, Xu, Xu, Wog, Xu, Xu, Xu, Xu, Xu
Xu, Xu, Xu, Xu, Xu, Xu, Xu, Xu, Xu, Xu, Xu, Qxu, Uh, Uu^Uf, Yhs, Yhs, Wwf, Wwf, Uu, Wwf, Yhs, Wwf, Uh, Uu, Ur, Ur, Wwg, Uh, Uh, Ur, Uh, Qxu, Qxu, Xu, Xu, Xu, Xu, Xu, Xu, Xu, Xu, Xu, Xu, Xu
Xu, Xu, Xu, Xu, Xu, Xu, Xu, Uh, Uh, Xu, Xu, Xu, Uh, Uu^Em, Yhs, Wwg, Wwg, Uh, Uh, Uu^Uf, Uu, Uu, Uh, Uh, Ur, Ur, Uu, Wwg, Wwg, Uh, Uu, Qxu, Xu, Xu, Xu, Xu, Xu, Xu, Xu, Xu, Xu, Xu, Xu, Xu
Xu, Xu, Xu, Xu, Xu, Xu, Uh, Uh, Uh, Xu, Uu, Xu, Ur, Uh, Wwf, Wwf, Yhs, Yhs, Uh, Uh, Uh, Ur, Uu, Uh, 2 Ur^Ii, Ur, Uu, Uh, Wwg, Uh, Uh, Xu, Xu, Xu, Xu, Xu, Xu, Xu, Xu, Xu, Xu, Xu, Xu, Xu
Xu, Xu, Xu, Uh, Uh, Xu, Uu^Uf, Ur, Ur, Ur, Ur, Uu^Xo, Uu, Ur, Wwg, Wwf, Uu, Uu, Uu, Uh, Re^Uf, Uu^Em, Uu, Uu, Uu, Ur, Ur, Uu, Uu^Uf, Wwg, Wwg, Xu, Xu, Xu, Xu, Xu, Xu, Xu, Xu, Xu, Xu, Xu, Xu, Xu
Xu, Xu, Xu, Uh, Uh, Uu, Ur, Ur, Uh, Uu^Uf, Ur, Uu^Xo, Uh, Uu, Wwf, Uh, Uh, Uu, Uu, Uh, Re^Uf, Re^Emf, Uu, Uu, Uh, Uh, Ur, Ur^Em, Uh, Re^Uf, Uu^Uf, Wog, Wog, Xu, Xu, Xu, Xu, Xu, Xu, Xu, Xu, Xu, Xu, Xu
Uu, Xu, Uu^Uf, Uh, Ur, Ur, Ur, Uh, Uh, Uu, Xu, Xu, Wwf, Wwf, Wwf, Uh, Uh^Ii, Uh, Uh, Uh, Ur, Uu, Uu, Uh, Uu, Uu, Uu, Xu, Xu, Uu^Ii, Uu^Uf, Uh, Xu, Wog^Xo, Wog^Xo, Xu, Xu, Xu, Xu, Xu, Xu, Xu, Xu, Xu
Uu, Uu, Ur, Ur, Uh, Uh, Xu, Xu, Xu, Xu, Xu, Xu, Wwg, Wwg, Xu, Xu, Xu, Uh, Uu, Uu, Uu, Ur, Ur, Ur, Ur, Re^Uf, Uu^Uf, Xu, Xu, Uh, Uh, Uu, Xu, Xu, Xu, Wog, Wog, Xu, Xu, Xu, Xu, Xu, Xu, Xu
Uu, Uu^Uf, Ur, Xu, Xu, Xu, Xu, Xu, Xu, Xu, Wog^Xo, Wog^Xo, Xu, Xu, Xu, Xu, Xu, Xu, Xu, Xu, Xu, Uu, Uu, Uu, Xu, Uu^Uf, Xu, Xu, Xu, Xu, Xu, Xu, Xu, Xu, Xu, Xu, Xu, Xu, Xu, Xu, Xu, Xu, Xu, Xu
Ur, Ur, Xu, Xu, Xu, Xu, Xu, Xu, Wog, Wog, Xu, Xu, Xu, Xu, Xu, Xu, Xu, Xu, Xu, Xu, Xu, Xu, Xu, Xu, Xu, Xu, Xu, Xu, Xu, Xu, Xu, Xu, Xu, Xu, Xu, Xu, Xu, Xu, Xu, Xu, Xu, Xu, Xu, Xu
Xu, Xu, Xu, Xu, Xu, Xu, Xu, Xu, Xu, Xu, Xu, Xu, Xu, Xu, Xu, Xu, Xu, Xu, Xu, Xu, Xu, Xu, Xu, Xu, Xu, Xu, Xu, Xu, Xu, Xu, Xu, Xu, Xu, Xu, Xu, Xu, Xu, Xu, Xu, Xu, Xu, Xu, Xu, Xu
Xu, Xu, Xu, Xu, Xu, Xu, Xu, Xu, Xu, Xu, Xu, Xu, Xu, Xu, Xu, Xu, Xu, Xu, Xu, Xu, Xu, Xu, Xu, Xu, Xu, Xu, Xu, Xu, Xu, Xu, Xu, Xu, Xu, Xu, Xu, Xu, Xu, Xu, Xu, Xu, Xu, Xu, Xu, Xu
