Xu, Xu, Xu, Xu, Xu, Xu, Xu^Qhh, Xu, Xu, Xu, Xos, Xos, Xos, Xu, Xu, Xu, Xuc, Xu, Xu, Xos, Xos, Xos, Xos, Xos, Xos, Xos, Xos, Xos, Xu, Xu, Xu, Xu, Xu, Xu, Xu, Urb, Urb, Urb, Urb, Xu, Xu, Xu, Xu, Xu
Xu, Xu, Xu, Xu, Xu, Xu, Xu^Qhh, Xu, Xos, Xos, Xor, Xos, Xuc, Xuc, Xuc, Xuc, Uu, Xu, Uu^Ii, Xu, Uu, Xos, Uh, Xos^Efs, Xos^Efs, Xos, Xu, Xu, Xuc, Xu, Xuc, Xu, Xu, Xu, Urb, Urb, Urb, Urb, Xu^Qhh, Xu, Xu, Xu, Xu, Xu
Xos, Xu, Xu, Xu, Xu, Xu, Xos^Qhh, Xos, Xos^Efs, Xor^Efs, Ur, Ur, Ur^Ii, Cud, Ur, Ur, Ur, Ur, Ur, Ur^Ii, Ur^Ii, Ur, Ur, Uu, Uu, Xu, Xu, Xuc, Uh^_mhh, Xuc, Uh^Ii, Xu, Xu, Xu, Urb, Urb, Urb, Xu, Xu^Qhh, Xu^Qhh, Xu, Xu, Xu, Xu
Xos, Xos, Xos, Xu, Xos, Xos, Xor, Xos^Qhh, Uu^Qhh, Cud, 5 Kud, Cud, Uu, Uu^Ii, Uu, Uu^Tf, Uu, Uu, Uu, Uu^Ii, Xu, Uu, Uu^Em, Ur, Ur, Uh, Uu, Uu^Tf, Uh, Uu^Tfi, Uu^Tfi, Uu^Ii, Uh, Urb, Urb, 1 Urb, Urb, Xu, Xu^Qhh, Xu^Qhh, Xu, Xu, Xu, Xu
Xos, Xos, Xos, Xos, Xos, Xor, Tb^Tf, Tb^Tf, Uu, Cud^Qhh, Uu^Qhh, Cud, Uu, Cud, Tb^Tf, Tb^Tf, Xuc, Uu^Tf, Xu, Xu, Xu, Xuc, Xuc, Uh, Tb^Tf, Ur, Ur, Uu^Em, Uu, Uh, Uh, Uu^Ii, Urb^Ii, Urb, Urb, Urb, Xu, Xu, Xu^Qhh, Xu^Qhh, Xu, Xu, Xu, Xu
Xos, Xos, Xos, Xos, Xos^Efs, Cud, Uu, Tb^Tf, Uh, Uu, Uh^Qhh, Uu, Cud, Uu, Uu^Tf, Uu, Xuc, Xu, Xu, Xu, Xu, Xu, Xuc, Uh, Tb^Tf, Uu, Uh, Ur, Ur, Uh, Ur, Urb^Ii, Ur^Ii, Ur, Uu, Uu, Xuc, Xu^Qhh, Xu, Xu, Xu, Xu, Xu, Xu
Xos, Xos, Xor, Xor^Efs, Wog, Wwg, Wwg, Uu^Ii, Uu, Uu, Cud, Uh^Qhh, Xos^Qhh, Xos, Xos, Xu, Xu, Xu, Xu, Xu, Xu, Xu, Xu, Xu, Xu, Xu, Xu, Uu^Tf, Uu, Ur, Ur, Ur^Ii, Uh^Ii, Uu^Ii, Uh^Ii, Uh^Ii, Xuc, Xu^Qhh, Xu, Xu, Xu, Xu, Xu, Xu
Xos, Xos, Xos^Efs, Uu, Uu, Wwf, Wwrg, Wwf, Wwg, Wwf, Wwg, Xos^Efs, Xor^Efs, Xos^Qhh, Xos^Qhh, Xos, Xos, Xu, Xu, Xu, Xos, Xos, Xos, Xu, Xuc, Xu, Xu, Uh, Uu^Tf, Uu^Em, Tb^Tf, Tb^Tf, Uh^Ii, Uu^Ii, Uh^Ii, Uh^Ii, Xuc, Xu^Qhh, Xu, Xu, Xu, Xu, Xu, Xu
Xu, Xos^Efs, Uh, Uh, Uu^Em, Ur, Ur, Wwrg, Wwg, Wwf, Wog, Wog, Wog, Xor, Xos, Xos^Qhh, Xu, Xu, Xu, Xos, Xos, Xos, Xos, Xos, Uh, Xuc, Xu, Xu, Xu, Uh, Xu, Tb^Tf, Xu, Uh^Ii, Xu, Xuc, Xu^Qhh, Xu^Qhh, Xu, Xu, Xu, Xu, Xu, Xu
Xu, Xu, Uh, Uh, Ur, Uu^Em, Xu, Ur, Wwf, Wog, Xu, Xu, Xuc, Xu, Xuc, Xu^Qhh, Xu, Xu, Xu, Xos, Xos, Xu, Uh, Xos^Efs, Tb^Tf, Uh, Uu^Tf, Xu, Uh^Qhh, Xu, Xu, Xu, Xu, Xu, Xu^Qhh, Xu^Qhh, Xu, Xu, Xu, Xu, Xu, Xu, Xu, Xu
Xu, Xuc, Uu, Uu^Tf, Ur, Xuc, Xuc, Uh, Ur, Wwrg, Xu, Xuc, Wog, Xuc, Wwf, Xu^Qhh, Xuc, Xuc, Xu, Xu, Xu^Qhh, Uh, Uh^Qhh, Tb^Tf, Uu^Tf, Ur, Tb^Tf, Uh^Qhh, Ur^Br\, Xos^Qhh, Xos^Qhh, Xu^Qhh, Xu^Qhh, Xu^Qhh, Xu, Xu, Xu, Xu, Xu, Xu, Xu, Xu, Xu, Xu
Xu, Xuc, Xuc, Ur, Uu^Tf, Uu^Tf, Xuc, Ur, Uu^Tf, Uu^Tf, Xu, Xor, Wwg, Wwg, Wwf, Urb^Qhh, Urb, Uu^Ii, Xor^Qhh, Xu^Qhh, Xu, Uh^Qhh, Uu^Tf, Uh^Qhh, Ur^Qhh, Ur^Qhh, Uh^Qhh, Uu^Qhh, Xos, Xos^Uov, Xos^Uov, Xu, Xu, Xu, Xu, Xu, Xu, Xu, Xu, Xu, Xu, Xu, Xu, Xu
Xu, Xuc, Xuc, Ur, Ur, Ur, Ur, Uu, Uh, Xos, Xos, Rb, Urb, Wwrg, Urb, Urb^Qhh, Urb^Qhh, Urb^Qhh, Rb^_mh, Xor, Xu, Uh, Urb, Urb, Tb^Tf, Tb^Tf, Uh, Uh, Xu, Xos, Xu, Xu^Uov, Xu, Xu, Xu, Xu, Xu, Xu, Xu, Xu, Xu, Xu, Xu, Xu
Xu, Xu, Xu, Xuc, Ur, Urb, Ur, Uh, Tb^Tf, Xu, Xu, Rb, Urb, Urb, Xu, Xu, Xu, Urb, Rb, Rb, Rb^Ii, Rb, Urb, Uh, Uu^Tf, Uh, Uh, Xuc, Xuc, Xu, Xu, Xu^Gov, Xu, Xu, Xu, Xu, Xu, Xu, Xu, Xu, Xu, Xu, Xu, Xu
Xu, Xu, Xuc, Xu, Uu^Ii, Urb, Uu^Ii, Uh, Uh, Xos, Xos, Urb, Urb, Urb, Xu, Rb, Urb^Ii, Xu, Xu, Urb, Urb, Urb, Urb, Xu, Xu, Uh, Xos, Uh, Xuc, Xu, Xu, Xu^Uov, Xu, Xu, Xu, Xu, Xu, Xu, Xu, Xu, Xu, Xu, Xu, Xu
Xu, Xuc, Uu^Ii, Uh, Uu^Ii, Uh, Uh^Ii, Uu^Ii, Uh^Ii, Xu, Xu, Rb, Rb, Urb, Xu, Rb, Urb^Ii, Urb^Ii, Rb, Xu, Xu, Urb, Urb^Qhh, Urb, Urb, Xos, Xos, Xos, Xos, Xu, Xu, Xu^Gov, Xu, Xu, Xu, Xu, Xu, Xu, Xu^Qhh, Xu^Qhh, Xu^Qhh, Xu^Qhh, Xu^Qhh, Xu
Xu, Xuc, Uh, Uu^Ii, Uh, Urb, Uh^Ii, Uh, Uh^Ii, Xos, Xos, Urb^Ii, Rb, Urb, Xu, Urb, Xu^Qhh, Urb, Xu^Qhh, Urb^Ii, Xu^Qhh, Xu^Qhh, Urb, Rb^Qhh, Urb^Qhh, Urb, Xos, Xos, Xu^Qhh, Xu^Qhh, Xu^Qhh, Xu^Uov, Xu^Gov, Xu, Xu, Xu, Xu^Qhh, Xu^Qhh, Xu, Xu, Xu, Xu, Xu, Xu^Qhh
Xu, Xu, Uh, Uh^Ii, Uh, Ur, Ur, Uh, Uh, Xu, Xu, Urb, Urb, Urb, Urb, Xu^Qhh, Rb, Xu^Qhh, Urb, Xu^Qhh, Urb, Urb, Rb, Urb^Ii, Urb^Qhh, Urb, Xos, Xos, Xu^Qhh, Xu, Xu, Xu^Qhh, Xu^Uov, Xu, Xu, Xu^Qhh, Xu, Xu, Xu, Xu, Xu^Qhh, Xu, Xu^Qhh, Xu
Xu, Xu, Uh, Uh^Ii, Uh, Uu^Tf, Ur, Uu^Ii, Uh, Xu, Xu, Rb, Urb, Urb, Urb, Rb^Qhh, Rb, Rb, Urb, Urb, Urb, Rb, Rb, Urb, Urb, Rb^Qhh, Xos^Qhh, Xos^Qhh, Xu, Xu, Xuc, Xu^Qhh, Xuc^Gov, Xu, Xu, Xu^Qhh, Xu, Xu, Xu^Qhh, Xu^Qhh, Xu, Xu^Qhh, Xu, Xu^Qhh
Xu^Qhh, Xu, Xu^Qhh, Uh, Xu^Qhh, Xu, Urb^Qhh, Uu^Tf, Xos^Qhh, Xos, Urb, Urb, Xos, Xos, Xos^Qhh, Xu^Qhh, Xu, Xu, Xos, Xos, Xos, Xos, Xos, Xos, Xos, Xos, Xos, Xos, Xu, Wog^Xo, Wog^Xo, Xuc^Qhh, Ur^Qhh, Xuc, Xuc, Xu^Qhh, Xuc, Xu, Xu^Qhh, Xu, Xuc, Xu, Xu, Xu
Xu, Xu^Qhh, Xu, Xu^Qhh, Xu, Xuc^Qhh, Urb, Xor^Qhh, Xor, Xos^Qhh, Xos^Qhh, Xos, Xos^Qhh, Xos^Qhh, Xos, Xu, Xos, Xos, Qxu, Uu, Ur, Ur, Ur, Uu, Xos, Xos, Xu, Xu, Xu, Xu, Xuc, Wog, Wwrg, Uh^Qhh, Xu^Qhh, Xu^Qhh, Uh, Xuc, Xuc^Qhh, Uu, Uu^Tf, Xu, Wog^_mh, Wog
Xu, Xu, Xuc, Xu, Xuc, Xuc, Ur^Qhu, Tb^Tf, Uu^Tf, Xos, Xos, Xos^Qhh, Xos, Xos, Xos, Xos, Xuc, Xuc, Qxu, Uu, Ur, Qxu, Uu, Ur, Qxu, Xu, Xu, Xu, Xu, Xu, Xu, Ur, Xuc, Wwrg, Wwrg, Wwg, Wwg, Xu, Wog, Uh^Qhh, Wog, Wog, Xu, Xu
Xu, Xu, Xuc, Uu^Ii, Uu^Qhu, Ur^Qhu, Ur, Ur^Qhu, Uh^Qhu, Xu^Qhu, Xu^Qhu, Xos, Xos, Xos, Xu, Xu, Xuc, Qxu, Qxu, Uu, Ur, Qxu, Uu, Ur, Uu, Qxu, Xu, Xu, Xuc, Xuc, Tb^Tf, Tb^Tf, Uu^Tf, Uh, Xu, Xu, Xu, Wog, Xu^Qhh, Wwrg^Qhh, Uh, Xu, Xu, Xu
Xu, Xu, Xu^Qhu, Xuc^Qhu, Xuc, Uh, Qxu, Qxu, Qxu, Xu, Xu, Xu^Qhu, Xu, Xu, Xu, Xu, Xu, Qxu, Qxu, Uu^Ii, Ur^Ii, Qxu, Qxu, Uu^Tf, Uu, Qxu, Xu, Xu, Xuc, Uh, Tb^Tf, Ur, Uu, Xu, Xu, Xu, Xu, Xu, Xu^Qhh, Uh, Xu, Xu, Xu, Xu
Xu, Xu, Xu^Qhu, Xu, Xu, Xor, Qxu^Xo, Qxu^Xo, Qxu^Xo, Qxu^Xo, Xu, Xu^Qhu, Xu, Xu, Xu, Xu, Xu, Qxu, Qxu, Uu, Ur, Uu, Uu^Em, Uu^Tf, Uu, Qxu, Xuc, Xu, Xu, Uh, Uu, Ur^Ii, Uu, Xu, Xu, Xu, Xu, Xu, Xuc, Xuc^Qhh, Xu^Qhh, Xu^Qhh, Xu^Qhh, Xu^Qhh
Xu, Xu, Xu^Qhu, Xu, Qxu, Qxu, Qxu^_ml, Qxu, Qxu, Qxu, Xu, Xu^Qhu, Xu, Xu, Xu, Xu, Xu, Xu, Qxu, Qxu, Qxu, Ur, Uu, Ur, Ur^Ii, Qxu, Qxu, Xuc, Xu, Uh, Uu, Uu^Tf, Xu, Xuc, Xu^Qhh, Xu^Qhh, Xu^Qhh, Xu, Xu, Xu, Xu, Xu, Xu, Xu
Xu, Xu, Xu^Qhu, Qxu, Xu, Qxu, Xu, Qxu, Xu, Xu, Xu^Qhu, Xu^Qhu, Xu, Xu, Xu, Xu, Xu^Qhu, Xuc^Qhu, Xuc^Qhu, Uh, Qxu, Uu^Em, Uu^Tf, Ur, Uh, Ur, Qxu, Xuc, Xu, Xuc, Uh, Xu, Xu^Qhh, Xu^Qhh, Xuc, Xuc, Xuc, Xu^Qhh, Xu^Qhh, Xu, Xu, Xu, Xu, Xu
Xu, Xu, Xu, Xu^Qhu, Xu^Qhu, Xu, Xu^Qhu, Xu, Xu^Qhu, Xu^Qhu, Xu, Xu, Xu, Xu, Xu^Qhu, Xu^Qhu, Xu, Qxu, Xuc^Qhu, Uh, Uh, Uh, Uh, Tb^Tf, Ur, Ur, Ur, Xu, Xu, Xuc, Xu, Xu^Qhh, Xuc, Xuc, Wog^Xo, Wog, Xu, Xuc, Xu, Xu^Qhh, Xu^Qhh, Xuc, Xu, Xu
Xu, Xu, Xu, Xu, Xu, Xu^Qhu, Xu, Xu^Qhu, Xu, Xu, Xu, Xu, Xu, Xu, Xu^Qhu, Xu, Xu, Qxu, Uu^Tf, Xuc^Qhu, Uh^Qhu, Ur^Em, Ur^Qhu, Tb^Tf, Xu, Xuc, Uh, Uh, Xu, Xor, Xor, Xor^Qhh, Wwg, Wog^_mh, Xu, Xu, Xu, Xu, Xu^Qhh, Xuc^Qhh, Xu, Xu, Xu, Xu
Xu, Xu, Xu, Xu, Xu, Xu, Xu, Xu, Xu, Xu, Xu, Xu, Xu, Xu, Qxu, Xuc^Qhu, Ur^Em, Re^Tf, Tb^Tf, Uu^Ii, Uh, Ur^Qhu, Uh, Uh^Qhu, Uh^Qhu, Tb^Tf, Uh^Qhu, Uh, Ur, Uh, Wwg, Wwrg^Qhh, Xu^Qhh, Xu, Xu, Xu, Xu^Qhh, Xu^Qhh, Xu, Xuc, Xu, Xu, Xu, Xu
Xu, Xu, Xu, Xu, Xu, Xu, Xu, Xu, Xu, Xu, Xu, Xu, Xu, Qxu, Uh, Uh^Qhu, Ur^Emf, Ur^Em, Re^Tf, Uh, Ur, Ur, Ur, Ur, Ur^Em, Ur^Qhu, Uu^Em, Xu^Qhu, Wwrg, Wwg, Uh^Ii, Xor, Xu^Qhu, Xu^Qhh, Xu^Qhh, Xu^Qhh, Xu, Xu, Xu, Xu, Xu, Xu, Xu, Xu
Xu, Xu, Xu, Xu, Xu, Xu, Xu, Xu, Xu, Xu, Xuc, Xuc, Uu, Uu, Uh, Uh^Qhu, Uh, Ur^Em, Uu, Uh, Yhs, Uh, Uu, Ur^Em, Wwf, Wwg, Wwg, Wwrg^Qhu, Ur^Qhu, Ur^Qhu, Uu^Qhu, Xu^Qhu, Qxu, Xor^Qhu, Xu, Xu, Xu, Xu, Xu, Xu, Xu, Xu, Xu, Xu
Xu, Xu, Xu, Xu, Xu, Xu, Xu^Qhu, Xu^Qhu, Xu^Qhu, Xu^Qhu, Xu^Qhu, Qxu, Uh, Uu, Uh^Qhu, Uh^Qhu, Wwrg, Uu^Ii, Wwg, Yhs, Wwf, Yhs, Wwg, Wwf^Es, Yhs, Yhs, Wwg, Uu^Em, Uh, Ur^Em, Uh^Em, Qxu, Xu, Xor^Qhu, Xu, Xu, Xu, Xu, Xu, Xu, Xu, Xu, Xu, Xu
Xu, Xu, Xu^Qhu, Xu, Xu^Qhu, Xu^Qhu, Xu, Xu, Xu, Xu, Xu, Xu^Qhu, Uh^Qhu, Tb^Tf, Yhs^Qhu, Yhs, Wwf, Wwf, Uu, Wwf^Es, Yhs, Wwf, Uh^_ml, Uu, Ur, Ur, Wwrg, Uh, Uh, Ur^Em, Uh, Qxu, Qxu, Xor^Qhu, Xu, Xu, Xu, Xu, Xu, Xu, Xu, Xu, Xu, Xu
Xu^Qhu, Xu^Qhu, Xu, Xu^Qhu, Xu, Xu, Xu, Uh, Uh, Xu, Xu^Qhu, Xu, Uh, Uu^Qhu, Yhs, Wwg, Wwg, Uh, Uh, Uu^Tf, Uu, Uu, Uh, Uh, Ur, Ur, Uu, Wwrg, Wwg, Uh, Uu, Qxu, Xu, Xor^Qhu, Xu, Xu, Xu, Xu, Xu, Xu, Xu, Xu, Xu, Xu
Xu, Xu, Xu, Xu, Xu, Xu, Uh^Qhu, Uh^Qhu, Uh^Qhu, Xu^Qhu, Uu, Xu^Qhu, Ur^Qhu, Uh, Wwrg, Wwf, Yhs, Yhs, Uh, Uh, Uh, Ur, Uu, Uh, 2 Ur^Ii, Ur, Uu, Uh, Wwg, Uh, Uh, Xu, Xu, Xu^Qhu, Xu, Xu, Xu, Xu, Xu, Xu, Xu, Xu, Xu, Xu
Xu^Qhu, Xu^Qhu, Xu^Qhu, Uh, Uh^Qhu, Xu^Qhu, Uu^Tf, Ur^Emf, Ur^Em, Ur^Em, Ur, Uu^Xo, Uu^Qhu, Ur, Wwg, Wwf, Uu, Uu, Uu, Uh, Re^Tf, Uu^Em, Uu, Uu, Uu, Ur, Ur, Uu^Emf, Uu^Tf, Wwrg, Wwg, Xuc, Xuc, Xu^Qhu, Xu^Qhu, Xu, Xu, Xu, Xu, Xu, Xu, Xu, Xu, Xu
Xu^Qhu, Xu, Xu, Uh^Qhu, Uh, Uu, Ur, Ur^Em, Uh, Tb^Tf, Ur, Uu^Xo, Uh, Uu^Qhu, Wwf^Qhu, Uh, Uh, Uu, Uu, Uh, Re^Tf, Re^Emf, Uu^Qhu, Uu^Qhu, Uh^Qhu, Uh, Ur^Qhu, Ur^Em, Uh, Re^Tf, Tb^Tf, Wog, Wog, Xu, Xu, Xu^Qhu, Xu, Xu, Xu, Xu, Xu, Xu, Xu, Xu
Uu^Qhu, Xu, Tb^Tf, Uh, Ur, Ur, Ur, Uh, Uh, Uu^Em, Xu, Xu, Wwf, Wwrg, Wwf, Uh^Qhu, Uh^Ii, Uh, Uh, Uh, Ur^Em, Uu^Em, Uu^Qhu, Uh, Uu^Emf, Uu^Qhu, Uu, Xu^Qhu, Xuc^Qhu, Uu^Ii, Uu^Tf, Uh, Xu, Wog^Xo, Wog^Xo, Xu^Qhu, Xu, Xu, Xu, Xu, Xu, Xu, Xu, Xu
Uu^Qhu, Uu^Emf, Ur^Em, Ur^_mll, Uh, Uh, Xu, Xu, Xu, Xu, Xu, Xu, Wwg, Wwg, Xu, Xu^Qhu, Xuc, Uh, Uu, Uu, Uu, Ur^Em, Ur^Qhu, Uu, Ur^Em, Re^Tf, Tb^Tf, Xu, Xuc^Qhu, Uh, Uh, Uu, Xu^Qhu, Xu, Xu^Qhu, Wog^Qhu, Wog, Xu, Xu, Xu, Xu, Xu, Xu, Xu
Uu^Qhu, Tb^Tf, Ur, Xu, Xu, Xu, Xu, Xu, Xu, Xu, Wog^Xo, Wog^Xo, Xu, Xu, Xu, Xu^Qhu, Xu, Xuc, Xu, Xu, Xu^Qhu, Uu^Qhu, Uh, Uh, Xu, Uu^Tf, Xu, Xu, Xu, Xuc^Qhu, Xu^Qhu, Xu^Qhu, Xu, Xu^Qhu, Xu, Xu, Xu, Xu, Xu, Xu, Xu, Xu, Xu, Xu
Ur^Qhu, Ur, Xu, Xu, Xu, Xu, Xu, Xu, Wog, Wog, Xu, Xu, Xu, Xu, Xu, Xu^Qhu, Xu, Xu, Xu, Xu, Xu^Qhu, Xu, Xu, Xu, Xu, Xu, Xu, Xu, Xu, Xu, Xu, Xu, Xu, Xu, Xu, Xu, Xu, Xu, Xu, Xu, Xu, Xu, Xu, Xu
Xu^Qhu, Xu, Xu, Xu, Xu, Xu, Xu, Xu, Xu, Xu, Xu, Xu, Xu, Xu, Xu, Xu^Qhu, Xu, Xu, Xu, Xu, Xu^Qhu, Xu, Xu, Xu, Xu, Xu, Xu, Xu, Xu, Xu, Xu, Xu, Xu, Xu, Xu, Xu, Xu, Xu, Xu, Xu, Xu, Xu, Xu, Xu
Xu^Qhu, Xu, Xu, Xu, Xu, Xu, Xu, Xu, Xu, Xu, Xu, Xu, Xu, Xu, Xu, Xu^Qhu, Xu, Xu, Xu, Xu, Xu^Qhu, Xu, Xu, Xu, Xu, Xu, Xu, Xu, Xu, Xu, Xu, Xu, Xu, Xu, Xu, Xu, Xu, Xu, Xu, Xu, Xu, Xu, Xu, Xu
