border_size=1
usage=map

Wog, Wog, Wog, Xu, Xu, Xu, Xu, Xu, Xu, Uu^Uf, Uu^Uf, Uu^Uf, Rr, Rr, Uh, Qxu, Qxu, Xu, Xu, Xu, Xu, Xu, Wog, Wog, Xu, Xu, Xu, Xu, Xu, Xu, Xu, Xu, Xu, Xu, Xu, Xu, Xu, Xu, Xu, Xu, Xu, Xu, Xu, Xu, Xuc, Uh, Uu^Uf, Ur, Ur, Uh, Xuc, Xuc, Xuc, Xuc, Xuc, Xuc, Uu, Uu, Uu, Xu
Wog, Wog, Wog, Xu, Xu, Xu, Xu, Xu, Cud, Uh, Uu^Uf, Rr, Re^Uf, Uu^Vud, Qxu, Qxu, Xu, Xu, Xu, Xu, Wog, Wog, Xu, Xu, Xu, Xu, Xu, Xu, Xu, Xu, Xu, Xu, Xu, Xu, Xu, Xu, Xu, Xu, Xu, Xu, Xu, Xu, Xu, Xu, Xu, Uh, Uh, Uu^Uf, Ur, Uh, Uh, Uu^Uf, Uu^Uf, Xuc, Ur, Uu^Uf, Ur, Uu, Xu, Xu
Wog, Wog, Wog, Wwg, Xuc, Xu, Xu, Cud, 3 Kud, Cud, Uu^Vu, Rr, Re^Uf, Uh, Qxu, Qxu, Xu, Xu, Xu, Xu, Wog, Xu, Xu, Xu, Xu, Xu, Xu, Xu, Xu, Xu, Xu, Xu, Xu, Xu, Xu, Xu, Xu, Xu, Xu, Xu, Xu, Xu, Xu, Xu, Xu, Xuc, Xuc, Uu, Uu, Ur, Re^Uf, Uu, Uu^Vud, Ur, Uh, Uu, Uu^Uf, Uh, Xu, Xu
Xu, Wog, Wog, Wog, Wwg, Xuc, Xu, Cud, Cud, Cud, Rr, Rr, Uh, Qxu, Xu, Xu, Xu, Xu, Xu, Wog, Wog, Xu, Xu, Xu, Xu, Xu, Xu, Xu, Xu, Xu, Xu, Xu, Xu, Xu, Xu, Xu, Xu, Xu, Xu, Xu, Xu, Xu, Xu, Xu, Xu, Xuc, Xuc, Uh, Uu^Em, Uu, Ur, Uu, Re^Uf, Uu, Xuc, Re^Uf, Xuc, Xu, Xu, Xu
Xu, Wog, Wog, Wog, Wog^Xo, Xuc, Xuc, Xuc, Uu^Vud, Re^Uf, Rr, Re^Uf, Xuc, Xuc, Xu, Xu, Xuc, Xuc, Wog, Wog^Xo, Xu, Xu, Xu, Xu, Xu, Xu, Xu, Xu, Xu, Xu, Xu, Xu, Xu, Xu, Xu, Xu, Xu, Xu, Xu, Xu, Xu, Xu, Xu, Xu, Qxu, Qxu, Xuc, Xuc, Uu^Uf, Uu^Emf, Ur, Uh, Qxu, Xuc, Xuc, Xuc, Xuc, Xu, Xu, Xu
Xu, Wwg, Wwg^Xo, Wog^Xo, Wog, Wog, Wog, Wwg, Wwg, Uu^Em, Wwf, Uu^Em, Uu^Es, Xuc, Xu, Xu, Wog, Wog, Wog, Xu, Xu, Xu, Xu, Xu, Xu, Xu, Xu, Xu, Xu, Xu, Xu, Xu, Xu, Xu, Xu, Xu, Xu, Xu, Xu, Xu, Xu, Xu, Xuc, Xu, Qxu, Qxu, Qxu, Xuc, Uu^Uf, Uu^Vu, Ur, Uh, Qxu, Qxu, Qxu, Qxu, Qxu, Uh, Uh, Xu
Xu, Xu, Xu, Wwg, Wwg, Wog, Wog, Wog, Wwg, Wwf, Wwg, Wwf, Wwf^Es, Wwg, Wog, Wog, Wwg, Wog, Wog, Xu, Xu, Xu, Xu, Xu, Xu, Xu, Xu, Xu, Xu, Xu, Xu, Xu, Xu, Xu, Xu, Xu, Xu, Xu, Xu, Xu, Xu, Xu, Xuc, Xuc, Xuc, Qxu, Re^Uf, Uu, Uh, Ur, Uh, Qxu, Qxu, Qxu, Qxu, Qxu, Qxu, Uh, Uh, Xu
Xu, Xu, Xu, Xu, Xu, Xu, Xu, Xuc, Xuc, Wwf^Es, Wwf^Es, Wwf, Wwf, Wwg, Wwg, Wog, Wwg, Wog, Wog, Xu, Xuc, Xu, Xuc, Xu, Xu, Xu, Xu, Xu, Xu, Xu, Xu, Xu, Xuc, Xu, Xuc, Xu, Xuc, Xu, Qxu, Qxu, Qxu, Qxu, Uu^Uf, Xuc, Uu^Uf, Re^Uf, Uh, Re^Uf, Re^Uf, Uu^Uf, Ce, Ce, Ce, Uu, Re^Uf, Uu^Uf, Uu^Vu, Uh, Uu^Uf, Uh
Xu, Xu, Xu, Xu, Xu, Xu, Xu, Xuc, Xuc, Wwf, Re^Uf, Wwg, Re, Wwf^Es, Uu, Wwg, Xuc, Wog, Wog, Wog, Wog^Xo, Xuc, Xuc, Xu, Xu, Xu, Xuc, Xu, Xu, Xu, Xu, Xu, Xuc, Xuc, Uh, Xuc, Uu^Uf, Qxu, Re^Uf, Qxu, Uh, Uh, Re^Uf, Uu^Emf, Uu^Uf, Re^Uf, Uh, Uu^Vud, Ur^Es, Ur, Ce, 5 Ket, Ce, Ur, Ur^Br\, Ur^Es, Ur^Es, Uh, Uu^Uf, Uu^Uf
Xu, Xu, Xu, Xu, Xu, Xu, Xu, Xuc, Xuc, Uh, Re^Uf, Re^Uf, Uu, Re, Re, Uh, Xuc, Xuc, Xuc, Wog^Xo, Wog, Wog, Wog, Xuc, Xuc, Xuc, Xuc, Xuc, Xu, Xu, Xu, Xuc, Xuc, Uu^Uf, Re^Uf, Uh, Uu^Uf, Uu^Uf, Uh, Re^Uf, Re^Uf, Uh, Re^Em, Uu^Em, Uu^Br/, Re^Uf, Re^Uf, Ur, Uu^Uf, Re^Uf, Uh, Ce, Ce, Ce, Uu^Uf, Uu^Br/, Uu^Uf, Uu^Uf, Uu^Uf, Ur^Br\
Xu, Xu, Xu, Xu, Xu, Xu, Xu, Xu, Qxu, Qxu, Uh, Uu, Rr, Rr, Re, Re^Uf, Uh, Xuc, Xu, Xuc, Xuc, Wog, Xuc, Xuc, Xu, Xuc, Xu, Xu, Xu, Xu, Xuc, Xuc, Re^Uf, Re^Uf, Uh^Emf, Re^Uf, Uu, Cud, Uu, Uh, Uu^Em, Uu^Em, Uu^Br/, Uu, Ur^Es, Ur, Re^Uf, Uh, Uu^Uf, Uu^Vu, Uu^Uf, Uh, Uh, Uh, Xu, Uh, Uu^Uf, Uu^Uf, Uh, Uu
Xu, Xu, Xu, Xu, Xu, Xu, Qxu, Qxu, Xu, Qxu, Uu^Uf, Uh, Rr^Em, Uu^Uf, Re^Uf, Re^Em, Uu, Xuc, Xuc, Xuc, Xuc, Xuc, Xuc, Xuc, Xu, Xu, Xu, Xu, Xu, Xuc, Uh, Uu, Re^Emf, Uh, Uh, Uu^Uf, Uu^Uf, Ur, Ur, Uu^Uf, Ur^Emf, Ur^Br/, Ur, Uu^Uf, Re^Uf, Uu, Uu^Uf, Uh, Xu, Uh, Xu, Xu, Xu, Xu, Xu, Uh, Uh, Uh, Uh, Uh
Xu, Xu, Xu, Xu, Xu, Xu, Xu, Xu, Xu, Xuc, Qxu, Uu^Uf, Uue^Uf, Rr, Rr, Re, Uu, Uu^Uf, Re^Uf, Xuc, Xuc, Xuc, Xuc, Xuc, Xuc, Xu, Xu, Xu, Uh, Xu, Uu, Chr, Uu^Em, Uu^Uf, Ur, Uu, Ur^Es, Uu, Uu, Ur^Br/, Uu^Em, Cud, Cud, Re^Emf, Re^Uf, Uu, Uh, Xu, Xu, Xu, Xu, Xu, Xu, Xu, Xu, Xu, Xu, Xu, Xu, Xu
Xu, Xu, Xu, Xu, Xu, Xu, Xu, Xu, Qxu, Qxu, Qxe, Re^Uf, Uhe, Uue, Uue^Uf, Re, Uu^Vu, Uh, Uu^Uf, Xuc, Xuc, Xuc, Xuc, Xuc, Xu, Xu, Xu, Xu, Xu, Uh, Uh, Ur, Rr, Ur, Uh, Uu, Uu^Br/, Ur^Br/, Ur, Uu, Uu^Uf, Cud, Uu, Uu, Uu^Uf, Re^Uf, Uu^Uf, Xu, Xu, Xu, Xu, Xu, Xu, Xu, Xu, Xu, Xu, Xu, Xu, Xu
Qxu, Qxu, Qxu, Qxu, Xu, Xu, Xu, Xu, Xu, Xu, Qxe, Re^Uf, Uue^Uf, Uhe, Uue, Rr, Rr, Re^Uf, Re^Uf, Uu^Uf, Xuc, Xuc, Cud, Cud, 2 Kud, Xu, Xu, Xu, Uh, Xu, Rr, Rr, Cud, Uh, Ur, Ur, Uu, Chr, Ur, Uh, Uh, Uu, Uh, Uu^Vud, Uh, Re^Uf, Uu^Uf, Xu, Xu, Xu, Xu, Xu, Xu, Xu, Xu, Xu, Xu, Xu, Xu, Xu
Uh, Qxu, Qxu, Qxu, Qxe, Qxe, Qxe, Qxu, Xu, Xue, Qxe, Qxe, Uue^Uf, Re^Uf, Uue^Es, Uue, Rr, Re, Re, Re^Em, Re, Xuc, Uu, Cud, Cud, Cud, Uu, Uh, Uu^Vud, Re, Uu, Uu, Rr, Uh, Uu^Br/, Ur^Br|, Uh, Uu, Uu, Uh, Xu, Uu^Uf, Uh, Uh, Xu, Xuc, Xu, Xu, Xu, Xu, Xu, Xu, Xu, Xu, Xu, Xu, Xu, Xu, Xu, Xu
Rr, Uu^Uf, Uh, Qxu, Qxe, Qxe, Qxe, Xue, Xue, Xue, Qxe, Qxe, Uue^Uf, Uue^Uf, Re, Uue, Xue, Rr, Uh, Uu^Vu, Uu^Uf, Uh, Uu, Uu, Re, Uu, Uu^Uf, Uu, Rr, Uu, Uu, Uu, Rr, Uu, Uh, Uu, Uu^Uf, Xu, Xuc, Xuc, Xuc, Xu, Uh, Uh, Uh, Xuc, Uh, Xu, Xu, Xu, Xu, Xu, Xu, Xu, Xu, Uh, Uh, Xu, Xu, Xu
Rr, Uu, Uu^Vu, Uu^Uf, Ce, Uue^Uf, Uue^Uf, Uhe, Uhe, Uhe, Uhe, Uhe, Uue, Uue, Uue^Emf, Re, Re, Rr, Uu, Uh, Uu^Uf, Uh, Uu^Vud, Re, Uue^Uf, Re^Em, Re, Rr, Uu, Rr, Re, Re, Re^Es, Uu, Uu, Ur, Ur^Es, Xuc, Xuc, Xuc, Wwg, Uh, Chw, Chw, Wwg, Uh, Wog, Wog, Wog, Wog, Wog, Xu, Xu, Xu, Uh, Uh, Uh, Xu, Xu, Xu
Uu, Rr, Rr, Uh, Ce, Ce, Ce, Uue^Vu, Uue, Uue^Uf, Uue, Uue, Re, Uue, Uue^Uf, Uue^Uf, Re, Rr, Re, Uu, Uu, Uh, Rr, Uue, Uue^Uf, Uu^Uf, Uu^Vu, Uu, Chr, Uh, Uh, Rr, Uh, Uu, Uu^Uf, Uu^Uf, Ur, Rb, Wwf^Es, Wwg, Wwg, Wwg, Wog, Wwg, Wog, Wog, Wog, Xu, Xu, Wog, Wog, Wwg, Wwg^Xo, Uu, Uu, Chw, Chw, Uh, Xu, Xu
Xu, Uu^Uf, Uu, Ce, Ce, 4 Ke, Ce, Rr, Rr, Rr, Rr, Uue, Rr, Re^Em, Rr, Re, Re^Uf, Cud, Uu, Re, Rr, Xue, Re, Re^Uf, Rr, Uu^Uf, Uu^Uf, Uh, Uu, Uh, Xu, Xu, Xu, Xu, Xu, Uu^Uf, Wwf^Es, Wwg, Wwg, Wwg, Wwg, Wog, Wwg, Wog, Wwg, Wog, Wog, Wog, Wog, Wog, Wog, Wog, Wog^Xo, Wog, Wog, Chw, Wwg, Uh, Xu, Xu
Xu, Uu^Uf, Uh, Ce, Uu^Vud, Ce, Uu^Uf, Uu^Uf, Uu, Uue, Uue, Rr, Uue^Uf, Rr, Re^Uf, Rr, Rr, Uu, Re^Uf, Rr, Uue, Uue, Uue^Uf, Re, Rr, Uu, Uu^Uf, Uh, Uh, Xu, Xu, Xu, Xu, Xu, Wwg, Wwg, Wwf, Wwg, Wwf^Es, Wwf^Es, Rr, Wwg, Uu, Uh, Xu, Xu, Xu, Wog, Xu, Wog, Xu, Wwg, Xu, Wog, Wog, Wog, Wog, Xu, Xu, Xu
Xuc, Xuc, Xuc, Uu^Uf, Uu^Uf, Uu, Uu, Uu^Uf, Uhe, Uue^Uf, Uue, Uue, Re^Em, Re^Em, Uue, Re, Rr, Xue, Re^Uf, Rr, Rr, Uue, Rr, Re, Uue, Rr, Cud, Uu, Xue, Xu, Xue, Xu, Wwf^Es, Wwf^Es, Wwg, Wwg, Wwg, Wwg, Uh, Uu, Rb, Rb, Rb^Uf, Uu^Uf, Uh, Xu, Xu, Xu, Xu, Xu, Xu, Xu, Xu, Xu, Uu, Wog, Wog, Wog, Wwg, Xu
Xos, Xuc, Xuc, Uu^Uf, Uu^Uf, Uh, Rr, Uhe, Re, Uue^Uf, Re, Re, Re, Re^Uf, Uue, Re^Em, Rr, Rr, Re^Es, Rr, Uue, Rr, Uue, Rr, Rr, Cud, Kud, Cud, Xue, Xue, Wwf^Z\, Wwf, Xu, Xu, Wog, Wog, Wwg, Wwf, Uh, Uu^Vud, Rb^Uf, Rr, Rb^Em, Rb^Uf, Uu^Uf, Xu, Xu, Xu, Xu, Xu, Xu, Xu, Xu, Xu, Wwf, Wwg, Wwg, Wog, Wog, Wwg
Xos, Xos, Xos, Uh, Uh, Uu^Uf, Rr, Re, Re, Uue^Vu, Uue, Uue, Rr, Rr, Rr, Rr, Re^Uf, Uue, Uue, Re, Re, Cud, Uue, Uue^Uf, Uue^Uf, Cud, Cud, Cud, Xue, Xue, Wwf^Es, Xue, Wwg, Wwg, Wwg, Wwg, Wwg, Xu, Xu, Uu^Uf, Rb^Uf, Rr, Rb, Rb^Uf, Uh, Uh, Xu, Xu, Xu, Xu, Xu, Xu, Uh, Uh, Wwf, Wwf, Xu, Wog, Wog, Wwg
Xos, Xos, Qxu, Uh, Rr, Rr, Qxu, Uu^Uf, Uhe, Uhe, Uue, Rr, Re, Uhe, Xue, Re^Uf, Re, Uue, Uue^Vu, Re^Uf, Re^Uf, Re^Uf, Re^Uf, Uue^Uf, Re, Uue^Uf, Uue, Cud, Uue^Vud, Xue, Wwf^Es, Xue, Wwg, Wwg, Xue, Wwg, Xue, Xu, Xu, Uu^Uf, Uu^Uf, Uu, Rb^Uf, Re^Uf, Uu^Vud, Xu, Xu, Xu, Uh, Uh, Uh, Xu, Xu, Uu^Uf, Wwf, Wwf, Xu, Wwg, Wwg, Wog
Qxu, Qxu, Qxu, Uu^Vu, Re, Re, Qxu, Qxu, Qxu, Uu^Vud, Uu, Uue^Uf, Uue^Uf, Uue, Xue, Xue, Uhe, Re, Uue, Re^Uf, Re^Emf, Rr, Re^Uf, Re, Xue, Re^Es, Uue, Uue, Uue, Wwg, Xue, Xue, Xue, Wwg, Xue, Wwg, Xue, Xu, Uu^Uf, Uh, Rr, Rb, Rb^Uf, Uu^Uf, Xu, Xu, Xu, Xu, Qxu, Qxu, Uh, Uu, Uu^Uf, Re^Uf, Re^Uf, Xu, Xu, Xu, Xu, Wwg
Qxu, Qxu, Uh, Uu, Uu^Uf, Qxu, Qxu, Qxu, Qxu, Qxu, Xu, Xu, Xu, Uhe, Xue, Xue, Uhe, Uue, Cud, Re^Uf, Re^Uf, Re, Rr, Uue^Uf, Uue, Re, Uue, Uue, Wwf, Wwg, Uue^Uf, Xue, Wwg, Xue, Wwg, Xue, Xu, Xu, Uu^Uf, Rb^Uf, Rb^Em, Rb, Uh, Rb^Uf, Uu^Uf, Xu, Xu, Xu, Qxu, Qxu, Qxu, Uh, Xu, Uu^Uf, Xu, Xu, Xu, Xu, Xu, Xu
Qxu, Qxu, Rr, Rr, Uu^Uf, Qxu, Qxu, Qxu, Uu^Uf, Xu, Xu, Xu, Xu, Xu, Xu, Xue, Xue, Uhe, Uue^Uf, Uue^Uf, Re^Uf, Re^Em, Re, Rr, Rr, Rr, Rr, Wwg, Wwf, Uue^Uf, Uhe, Xue, Wwg, Wwg, Xue, Xue, Xu, Xu, Rb^Z\, Rr, Rr, Uh, Xu, Uu^Uf, Xu, Xu, Xu, Xu, Xu, Qxu, Qxu, Xu, Xu, Xu, Xu, Xu, Xu, Xu, Xu, Xu
Qxu, Re^Uf, Re, Uu, Uu^Uf, Re^Uf, Re, Re^Uf, Re, Uu, Uu^Ii, Uu^Ufi, Uh^Ii, Xu, Xuc, Xu, Xu, Xue, Uhe, Uue^Uf, Uue^Uf, Re^Uf, Uue^Uf, Re^Uf, Re^Uf, Re^Uf, Rr, Wwf^Es, Uue^Uf, Uue^Uf, Wwf, Wwf^Es, Wwg, Wwg, Xu, Xu, Uu^Uf, Uu^Vu, Rb, Rb^Z\, Xu, Xu, Xu, Xu, Uh, Xu, Xu, Xu, Qxu, Qxu, Qxu, Xu, Xu, Xu, Qxu, Qxu, Qxu, Xu, Xu, Xu
Re, Uu, Re, Qxu, Xuc, Xuc, Xuc, Xuc, Qxu, Uu^Ufi, Uu^Ufi, Uu^Ii, Uh^Ii, Qxu, Qxu, Xu, Xu, Xue, Xue, Uhe, Xue, Qxe, Uhe, Uue, Re^Uf, Re^Emf, Re, Wwf, Wwg, Wwg, Wwg, Wwf^Es, Wwf^Es, Wwg, Xu, Xu, Rb^Uf, Rb, Rb^Em, Xu, Xu, Xu, Xu, Uh, Urb, Uh, Xu, Xu, Xu, Qxu, Xu, Xu, Xu, Uh, Uu, Qxu, Qxu, Xu, Xu, Xu
Rr, Re, Qxu, Qxu, Xuc, Xuc, Xuc, Xuc, Xuc, Qxu, Qxu, Uh^Ii, Qxu, Qxu, Qxu, Xos, Xu, Xue, Xu, Xue, Xue, Qxe, Qxe, Uhe, Uue^Uf, Re^Uf, Uue^Uf, Wwg, Wwg, Wwf^Es, Wwg, Wwf, Xu, Xu, Xu, Re^Uf, Rb^Uf, Rb, Uu, Uu^Uf, Cud, Xu, Urb, Urb, Xu, Uh, Xu, Xu, Xu, Xu, Xu, Xu, Uh, Uu^Uf, Uh, Qxu, Xu, Xu, Xu, Xu
Qxu, Qxu, Qxu, Xuc, Xuc, Xuc, Xu, Xuc, Xos, Qxu, Qxu, Qxu, Qxu, Qxu, Xos, Xos, Xos, Xu, Xu, Xue, Xu, Xue, Xu, Uhe, Uue^Uf, Uue^Uf, Wwg, Wwf^Es, Wwg, Wwf, Wwf^Z/, Wwf^Z/, Wwf, Uu^Uf, Uu^Vud, Re^Uf, Rr, Rr, Uu, Uu^Uf, Cud, 6 Kud, Xu, Xu, Xu, Xu, Uu, Xu, Uu, Xu, Uh, Uh, Xu, Uh, Xu, Qxu, Qxu, Xu, Xu, Xu
Qxu, Qxu, Xuc, Xuc, Xuc, Xuc, Xu, Xos, Xos, Xos, Xos, Qxu, Xos, Xos, Xos, Xos, Xu, Xu, Xu, Xu, Xu, Xu, Uu^Uf, Xu, Uh, Wwg, Wwg, Wwg, Xu, Wwf^Z/, Uh, Rr, Rr, Uu^Uf, Rb, Rb^Em, Rb, Uu, Rb, Uu^Vu, Uu, Cud, Cud, Xu, Xu, Uu, Xu, Uu, Xu, Qxu, Xu, Xu, Xu, Xu, Xu, Qxu, Qxu, Xu, Xu, Xu
Xu, Xu, Xuc, Xuc, Xu, Xu, Xu, Xu, Xu, Xos, Xos, Xos, Xos, Xos, Xu, Xu, Xu, Xuc, Xu, Xu, Xu, Uh, Uu, Uu^Uf, Wwg, Wwg, Wwg, Wwg, Xu, Xu, Xu, Rb, Re^Uf, Rr, Uu^Uf, Uu, Uu, Uu, Rr, Rr, Rb^Em, Uu, Uu, Xu, Xu, Qxu, Qxu, Qxu, Qxu, Qxu, Qxu, Uu, Uu, Xu, Xu, Xu, Xu, Xu, Xu, Xu
Xu, Xu, Xu, Xu, Xu, Xu, Xu, Xu, Xu, Xu, Xu, Xu, Xu, Xu, Xu, Xu, Xu, Xu, Xu, Xu, Xu, Uu^Uf, Wwg, Wwg, Wwg, Wog, Wwg, Wwg, Xu, Xu, Uh^Ii, Uh, Uu^Uf, Re^Uf, Uh, Uh, Uu^Uf, Uu^Uf, Uu^Uf, Rr, Uu^Uf, Uu, Rr, Uu^Vud, Uu^Uf, Uu^Uf, Uu^Uf, Qxu, Uu^Uf, Qxu, Uh, Qxu, Qxu, Xu, Xu, Xu, Xu, Xu, Xu, Xu
Xu, Xu, Uh, Uh, Uu^Uf, Xu, Xu, Xu, Uh, Xu, Xu, Xu, Xu, Xu, Uu^Uf, Uh, Uh, Uu^Uf, Xu, Xu, Wwg, Wwg, Wwg, Wog, Wog, Wog, Xu, Xu, Xu, Xu, Uh^Ii, Uu^Ufi, Uu, Uu^Vu, Xu, Xu, Xu, Xu, Uu^Uf, Uh, Uu^Uf, Uu, Rr, Rb^Em, Uu, Uu^Uf, Uu, Uu, Rr, Uh, Uu, Uh, Uu^Vud, Uh, Uu^Uf, Xu, Xu, Xu, Xu, Xu
Uu, Uu^Uf, Uu, Uu^Uf, Wwg, Wwg, Wwg, Wwg, Wog, Wwg, Wwg, Wwg, Wog, Wwg, Wwg, Uu, Xu, Xu, Wwg, Wwg^Xo, Wog^Xo, Wwg, Wwg, Wog, Uu^Uf, Uh, Xu, Xu, Uu^Uf, Uh, Qxu, Qxu, Uh, Xu, Xu, Xu, Xu, Xu, Xu, Uu^Uf, Xu, Uh, Uu^Uf, Rr, Uu, Rr, Rb, Rr, Rb^Em, Rr, Rb, Uu, Rb, Uu, Uu, Xu, Xu, Xu, Xu, Xu
Wwg, Wwg, Wog, Wwg, Xu, Wog, Wog, Wwg, Wwg, Wog, Wwg, Wwg, Wog, Wog, Wog, Wwg, Wwg, Wwg, Wog, Wog, Wwg, Wwg^Xo, Wog^Xo, Uu, Xuc, Uu, Xu, Xu, Uu^Vud, Uu^Uf, Qxu, Qxu, Xu, Xu, Xu, Xu, Xu, Xu, Xu, Xu, Uu^Uf, Uh, Uu^Uf, Rb, Uu^Vu, Uu, Re^Uf, Re^Uf, Re^Uf, Uu, Uu, Rr, Ce, Ce, Ce, Uh, Uh, Xu, Xu, Xu
Wog, Wwg, Wog, Wog, Xu, Xu, Wwg, Wwg, Xu, Wwg, Xu, Wwg, Xu, Wog, Wwg, Wog, Wwg, Wwg, Wwg, Wwg, Wwg, Wwg, Uh, Xuc, Xuc, Xuc, Xu, Xu, Qxu, Qxu, Qxu, Uu^Uf, Uu^Uf, Xu, Xu, Xu, Xu, Xu, Xu, Qxu, Qxu, Uu^Uf, Uu^Uf, Uh, Uu^Uf, Uu^Uf, Uu^Uf, Uu^Uf, Uu^Uf, Uu, Uu^Vu, Uu^Uf, Ce, 1 Ke, Rr, Uu, Uh, Uu, Xu, Xu
Wog, Wog, Wog, Wog, Uu^Uf, Wwg, Uu^Uf, Xu, Xu, Xu, Xu, Xu, Xu, Xu, Uh, Wwg, Xu, Wwg, Uh, Uu, Uu^Uf, Uh, Uu^Uf, Xuc, Uh, Xuc, Xu, Xu, Qxu, Qxu, Xu, Uh, Xu, Uh, Xu, Xu, Xu, Xu, Xu, Xu, Qxu, Uu^Uf, Qxu, Xu, Uu^Uf, Uh, Qxu, Uh, Xu, Uh, Uh, Uu, Uu, Ce, Rb, Rb, Rb, Uu, Uu, Xu
Wwg, Wwg, Uh, Uu^Uf, Uh, Uu^Uf, Xu, Xu, Xu, Xu, Xu, Uu^Uf, Uu^Uf, Uh, Uu^Uf, Uu, Xu, Xu, Xu, Xu, Xu, Xu, Xu, Uu, Xu, Xu, Xu, Qxu, Qxu, Qxu, Xu, Xu, Xu, Xu, Xu, Xu, Xu, Xu, Xu, Qxu, Qxu, Qxu, Xu, Xu, Qxu, Qxu, Xu, Xu, Xu, Xu, Xu, Xu, Xu, Uu, Uu^Vud, Rb, Rr, Rb, Uh, Uu
Xu, Xu, Xu, Xu, Xu, Xu, Xu, Xu, Xu, Xu, Xu, Xu, Xu, Xu, Xu, Xu, Xu, Xu, Xu, Xu, Xu, Xu, Xu, Xu, Xu, Xu, Xu, Xu, Qxu, Xu, Xu, Xu, Xu, Xu, Xu, Qxu, Qxu, Xu, Qxu, Qxu, Qxu, Xu, Xu, Qxu, Qxu, Qxu, Xu, Xu, Xu, Xu, Xu, Xu, Xu, Xu, Qxu, Uh, Uu, Uu, Rb, Uu
Xu, Xu, Xu, Xu, Xu, Xu, Xu, Xu, Xu, Xu, Xu, Xu, Xu, Xu, Xu, Xu, Xu, Xu, Xu, Xu, Xu, Xu, Xu, Xu, Xu, Xu, Xu, Xu, Xu, Qxu, Qxu, Qxu, Qxu, Xu, Qxu, Qxu, Xu, Qxu, Xu, Xu, Xu, Xu, Xu, Xu, Xu, Xu, Xu, Xu, Xu, Xu, Xu, Xu, Xu, Xu, Qxu, Qxu, Uh, Uh, Uu, Rr
Xu, Xu, Xu, Xu, Xu, Xu, Xu, Xu, Xu, Xu, Xu, Xu, Xu, Xu, Xu, Xu, Xu, Xu, Xu, Xu, Xu, Xu, Xu, Xu, Xu, Xu, Xu, Xu, Xu, Xu, Xu, Qxu, Xu, Qxu, Xu, Qxu, Xu, Xu, Xu, Xu, Xu, Xu, Xu, Xu, Xu, Xu, Xu, Xu, Xu, Xu, Xu, Xu, Xu, Xu, Xu, Qxu, Xu, Uh, Uh, Uu
Xu, Xu, Xu, Xu, Xu, Xu, Xu, Xu, Xu, Xu, Xu, Xu, Xu, Xu, Xu, Xu, Xu, Xu, Xu, Xu, Xu, Xu, Xu, Xu, Xu, Xu, Xu, Xu, Xu, Xu, Xu, Xu, Xu, Xu, Xu, Xu, Xu, Xu, Xu, Xu, Xu, Xu, Xu, Xu, Xu, Xu, Xu, Xu, Xu, Xu, Xu, Xu, Xu, Xu, Xu, Xu, Xu, Xu, Xu, Uu
Xu, Xu, Xu, Xu, Xu, Xu, Xu, Xu, Xu, Xu, Xu, Xu, Xu, Xu, Xu, Xu, Xu, Xu, Xu, Xu, Xu, Xu, Xu, Xu, Xu, Xu, Xu, Xu, Xu, Xu, Xu, Xu, Xu, Xu, Xu, Xu, Xu, Xu, Xu, Xu, Xu, Xu, Xu, Xu, Xu, Xu, Xu, Xu, Xu, Xu, Xu, Xu, Xu, Xu, Xu, Xu, Xu, Xu, Xu, Xu
