Wog, Wog, Wog, Xu, Xu, Xu, Xu, Xu, Xu, Uu^Tf, Tb^Tf, Uu^Tf, Rr, Rr, Uh, Qxu, Qxu, Xu^Qhh, Xu^Qhh, Xu^Qhh, Xu^Qhh, Xu^Qhh, Wog^Qhh, Wog^Qhh, Xu^Qhh, Xu^Qhh, Xu^Qhh, Xu, Xu, Xu, Xu, Xu, Xu, Xu, Xu, Xu, Xu, Xu, Xu, Xu, Xu, Xu, Xu, Xu, Xuc, Uh, Tb^Tf, Ur, Ur, Uh, Xuc, Xuc, Xuc, Xuc, Xuc, Xuc, Uu, Uu, Uu, Xu
Wog, Wog, Wog, Xu, Xu, Xu, Xu, Xu, Cud, Uh^_mh, Uu^Tf, Rr, Re^Tf, Uu^Vud, Qxu, Qxu, Xu, Xu^Qhh, Xu, Xu, Wog, Wog, Xu, Xu, Xu, Xu^Qhh, Xu^Qhh, Xu^Qhh, Xu, Xu, Xu, Xu, Xu, Xu, Xu, Xu, Xu, Xu, Xu, Xu, Xu, Xu, Xu, Xu, Xu, Uh, Uh, Uu^Tf, Ur, Uh, Uh, Tb^Tf, Uu^Tf, Xuc, Ur^Edt, Uu^Tf, Ur^Edt, Uu^_mhh, Xu, Xu
Wog, Wog, Wog, Wwg, Xuc, Xu, Xu, Cud, 3 Kud, Cud, Uu^Vu, Rr, Re^Tf, Uh, Qxu, Qxu, Xu, Xu^Qhh, Xu, Xu, Wog, Xu, Xu, Xu^_mhh, Xu, Xu^Qhh, Xu, Xu, Xu, Xu, Xu, Xu, Xu, Xu, Xu, Xu, Xu, Xu, Xu, Xu, Xu, Xu, Xu, Xu, Xu, Xuc, Xuc, Uu, Uu^Edt, Ur^Edt, Re^Tf, Uu, Uu^Vud, Ur, Uh, Uu^Edt, Tb^Tf, Uh, Xu, Xu
Xu, Wog, Wog, Wog, Wwg, Xuc, Xu, Cud, Cud, Cud, Rr^Edt, Rr^Edt, Uh, Qxu, Xu, Xu, Xu, Xu^Qhh, Xu, Wog, Wog, Xu, Xu, Xu, Xu^Qhh, Xu^Qhh, Xu, Xu, Xu, Xu, Xu, Xu, Xu, Xu, Xu, Xu, Xu, Xu, Xu, Xu, Xu, Xu, Xu, Xu, Xu, Xuc, Xuc, Uh, Uu^Em, Uu^Edt, Ur, Uu, Re^Tf, Uu, Xu, Re^Tf, Xu, Xu, Xu, Xu
Xu, Wog, Wog, Wog, Wog^Xo, Xuc, Xuc, Xuc, Uu^Vud, Re^Tf, Rr^Edt, Re^Tf, Xuc, Xuc, Xu, Xu, Xuc, Xuc^Qhh, Wog, Wog^Xo, Xu, Xu, Xu, Xu, Xu^Qhh, Xu, Xu, Xu, Xu, Xu, Xu, Xu, Xu, Xu, Xu, Xu, Xu, Xu, Xu, Xu, Xu, Xu, Xu, Xu, Qxu, Qxu, Xuc, Xuc, Tb^Tf, Uu^Emf, Ur^Edt, Uh, Qxu, Xuc, Xu, Xu, Xuc, Xuc, Xuc, Xu
Xu, Wwg, Wwg^Xo, Wog^Xo, Wog, Wog, Wog, Wwrg, Wwrg, Uu^Em, Wwf, Uu^Em, Uu^Es, Xuc, Xu, Xu, Wog, Wog^Qhh, Wog^Qhh, Xu, Xu, Xu, Xu, Xu^Qhh, Xu, Xu, Xu, Xu, Xu, Xu, Xu, Xu, Xu, Xu, Xu, Xu, Xu, Xu, Xu, Xu, Xu, Xu, Xuc^Qhh, Xu, Qxu, Qxu, Qxu, Xuc, Uu^Tf, Uu^Vu, Ur, Uh, Qxu, Qxu, Qxu, Qxu, Qxu, Uh, Uh, Xu
Xu, Xu, Xu, Wwg, Wwg, Wog, Wog, Wog, Wwg, Wwf, Wwg, Wwf, Wwf^Es, Wwrg, Wwrg, Wog, Wwg, Wog, Wog^Qhh, Xu, Xu, Xu, Xu^Qhh, Xu^Qhh, Xu, Xu, Xu, Xu, Xu, Xu, Xu, Xu, Xu, Xu, Xu, Xu, Xu, Xu, Xu, Xu, Xu, Xu, Xuc, Xuc^Qhh, Xuc, Qxu, Re^Tf, Uu, Uh, Ur^Edt, Uh, Qxu, Qxu, Qxu, Qxu, Qxu, Qxu, Uh, Uh, Xuc
Xu, Xu, Xu, Xu, Xu, Xu, Xu, Xuc, Xuc, Wwf^Es, Wwf^Es, Wwrg, Wwf, Wwg, Wwg, Wog, Wwg, Wog, Wog, Xu^Qhh, Xu^Qhh, Xu^Qhh, Xuc, Xu, Xu, Xu, Xu, Xu, Xu, Xu, Xu, Xu, Xuc, Xu, Xuc, Xu, Xuc, Xu, Qxu, Qxu, Qxu, Qxu, Tb^Tf, Xuc^Qhh, Tb^Qhh, Re^Tf, Uh, Re^Tf, Re^Tf, Uu^Tf, Cer^Edb, Cer, Cer, Uu, Re^Tf, Uu^Tf, Uu^Vu, Uh, Uu^Tf, Uh
Xu, Xu, Xu, Xu, Xu, Xu, Xu, Xuc, Xuc, Wwf, Re^Tf, Wwg, Re, Wwf^Es, Uu, Wwrg, Xuc, Wog, Wog, Wog, Wog^Xo, Xu, Xu, Xu, Xu, Xu, Xuc, Xu, Xu, Xu, Xu, Xu, Xuc, Xu, Uh, Xuc, Tb^Tf, Qxu, Re^Tf, Qxu, Uh, Uh, Re^Tf, Tb^Emf, Uu^Qhh, Re^Tf, Uh, Uu^Vud, Ur^Es, Ur, Cer^Edb, 5 Ket, Cer^Edb, Ur, Ur^Br\, Ur^Es, Ur^Es, Uh, Uu^Tf, Uu^Tf
Xu, Xu, Xu, Xu, Xu, Xu, Xu, Xuc, Xuc, Uh, Re^Tf, Re^Tf, Uu^Edt, Re^Edt, Re^Edt, Uh, Xuc, Xuc, Xu, Wog^Xo, Wog, Wog, Wog, Xu, Xu, Xuc, Xuc, Xuc, Xu, Xu, Xu, Xuc, Xu, Tb^Tf, Re^Tf, Uh, Tb^Tf, Uu^Tf, Uh, Re^Tf, Re^Tf, Uh, Re^Em, Uu^Em, Uu^Br/, Re^Qhh, Re^Qhh, Ur, Uu^Tf, Re^Tf, Uh, Cer^Edb, Cer, Cer, Uu^Tf, Uu^Br/, Uu^Tf, Tb^Tf, Uu^Tf, Ur^Br\
Xu, Xu, Xu, Xu, Xu, Xu, Xu, Xu, Qxu, Qxu, Uh, Uu, Rr, Rr^Edt, Re^Edt, Re^Tf, Uh, Xuc, Xu, Xu, Xu, Wog, Xu, Xu, Xu, Xuc, Xu, Xu, Xu, Xu, Xuc, Xuc, Re^Tf, Tb^Tf, Uh^Emf, Re^Tf, Uu, Cud, Uu, Uh, Uu^Em, Uu^Em, Uu^Br/, Uu, Ur^Es, Ur, Re^Tf, Uh^Qhh, Uu^Tf, Uu^Vu, Uu^Tf, Uh, Uh, Uh, Xuc, Uh, Tb^Tf, Tb^Tf, Uh, Uu
Xu, Xu, Xu, Xu, Xu, Xu, Qxu, Qxu, Xu, Qxu, Tb^Tf, Uh, Rr^Em, Uu^Tf, Re^Tf, Re^Em, Uu, Xu, Xu, Xuc, Xuc, Xu, Xuc, Xuc, Xu, Xu, Xu, Xu, Xu, Xuc, Uh, Uu, Re^Emf, Uh, Uh, Tb^Tf, Uu^Tf, Ur, Ur^Edb, Uu^Tf, Ur^Emf, Ur^Br/, Ur, Uu^Tf, Re^Tf, Uu, Uu^Tf, Uh^Qhh, Xu^Qhh, Uh, Xu, Xu, Xu^Qhh, Xu^Qhh, Xuc^Qhh, Uh, Uh, Uh, Uh, Uh
Xu, Xu, Xu, Xu, Xu, Xu, Xu, Xu, Xu, Xuc, Qxu, Uu^Tf, Uue^Tf, Rr, Rr, Re, Uu, Tb^Tf, Tb^Tf, Xuc, Xuc, Xuc, Xuc, Xuc, Xuc, Xu, Xu, Xu, Uh, Xu, Uu, Cte, Uu^Em, Uu^Tf, Ur, Uu, Ur^Es, Uu, Uu^Edb, Ur^Br/, Uu^Qhh, Cud^Qhh, Cud^Qhh, Re^Emf, Re^Tf, Uu, Uh, Xuc, Xu, Xu^Qhh, Xu^Qhh, Xu^Qhh, Xu, Xu^Qhh, Xu^Qhh, Xu^Qhh, Xu^Qhh, Xu, Xu, Xu
Xu, Xu, Xu, Xuc, Xuc, Xu, Xu, Xu, Qxu, Qxu, Qxe, Re^Tf, Uhe, Uue, Uue^Tf, Re, Uu^Vu, Uh, Tb^Tf, Xuc, Xuc, Xuc, Xuc, Xuc, Xu, Xu, Xu, Xu, Xu, Uh, Uh, Ur^Edb, Rr^Edb, Ur, Uh, Uu, Uu^Br/, Ur^Br/, Ur^Edb, Uu^Qhh, Uu^Tf, Cud, Uu^_mhh, Uu^Qhh, Tb^Qhh, Re^Tf, Tb^Tf, Xuc, Xu, Xu, Xu, Xu, Xu, Xu, Xu, Xu^Qhh, Xu, Xu^Qhh, Xu^Qhh, Xu^Qhh
Qxu, Qxu, Qxu, Qxu, Xuc, Xu, Xu, Xu, Xu, Xu, Qxe, Re^Tf, Uue^Tf, Uhe, Uue, Rr, Rr^Edt, Re^Tf, Re^Tf, Uu^Tf, Xuc, Xuc, Cud, Cud, 2 Kud, Xuc, Xu, Xu, Uh, Xu, Rr, Rr^Edb, Cud, Uh, Ur^Edt, Ur^Edt, Uu, Cte, Ur, Uh^Qhh, Uh^Qhh, Uu, Uh, Uu^Vud, Uh^Qhh, Re^Tf, Uu^Tf, Xu, Xu, Xu, Xu, Xu, Xu, Xu, Xu, Xu, Xu, Xu, Xu, Xu^Qhh
Uh, Qxu, Qxu, Qxu, Qxu, Qxu, Qxu, Qxu, Xu, Xue, Qxe, Qxe, Uue^Tf, Re^Tf, Uue^Es, Uue^Edt, Rr^Edb, Re^Edt, Re, Re^Em, Re, Xuc, Uu, Cud, Cud, Cud, Uu, Uh, Uu^Vud, Re, Uu^Edt, Uu^Edb, Rr, Uh, Uu^Br/, Ur^Br|, Uh, Uu, Uu, Uh, Xu^Qhh, Uu^Tf, Uh^Qhh, Uh, Xu, Xuc^Qhh, Xu, Xu, Xu, Xu, Xu, Xu, Xu, Xu, Xu, Xu, Xu, Xu, Xu, Xu
Rr, Uu^Tf, Uh, Qxu, Qxe, Qxe, Qxe, Xue, Xue, Xue, Qxe, Qxe, Uue^Tf, Uue^Tf, Re, Uue, Xue, Rr, Uh, Uu^Vu, Uu^Tf, Uh, Uu, Uu, Re, Uu, Uu^Tf, Uu, Rr, Uu^Edt, Uu^Edt, Uu^Edb, Rr^Edb, Uu, Uh, Uu^Br|, Uu^Tf, Xu, Xuc, Xuc, Xuc, Xu^Qhh, Uh, Uh^Qhh, Uh^Qhh, Xuc^Qhh, Uh, Xu, Xu, Xu, Xu, Xu, Xu, Xu, Xu, Uh^Qspd, Uh, Xu, Xu, Xu
Rr^Edt, Uu^Edt, Uu^Vu, Tb^Tf, Cer^Edt, Uue^Tf, Uue^Tf, Uhe, Uhe, Uhe, Uhe, Uhe^Qhu, Uue^Qhu, Uue, Uue^Emf, Re, Re^Edb, Rr^Edt, Uu, Uh, Tb^Tf, Uh, Uu^Vud, Re, Uue^Tf, Re^Em, Re, Rr, Uu, Rr^Edb, Re, Re^Edb, Re^Es, Uu^Edt, Uu^Edt, Ur, Ur^Es, Xuc, Xuc, Xuc, Wwrg, Uh, Chw, Chw, Wwg, Uh, Wog, Wwrg, Wog, Wwrg, Wwrg, Xu, Xu, Xu, Ur, Uh, Uh, Xu, Xu, Xu
Uu, Rr^Edt, Rr^Edt, Uh, Cer, Cer^Edb, Cer^Edt, Uue^Vu, Uue, Tb^Tf, Tb^Qhu, Uhe^Qhu, Re^Qhu, Uue, Uue^Tf, Uue^Tf, Re, Rr^Edb, Re, Uu, Uu, Uh, Rr, Uue, Uue^Tf, Uu^Tf, Uu^Vu, Uu, Cte, Uh, Uh, Rr^Edb, Uh, Uu^Edt, Uu^Tf, Uu^Tf, Ur, Rb, Wwf^Es, Wwg, Wwg, Wwg, Wog, Wwg, Wog, Wog, Wog, Xu, Xu, Wog, Wog, Wwg, Wwf^Es, Uu, Uu, Chw, Chw, Uh, Xu, Xu
Xu, Uu^Tf, Uu, Cer^Edt, Cer^Edt, 4 Ker, Cer^Edt, Rr, Rr, Rr, Rr^Edt, Uue^Qhu, Rr, Re^Em, Rr, Re, Re^Tf, Cud, Uu, Re, Rr, Xue, Re, Re^Tf, Rr, Uu^Tf, Tb^Tf, Uh, Uu, Uh, Xu, Xu, Xu^Qhh, Xu^Qhh, Xu^Qhh, Uu^Tf, Wwf^Es, Wwrg, Wwrg, Wwrg, Wwg, Wog, Wwg, Wog, Wwg, Wog, Wwf^Es, Wog, Wog, Wog, Wwrg, Wog, Wwg, Wwrg, Wwrg, Chw, Wwg, Uh, Xu, Xu
Xu, Uu^Tf, Uh, Cer^Edt, Uu^Vud, Cer^Edb, Uu^Tf, Uu^Tf, Uu, Uue, Uue, Rr^Edt, Uue^Tf, Rr, Re^Tf, Rr^Edb, Rr^Edb, Uu, Re^Tf, Rr^Edb, Uue^Edb, Uue, Uue^Tf, Re^Edt, Rr^Edt, Uu^Edb, Uu^Tf, Uh, Uh, Xu, Xu^Qhh, Xu^Qhh, Xu, Xuc, Wwrg^Qhh, Wwg^Qhh, Wwf, Wwg, Wwf^Es, Wwf^Es, Rr, Wwrg, Uu, Uh, Xu, Xu, Xu, Wwrg, Xu, Wwrg, Xu, Wwg, Xu, Wwg, Wog, Wog, Wog, Xu, Xu, Xu
Xuc, Xuc, Xuc, Uu^Tf, Uu^Tf, Uu, Uu, Uu^Tf, Uhe, Uue^Tf, Uue, Uue, Re^Em, Re^Em, Uue, Re^Edt, Rr^Edt, Xue, Re^Tf, Rr^Edb, Rr^Edb, Uue, Rr^Edb, Re^Edb, Uue^Edb, Rr^Edb, Cud, Uu, Xuc^Qhh, Xu^Qhh, Xuc, Xuc, Wwf^Es, Wwf^Es, Wwg^Qhh, Wwg, Wwg, Wwrg, Uh, Uu, Rb, Rb, Rb^Tf, Uu^Tf, Uh, Xu, Xu, Xu, Xu, Xu, Xu, Xu, Xu, Xu, Uu, Wog, Wog, Wog, Wwg, Xu
Xos, Xuc, Xuc, Tb^Tf, Tb^Tf, Uh, Rr, Uhe, Re, Uue^Tf, Re, Re, Re^Edb, Re^Tf, Uue, Re^Em, Rr^Edb, Rr, Re^Es, Rr^Edb, Uue, Rr^Edb, Uue, Rr^Edb, Rr, Cud, Kud, Cud, Xuc^Qhh, Xu, Wwf^Pr\, Wwf, Xu, Xu^Qhh, Wog, Wog, Wwg, Wwf, Uh, Uu^Vud, Rb^Tf, Rr, Rb^Em, Tb^Tf, Tb^Tf, Xuc, Xu, Xu, Xu, Xu, Xu, Xu, Xu, Xu, Wwf, Wwg, Wwg, Wog, Wog, Wwg
Xos, Xos, Xos, Uh, Uh, Uu^Tf, Rr, Re, Re, Uue^Vu, Uue, Uue, Rr, Rr, Rr, Rr, Re^Tf, Uue, Uue, Re^Edt, Re^Edt, Cud, Uue, Uue^Tf, Tb^Tf, Cud, Cud, Cud, Xuc^Qhh, Xu, Wwf^Es, Xu, Wwrg, Wwg, Wwg, Wwg, Wwrg, Xu^Qhh, Xuc, Tb^Tf, Tb^Tf, Rr, Rb, Rb^Tf, Ur, Uh, Xu, Xu, Xu, Xu, Xu, Xu, Uh, Uh, Wwf, Wwrg, Xu, Wog, Wog, Wwg
Xos, Xos, Qxu, Uh, Rr^Edt, Rr^Edt, Qxu, Uu^Tf, Uhe^Qhh, Uhe^Qhh, Uue^Qhh, Rr^Qhh, Re^Qhh, Uhe, Xue, Re^Tf, Re^Edt, Uue^Edb, Uue^Vu, Re^Tf, Re^Tf, Re^Tf, Re^Tf, Uue^Tf, Re, Tb^Tf, Uue, Cud^Qhh, Uue^Vud, Xuc, Wwf^Es, Xu, Wwrg, Wwg, Xu, Wwg, Xu, Xu^Qhh, Xuc, Tb^Tf, Uu^Tf, Uu, Rb^Tf, Re^Tf, Uu^Vud, Uh, Tb^Tf, Xu, Uh, Uh^Qspd, Uh, Xu, Xu, Tb^Tf, Wwf, Wwf, Xu, Wwg, Wwg, Wog
Qxu, Qxu, Qxu, Uu^Vu, Re^Edt, Re^Edt, Qxu, Qxu, Qxu, Uu^Vud, Uu, Uue^Tf, Uue^Tf, Uue^Qhh, Xue^Qhh, Xue, Uhe, Re^Edb, Uue, Re^Tf, Re^Emf, Rr, Re^Tf, Re, Xue, Re^Es, Uue, Uue^Qhh, Uue, Wwg, Xuc, Xu, Xu, Wwg, Xu, Wwg, Xu^Qhh, Xu^Qhh, Tb^Tf, Uh^Qhh, Rr, Rb, Rb^Tf, Tb^Tf, Xu, Xu, Tb^Tf, Uh, Qxu, Qxu, Uh, Uu, Tb^Tf, Re^Tf, Re^Tf, Xu, Xu, Xu, Xu, Wwg
Qxu, Qxu, Uh, Uu, Uu^Tf, Qxu, Qxu, Qxu, Qxu, Qxu, Xu^Qhh, Xu^Qhh, Xu^Qhh, Uhe, Xue^Qhh, Xue, Uhe, Uue, Cud, Re^Tf, Re^Tf, Re, Rr^Edt, Uue^Tf, Uue^Qhh, Re, Uue^Qhh, Uue^Qhh, Wwf, Wwg, Uue^Tf, Xuc, Wwg, Xu, Wwg, Xu, Xu^Qhh, Xu, Uu^Tf, Rb^Tf, Rb^Em, Rb, Uh, Rb^Tf, Tb^Tf, Xu, Xu, Uh, Qxu, Qxu, Qxu, Uh, Xu, Tb^Tf, Xu, Xu, Xu, Xu, Xu, Xu
Qxu, Qxu, Rr^Edt, Rr, Uu^Tf, Qxu, Qxu, Qxu, Uu^Tf, Xu^Qhh, Xu, Xu, Xu, Xu^Qhh, Xu, Xue^Qhh, Xue^Qhh, Uhe, Uue^Tf, Tb^Tf, Re^Tf, Re^Em, Re^Edt, Rr^Edt, Rr^Qhh, Rr, Rr, Wwg, Wwf, Uue^Tf, Uhe, Xu, Wwg, Wwg, Xu, Xu^Qhh, Xu, Xor, Rb^Pr\, Rr, Rr, Uh, Xu, Uu^Tf, Xos^Qhh, Xu^Qhh, Xu^Qhh, Xu, Xu, Qxu, Qxu, Xu, Xu, Xu, Xu, Xu, Xu, Xu, Xu, Xu
Qxu, Re^Tf, Re^Edt, Uu^Edt, Uu^Tf, Re^Tf, Re, Re^Tf, Re, Uu, Uu^Ii, Uu^Tfi, Uh^Ii, Xu, Xuc, Xu, Xu, Xue^Qhh, Uhe, Tb^Tf, Tb^Tf, Re^Tf, Uue^Tf, Re^Tf, Re^Qhh, Re^Tf, Rr, Wwf^Es, Uue^Tf, Uue^Tf, Wwf, Wwf^Es, Wwg, Wwg, Xu^Qhh, Xu^Qhh, Tb^Tf, Uu^Vu, Rb, Rb^Pr\, Xor, Xu, Xos^Qhh, Xos^Qhh, Uh, Xuc, Xuc, Xu^Qhh, Qxu, Qxu, Qxu, Xu, Xu, Xu, Qxu, Qxu, Qxu, Xu, Xu, Xu
Re, Uu, Re, Qxu, Xuc, Xuc, Xuc, Xuc, Qxu, Uu^Tfi, Uu^Tfi, Uu^Ii, Uh^Ii, Qxu, Qxu, Xu, Xu, Xue^Qhh, Xue, Uhe, Xue, Qxe, Uhe, Uue^Qhh, Tb^Tf, Re^Emf, Re, Wwf, Wwrg, Wwg, Wwg, Wwf^Es, Wwf^Es, Wwrg, Xu^Qhh, Xu, Rb^Tf, Rb, Rb^Em, Xu, Xu, Xos, Xu^Qhh, Uh, Urb, Uh, Xu, Xu^Qhh, Xu^Qhh, Qxu, Xu, Xu, Xu, Uh, Uu, Qxu, Qxu, Xu, Xu, Xu
Rr, Re, Qxu, Qxu, Xuc, Xuc, Xuc, Xuc, Xuc, Qxu, Qxu, Uh^Ii, Qxu, Qxu, Qxu, Xos, Xu, Xue^Qhh, Xu^Qhh, Xue, Xue, Qxe, Qxe, Uhe^Qhh, Tb^Tf, Re^Tf, Uue^Tf, Wwrg, Wwg, Wwf^Es, Wwrg, Wwf, Xor^Qhh, Xor^Qhh, Xu, Re^Tfi, Rb^Tf, Rb^Edt, Uu, Uu^Tf, Cte^Edt, Xu, Urb, Urb^Qhh, Xu, Uh, Xu, Xu, Xu, Xu^Qhh, Xu^Qhh, Xu, Uh, Tb^Tf, Uh, Qxu, Xu, Xu, Xu, Xu
Qxu, Qxu, Qxu, Xuc, Xuc, Xuc, Xu, Xuc, Xos, Qxu, Qxu, Qxu, Qxu, Qxu, Xos, Xos, Xos, Xu, Xu, Xue^Qhh, Xu^Qhh, Xue, Xu^Qhh, Uhe^Qhh, Tb^Tf, Uue^Tf, Wwg, Wwf^Es, Wwrg, Wwf, Wwf^Pr/, Wwf^Pr/, Wwf, Uu^Tf, Uu^Vud, Re^Tf, Rr^Edt, Rr^Edt, Uu, Uu^Tf, Cte^Edt, 6 Kte^Edt, Xu, Xu^Qhh, Xu, Xu, Uu, Xu, Uu, Xu, Uh, Uh^Qhh, Xu^Qhh, Uh, Xu, Qxu, Qxu, Xu, Xu, Xu
Qxu, Qxu, Xuc, Xuc, Xuc, Xuc, Xu, Xos, Xos, Xos, Xos, Qxu, Xos, Xos, Xos, Xos, Xu, Xu, Xu, Xu, Xu, Xu^Qhh, Uu^Tf, Xu, Uh, Wwrg, Wwg, Wwg, Xor, Wwf^Pr/, Uh, Rr, Rr, Uu^Tf, Rb, Rb^Em, Rb, Uu, Rb^Edt, Uu^Vu, Uu, Cte^Edt, Cte^Edt, Xu^Qhh, Xu, Uu, Xu, Uu, Xu, Qxu, Xu, Xu, Xu, Xu^Qhh, Xu^Qhh, Qxu, Qxu, Xu, Xu, Xu
Xu, Xu, Xuc, Xuc, Xu, Xu, Xu, Xu, Xu, Xos, Xos, Xos, Xos, Xos, Xu, Xu, Xu, Xuc, Xu, Xu, Xu, Uh, Uu, Uu^Tf, Wwrg, Wwg, Wwg, Wwrg, Xor, Xor, Xor, Rb, Re^Tf, Rr, Uu^Tf, Uu, Uu, Uu, Rr^Edt, Rr^Edt, Rb^Em, Uu^Em, Uu^Qhh, Xu^Qhh, Xu, Qxu, Qxu, Qxu, Qxu, Qxu, Qxu, Uu, Uu, Xu, Xu, Xu^Qhh, Xu^Qhh, Xu, Xu, Xu
Xu, Xu, Xu, Xu, Xu, Xu, Xu, Xu, Xu, Xu, Xu, Xu, Xu, Xu, Xu, Xu, Xu, Xu, Xu, Xu, Xu, Uu^Tf, Wwrg, Wwg, Wwg, Wog, Wwg, Wwrg, Xu, Xor, Uh^Ii, Uh, Uu^Tf, Re^Tf, Uh, Uh, Uu^Tf, Uu^Tf, Uu^Tf, Rr^Edt, Uu^Tf, Uu^Em, Rr^Qhh, Uu^Vud, Uu^Tf, Tb^Tf, Uu^Tf, Qxu, Uu^Tf, Qxu, Uh, Qxu, Qxu, Xu, Xu, Xu, Xu, Xu^Qhh, Xu^Qhh, Xu
Xu, Xu, Uh, Uh, Uu^Tf, Xu, Xu, Xu, Uh, Xu, Xu, Xu, Xu, Xu, Uu^Tf, Uh, Uh, Uu^Tf, Xu, Xu, Wwg, Wwrg, Wwg, Wog, Wog, Wog, Xu, Xu, Xu, Xu, Uh^Ii, Uu^Tfi, Uu^Em, Uu^Vu, Xos, Xu, Ur, Xu, Tb^Tf, Uh, Tb^Tf, Uu, Rr^Qhh, Rb^Em, Uu, Uu^Tf, Uu, Uu, Rr, Uh, Uu, Uh, Uu^Vud, Uh, Tb^Tf, Xu, Xu, Xu, Xu, Xu^Qhh
Uu, Uu^Tf, Uu, Uu^Tf, Wwg, Wwrg, Wwg, Wwg, Wog, Wwg, Wwg, Wwrg, Wog, Wwrg, Wwg, Uu, Xu, Xu, Wwg, Wwg^Xo, Wog^Xo, Wwg, Wwrg, Wog, Uu^Tf, Uh, Xu, Xu, Uu^Tf, Uh, Qxu, Qxu, Uh, Xu, Xu, Uh, Rb, Uh, Xu, Tb^Tf, Xu, Uh, Uu^Tf, Rr^Qhh, Uu, Rr, Rb, Rr, Rb^Em, Rr, Rb^_mh, Uu, Rb, Uu, Uu, Xu, Xu, Xu, Xu, Xu
Wwg, Wwrg, Wog, Wwg, Xu, Wog, Wog, Wwg, Wwg, Wog, Wwg, Wwg, Wog, Wog, Wog, Wwg, Wwg, Wwg, Wog, Wog, Wwg, Wwg^Xo, Wog^Xo, Uu, Xuc, Uu, Xu, Xu, Uu^Vud, Uu^Tf, Qxu, Qxu, Xu, Xu, Xu, Tb^Tf, Uu^Tf, Xu, Xu, Xu, Uu^Tf, Uh, Tb^Tf, Rb^Qhh, Uu^Vu, Uu, Re^Tf, Re^Tf, Re^Tf, Uu, Uu, Rr, Ce, Ce, Ce, Uh, Uh, Xu, Xu, Xu
Wog, Wwg, Wog, Wog, Xu, Xu, Wwg, Wwg, Xu, Wwg, Xu, Wwrg, Xu, Wog, Wwg, Wog, Wwg, Wwg, Wwg, Wwg, Wwrg, Wwrg, Uh, Xuc, Xuc, Xuc, Xu, Xu, Qxu, Qxu^Bs\, Ur^Em, Tb^Tf, Uu^Tf, Xu^Qspd, Xu, Xu, Xu, Xu, Xu, Qxu, Qxu, Tb^Tf, Uu^Tf, Uh^Qhh, Uu^Tf, Uu^Tf, Uu^Tf, Tb^Tf, Tb^Tf, Uu, Uu^Vu, Uu^Tf, Ce, 1 Ke, Rr, Uu, Uh, Uu, Xu, Xu
Wog, Wog, Wog, Wog, Uu^Tf, Wwrg, Uu^Tf, Xu, Xu, Xu, Xu, Xu, Xu, Xu, Uh, Wwrg, Xu, Wwg, Uh, Uu, Uu^Tf, Uh, Uu^Tf, Xuc, Uh, Xuc, Xu, Xu, Qxu, Qxu, Xu, Uh^Qspd, Xu, Uh, Xu, Xu, Xu, Xu, Xu, Xu, Qxu, Uu^Tf, Qxu, Xu^Qhh, Uu^Tf, Uh, Qxu, Uh, Xu, Uh, Uh, Uu, Uu, Ce, Rb, Rb, Rb, Uu, Uu, Xu
Wwg, Wwg, Uh, Uu^Tf, Uh, Uu^Tf, Xu, Xu, Xu, Xu, Xu, Uu^Tf, Uu^Tf, Uh, Uu^Tf, Uu, Xu, Xu, Xu, Xu, Xu, Xu, Xu, Uu, Xu, Xu, Xu, Qxu, Qxu, Qxu, Xu, Xu, Xu, Xu, Xu, Xu, Xu, Xu, Xu, Qxu, Qxu, Qxu, Xu^Qhh, Xu^Qhh, Qxu, Qxu, Xu, Xu, Xu, Xu, Xu, Xu, Xu, Uu, Uu^Vud, Rb, Rr, Rb, Uh, Uu
Xu, Xu, Xu, Xu, Xu, Xu, Xu, Xu, Xu, Xu, Xu, Xu, Xu, Xu, Xu, Xu, Xu, Xu, Xu, Xu, Xu, Xu, Xu, Xu, Xu, Xu, Xu, Xu, Qxu, Xu, Xu, Xu, Xu, Xu, Xu, Qxu, Qxu, Xu, Qxu, Qxu, Qxu, Xu, Xu^Qhh, Qxu, Qxu, Qxu, Xu, Xu, Xu, Xu, Xu, Xu, Xu, Xu, Qxu, Uh, Uu, Uu, Rb, Uu
Xu, Xu, Xu, Xu, Xu, Xu, Xu, Xu, Xu, Xu, Xu, Xu, Xu, Xu, Xu, Xu, Xu, Xu, Xu, Xu, Xu, Xu, Xu, Xu, Xu, Xu, Xu, Xu, Xu, Qxu, Qxu, Qxu, Qxu, Xu, Qxu, Qxu, Xu, Qxu, Xu, Xu, Xu, Xu, Xu, Xu^Qhh, Xu^Qhh, Xu, Xu, Xu, Xu, Xu, Xu, Xu, Xu, Xu, Qxu, Qxu, Uh, Uh, Uu, Rr
Xu, Xu, Xu, Xu, Xu, Xu, Xu, Xu, Xu, Xu, Xu, Xu, Xu, Xu, Xu, Xu, Xu, Xu, Xu, Xu, Xu, Xu, Xu, Xu, Xu, Xu, Xu, Xu, Xu, Xu, Xu, Qxu, Xu, Qxu, Xu, Qxu, Xu, Xu, Xu, Xu, Xu, Xu, Xu, Xu, Xu^Qhh, Xu, Xu, Xu, Xu, Xu, Xu, Xu, Xu, Xu, Xu, Qxu, Xu, Uh, Uh, Uu
Xu, Xu, Xu, Xu, Xu, Xu, Xu, Xu, Xu, Xu, Xu, Xu, Xu, Xu, Xu, Xu, Xu, Xu, Xu, Xu, Xu, Xu, Xu, Xu, Xu, Xu, Xu, Xu, Xu, Xu, Xu, Xu, Xu, Xu, Xu, Xu, Xu, Xu, Xu, Xu, Xu, Xu, Xu, Xu, Xu^Qhh, Xu, Xu, Xu, Xu, Xu, Xu, Xu, Xu, Xu, Xu, Xu, Xu, Xu, Xu, Uu
Xu, Xu, Xu, Xu, Xu, Xu, Xu, Xu, Xu, Xu, Xu, Xu, Xu, Xu, Xu, Xu, Xu, Xu, Xu, Xu, Xu, Xu, Xu, Xu, Xu, Xu, Xu, Xu, Xu, Xu, Xu, Xu, Xu, Xu, Xu, Xu, Xu, Xu, Xu, Xu, Xu, Xu, Xu, Xu, Xu^Qhh, Xu, Xu, Xu, Xu, Xu, Xu, Xu, Xu, Xu, Xu, Xu, Xu, Xu, Xu, Xu
