Xoc, Xoc, Xoc, Xoc, Xoc, Xoc, Xoc, Xoc, Xoc, Xoc, Xoc, Xoc^Zok, Xoc^Zok, Xoc^Zok, Xoc^Zok, Xoc^Zok, Xoc^Zok, Xoc^Zok, Xoc, Xoc, Xoc, Xoc, Xoc, Xoc, Xoc, Xoc, Xoc, Xoc, Xoc
Xoc, Xoc, Xoc, Xoc, Xoc, Xoc, Xoc, Xoc, Xoc, Xoc, Xoc, Xoc^Zok, Cud^Zok, Xoc^Zok, Cud^Zok, Xoc^Zok, Cud^Zok, Xoc^Zok, Xoc, Xoc, Xoc, Xoc, Xoc, Xoc, Xoc, Xoc, Xoc, Xoc, Xoc
Xoc, Xoc, Xoc, Xoc, Xoc, Xoc, Xoc, Xoc, Xoc, Xoc, Xoc, Xoc^Zok, Cud^Zok, Cud^Zok, Cud^Zok, Cud^Zok, Cud^Zok, Xoc^Zok, Xoc, Xoc, Xoc, Xoc, Xoc, Xoc, Xoc, Xoc, Xoc, Xoc, Xoc
Xoc, Xoc, Xoc, Xoc, Xoc, Xoc, Xos^Zok, Xos^Zok, Xos^Zok, Xoc, Xoc, Xoc, Cud, Cud, Cud, Cud, Cud, Xoc, Xoc, Xoc, Xoc^Zok, Xoc^Zok, Xoc^Zok, Xoc, Xoc, Xoc, Xoc, Xoc, Xoc
Xoc, Xoc, Xoc, Xoc, Xoc, Xos^Zok, Re^Zok, Re^Zok, Re^Fds, Xoc, Xoc^Efs, Xoc, Cud, Cud^Ebn, 2 Kud^Ii, Cud^Ebn, Cud, Xoc, Xoc^Efs, Xoc, Re^Gvs, Re^Zok, Re^Zok, Xoc^Zok, Xoc, Xoc, Xoc, Xoc, Xoc
Xoc, Xoc, Xoc, Xoc, Xoc, Xos^Zok, Xoc, Re^Gvs, Rp^Emf, Rp, Cud, Cud, Xoc, Cud, Cud, Cud, Xoc, Cud, Cud, Rp, Rp^Em, Re^Gvs, Xoc, Xoc^Zok, Xoc, Xoc, Xoc, Xoc, Xoc
Xoc, Xoc, Xoc, Xoc, Xoc, Xoc, Xoc, Xoc, Cud, Cud, Xoc, Isr, Isc, Isc, Isc, Isc, Isc, Isr, Xoc, Cud, Cud, Xoc, Xoc, Xoc, Xoc, Xoc, Xoc, Xoc, Xoc
Xoc, Xoc, Xoc, Xoc, Xoc, Xoc, Xoc, Cud, Wog, Wog, Rr, Isr, Isc^Ebn, Isc, Isc, Isc, Isc^Ebn, Isr, Rr, Wog, Wog, Cud, Xoc, Xoc, Xoc, Xoc, Xoc, Xoc, Xoc
Xoc, Xoc, Xoc, Xoc, Xoc^Zok, Xoc, Rp, Cud, Wog, Wog, Xoc, Isr, Isc, Isc, Isc, Isc, Isc, Isr, Xoc, Wog, Wog, Cud, Rp, Xoc, Xoc^Zok, Xoc, Xoc, Xoc, Xoc
Xoc, Xoc, Xoc, Xoc^Zok, Re^Zok, Re^Gvs, Rp^Em, Cud, Wog, Wog, Rr, Isr, Isc, Isc, Isc, Isc, Isc, Isr, Rr, Wog, Wog, Cud, Rp^Emf, Re^Gvs, Re^Zok, Xoc^Zok, Xoc, Xoc, Xoc
Xoc, Xoc, Xoc, Xoc^Zok, Re^Zok, Re^Gvs, Rp^Em, Cud, Wog, Wog, Rr, Isr, Isc, Isc, Isc, Isc, Isc, Isr, Rr, Wog, Wog, Cud, Rp^Em, Re^Fds, Re^Zok, Xoc^Zok, Xoc, Xoc, Xoc
Xoc, Xoc, Xoc, Xoc^Zok, Xoc^Zok, Re^Fds, Rp^Emf, Cud, Wog, Wog, Xoc, Isr, Isc, Isc, 1 Isc, Isc, Isc, Isr, Xoc, Wog, Wog, Cud, Rp^Fds, Re^Gvs, Xoc^Zok, Xoc^Zok, Xoc, Xoc, Xoc
Xoc, Xoc, Xoc, Xoc, Xoc, Xoc, Xoc, Cud, Wog, Wog, Rr, Isr, Isc^Ebn, Isc, Isc, Isc, Isc^Ebn, Isr, Rr, Wog, Wog, Cud, Xoc, Xoc, Xoc, Xoc, Xoc, Xoc, Xoc
Xoc, Xoc, Xoc, Xoc, Xoc^Zok, Xoc, Rp^Fdw, Cud, Wog, Wog, Xoc, Isr, Isc, Isc, Isc, Isc, Isc, Isr, Xoc, Wog, Wog, Cud, Rp, Xoc, Xoc^Zok, Xoc, Xoc, Xoc, Xoc
Xoc, Xoc, Xoc, Xoc^Zok, Re^Zok, Re^Gvs, Rp^Em, Cud, Wog, Wog, Rr, Isr, Isc, Isc, Isc, Isc, Isc, Isr, Rr, Wog, Wog, Cud, Rp^Fds, Re^Fds, Re^Zok, Xoc^Zok, Xoc, Xoc, Xoc
Xoc, Xoc, Xoc, Xoc^Zok, Re^Zok, Re^Gvs, Rp^Emf, Cud, Wog, Wog, Rr, Isr, Isc, Isc, Isc, Isc, Isc, Isr, Rr, Wog, Wog, Cud, Rp^Emf, Re^Fds, Re^Zok, Xoc^Zok, Xoc, Xoc, Xoc
Xoc, Xoc, Xoc, Xoc^Zok, Xoc^Zok, Re^Gvs, Rp, Cud, Wog, Wog, Xoc, Isr, Isc, Isc, Isc, Isc, Isc, Isr, Xoc, Wog, Wog, Cud, Rp^Em, Re^Gvs, Xoc^Zok, Xoc^Zok, Xoc, Xoc, Xoc
Xoc, Xoc, Xoc, Xoc, Xoc, Xoc, Xoc, Cud, Wog, Wog, Rr, Isr, Isc^Ebn, Isc, Isc, Isc, Isc^Ebn, Isr, Rr, Wog, Wog, Cud, Xoc, Xoc, Xoc, Xoc, Xoc, Xoc, Xoc
Xoc, Xoc, Xoc, Xoc, Xoc^Zok, Xoc, Rp, Cud, Wog, Wog, Xoc, Isr, Isc, Isc, Isc, Isc, Isc, Isr, Xoc, Wog, Wog, Cud, Rp^Em, Xoc, Xoc^Zok, Xoc, Xoc, Xoc, Xoc
Xoc, Xoc, Xoc, Xoc^Zok, Re^Zok, Re^Gvs, Rp^Emf, Cud, Wog, Wog, Rr, Isr, Isc, Isc, Isc, Isc, Isc, Isr, Rr, Wog, Wog, Cud, Rp^Emf, Re^Gvs, Re^Zok, Xoc^Zok, Xoc, Xoc, Xoc
Xoc, Xoc, Xoc, Xoc^Zok, Re^Zok, Re^Fds, Rp^Emf, Cud, Wog, Wog, Rr, Isr, Isc, Isc, Isc, Isc, Isc, Isr, Rr, Wog, Wog, Cud, Rp^Em, Re^Fds, Re^Zok, Xoc^Zok, Xoc, Xoc, Xoc
Xoc, Xoc, Xoc, Xoc^Zok, Xoc^Zok, Re^Fds, Rp^Em, Cud, Wog, Wog, Xoc, Isr, Isc, Isc, Isc, Isc, Isc, Isr, Xoc, Wog, Wog, Cud, Rp, Re^Gvs, Xoc^Zok, Xoc^Zok, Xoc, Xoc, Xoc
