border_size=1
usage=map

Xos         , Xos         , Xos         , Xos         , Xos         , Xos         , Xos         , Xos         , Xos         , Xos         , Xos         , Xos         , Xos         , Xos         , Xos         , Xos         , Xos         , Xos         , Xos         , Xos         , Xos         , Xos         , Xos         , Xos         , Xos         , Xos         , Xos         , Xos         , Xos         
Xos         , Xos         , Xos         , Xos         , Xos         , Xos         , Xos         , Xos         , Xos         , Xos         , Xos         , Xos         , Xos         , Xos         , Xos         , Xos         , Xos         , Xos         , Xos         , Xos         , Xos         , Xos         , Xos         , Xos         , Xos         , Xos         , Xos         , Xos         , Xos         
Xos         , Xos         , Xos         , Xos         , Xos         , Xos         , Xos         , Xos         , Xos         , Xos         , Xos         , Xos         , Xol         , Xol         , Cud         , Xol         , Xol         , Xos         , Xos         , Xos         , Xos         , Xos         , Xos         , Xos         , Xos         , Xos         , Xos         , Xos         , Xos         
Xos         , Xos         , Xos         , Xos         , Xos         , Xos         , Xos^Zok     , Xos^Zok     , Xos^Zok     , Xos         , Xos         , Xol         , Cud         , Cud         , Cud         , Cud         , Cud         , Xol         , Xos         , Xos         , Xos^Zok     , Xos^Zok     , Xos^Zok     , Xos         , Xos         , Xos         , Xos         , Xos         , Xos         
Xos         , Xos         , Xos         , Xos         , Xos         , Xos^Zok     , Re^Zok      , Re^Zok      , Re^Fds      , Xos         , Xol         , Xol         , Cud         , Cud^Bz      , Kud^Ii      , Cud^Bz      , Cud         , Xol         , Xol         , Xos         , Re^Gvs      , Re^Zok      , Re^Zok      , Xos^Zok     , Xos         , Xos         , Xos         , Xos         , Xos         
Xos         , Xos         , Xos         , Xos         , Xos         , Xos^Zok     , Xos         , Re^Gvs      , Rp^Emf      , Rp          , Cud         , Cud         , Xos         , Cud         , Cud         , Cud         , Xos         , Cud         , Cud         , Rp          , Rp^Em       , Re^Gvs      , Xos         , Xos^Zok     , Xos         , Xos         , Xos         , Xos         , Xos         
Xos         , Xos         , Xos         , Xos         , Xos         , Xos         , Xos         , Xos         , Cud         , Cud         , Xos         , Rr          , Rrc         , Rrc         , Rrc         , Rrc         , Rrc         , Rr          , Xos         , Cud         , Cud         , Xos         , Xos         , Xos         , Xos         , Xos         , Xos         , Xos         , Xos         
Xos         , Xos         , Xos         , Xos         , Xos         , Xos         , Xos         , Cud         , Wog         , Wog         , Rb          , Rr          , Rrc^Bz      , Rrc         , 2 Rrc       , Rrc         , Rrc^Bz      , Rr          , Rb          , Wog         , Wog         , Cud         , Xos         , Xos         , Xos         , Xos         , Xos         , Xos         , Xos         
Xos         , Xos         , Xos         , Xos         , Xos^Zok     , Xos         , Rp          , Cud         , Wog         , Wog         , Xos         , Rr          , Rrc         , Rrc         , Rrc         , Rrc         , Rrc         , Rr          , Xos         , Wog         , Wog         , Cud         , Rp          , Xos         , Xos^Zok     , Xos         , Xos         , Xos         , Xos         
Xos         , Xos         , Xos         , Xos^Zok     , Re^Zok      , Re^Gvs      , Rp^Em       , Cud         , Wog         , Wog         , Rb          , Rr          , Rrc         , Rrc         , Rrc         , Rrc         , Rrc         , Rr          , Rb          , Wog         , Wog         , Cud         , Rp^Emf      , Re^Gvs      , Re^Zok      , Xos^Zok     , Xos         , Xos         , Xos         
Xos         , Xos         , Xos         , Xos^Zok     , Re^Zok      , Re^Gvs      , Rp^Em       , Cud         , Wog         , Wog         , Rb          , Rr          , Rrc         , Rrc         , Rrc         , Rrc         , Rrc         , Rr          , Rb          , Wog         , Wog         , Cud         , Rp^Em       , Re^Fds      , Re^Zok      , Xos^Zok     , Xos         , Xos         , Xos         
Xos         , Xos         , Xos         , Xos^Zok     , Xos^Zok     , Re^Fds      , Rp^Emf      , Cud         , Wog         , Wog         , Xos         , Rr          , Rrc         , Rrc         , 1 Rrc       , Rrc         , Rrc         , Rr          , Xos         , Wog         , Wog         , Cud         , Rp^Fds      , Re^Gvs      , Xos^Zok     , Xos^Zok     , Xos         , Xos         , Xos         
Xos         , Xos         , Xos         , Xos         , Xos         , Xos         , Xos         , Cud         , Wog         , Wog         , Rb          , Rr          , Rrc^Bz      , Rrc         , Rrc         , Rrc         , Rrc^Bz      , Rr          , Rb          , Wog         , Wog         , Cud         , Xos         , Xos         , Xos         , Xos         , Xos         , Xos         , Xos         
Xos         , Xos         , Xos         , Xos         , Xos^Zok     , Xos         , Rp^Fdw      , Cud         , Wog         , Wog         , Xos         , Rr          , Rrc         , Rrc         , Rrc         , Rrc         , Rrc         , Rr          , Xos         , Wog         , Wog         , Cud         , Rp          , Xos         , Xos^Zok     , Xos         , Xos         , Xos         , Xos         
Xos         , Xos         , Xos         , Xos^Zok     , Re^Zok      , Re^Gvs      , Rp^Em       , Cud         , Wog         , Wog         , Rb          , Rr          , Rrc         , Rrc         , Rrc         , Rrc         , Rrc         , Rr          , Rb          , Wog         , Wog         , Cud         , Rp^Fds      , Re^Fds      , Re^Zok      , Xos^Zok     , Xos         , Xos         , Xos         
Xos         , Xos         , Xos         , Xos^Zok     , Re^Zok      , Re^Gvs      , Rp^Emf      , Cud         , Wog         , Wog         , Rb          , Rr          , Rrc         , Rrc         , Rrc         , Rrc         , Rrc         , Rr          , Rb          , Wog         , Wog         , Cud         , Rp^Emf      , Re^Fds      , Re^Zok      , Xos^Zok     , Xos         , Xos         , Xos         
Xos         , Xos         , Xos         , Xos^Zok     , Xos^Zok     , Re^Gvs      , Rp          , Cud         , Wog         , Wog         , Xos         , Rr          , Rrc         , Rrc         , Rrc         , Rrc         , Rrc         , Rr          , Xos         , Wog         , Wog         , Cud         , Rp^Em       , Re^Gvs      , Xos^Zok     , Xos^Zok     , Xos         , Xos         , Xos         
Xos         , Xos         , Xos         , Xos         , Xos         , Xos         , Xos         , Cud         , Wog         , Wog         , Rb          , Rr          , Rrc^Bz      , Rrc         , Rrc         , Rrc         , Rrc^Bz      , Rr          , Rb          , Wog         , Wog         , Cud         , Xos         , Xos         , Xos         , Xos         , Xos         , Xos         , Xos         
Xos         , Xos         , Xos         , Xos         , Xos^Zok     , Xos         , Rp          , Cud         , Wog         , Wog         , Xos         , Rr          , Rrc         , Rrc         , Rrc         , Rrc         , Rrc         , Rr          , Xos         , Wog         , Wog         , Cud         , Rp^Em       , Xos         , Xos^Zok     , Xos         , Xos         , Xos         , Xos         
Xos         , Xos         , Xos         , Xos^Zok     , Re^Zok      , Re^Gvs      , Rp^Emf      , Cud         , Wog         , Wog         , Rb          , Rr          , Rrc         , Rrc         , Rrc         , Rrc         , Rrc         , Rr          , Rb          , Wog         , Wog         , Cud         , Rp^Emf      , Re^Gvs      , Re^Zok      , Xos^Zok     , Xos         , Xos         , Xos         
Xos         , Xos         , Xos         , Xos^Zok     , Re^Zok      , Re^Fds      , Rp^Emf      , Cud         , Wog         , Wog         , Rb          , Rr          , Rrc         , Rrc         , Rrc         , Rrc         , Rrc         , Rr          , Rb          , Wog         , Wog         , Cud         , Rp^Em       , Re^Fds      , Re^Zok      , Xos^Zok     , Xos         , Xos         , Xos         
Xos         , Xos         , Xos         , Xos^Zok     , Xos^Zok     , Re^Fds      , Rp^Em       , Cud         , Wog         , Wog         , Xos         , Rr          , Rrc         , Rrc         , Rrc         , Rrc         , Rrc         , Rr          , Xos         , Wog         , Wog         , Cud         , Rp          , Re^Gvs      , Xos^Zok     , Xos^Zok     , Xos         , Xos         , Xos         
