border_size=1
usage=map

Xu, Xu, Xu, Xu, Xu, Xu, Xu, Xu, Xu, Xu, Xu, Xu, Xu, Xu, Xu, Xu, Xu, Xu, Xu, Xu, Xos, Xos, Xos, Xu, Xu, Xu, Xu, Xu, Xu, Xu, Xu, Xu, Xu, Xu, Qxv, Ql, Ql, Ql, Qxv, Qxv, Qxv, Qxv, Qxv, Qxv, Qxv, Qxv, Ql, Ql, Xu, Xu, Xu, Xu, Xu, Qxv, Qxv, Ql, Xu, Xu, Uu^Ii, Uu, Uu, Re, Ur, Uu, Uu, Uu
Xu, Xu, Xu, Xu, Xu, Xu, Xu, Xu, Xu, Xu, Xu, Xu, Xu, Xu, Xu, Xu, Xu, Xu, Xos, Xos, Xos, Xos, Xu, Xu, Xu, Xu, Xu, Xu, Xu, Xu, Xu, Xu, Ql, Qxv, Qxv, Qxv, Qxv, Qxv, Qxv, Qxv, Xu, Qxv, Qxv, Qxv, Qxv, Qxv, Ql, Ql, Xu, Xu, Uu, Xu, Qxv, Qxv, Qxv, Qxv, Xu, Uu, Uu^Ii, Uu, Ur, Rb^Es, Uu, Uu, Uu, Uu
Xu, Xu, Xu, Xu, Xu, Xu, Xu, Xu, Xu, Xu, Xu, Xu, Xu, Xu, Qxv, Xu, Xu, Xu, Xos, Xos, Qxv, Qxv, Qxv, Ql, Xu, Xu, Xu, Xu, Xu, Xu, Xu, Ql, Ql, Qxv, Qxv, Qxv, Xu, Qxv, Qxv, Xu, Uh, Uh, Uh, Qxv, Qxv, Ql, Uu, Xu, Uu, Uu, Ce, Uu, Uu, Uu, Uu, Qxv, Uu, Uu, Uu, Uu, Rb^Es, Rb, Uu, Uu, Xu, Xu
Xu, Xu, Xu, Xu, Xu, Xu, Xu, Xu, Xu, Xu, Xu, Xu, Xu, Xu, Qxv, Xu, Xu, Xu, Uh, Xu, Qxv, Qxv, Ql, Ql, Xu, Xu, Xu, Xu, Xu, Xu, Ql, Ql, Xu, Qxv, Qxv, Uu, Uu, Uu, Uh, Uu, Uu, Uu^Vud, Ur, Uh, Uu, Xu, Uu, Uu, Ur, Ce, Ke, Ce, Uu, Uu^Vu, Ur, Ur^Es, Rb, Uu, Uu, Ur, Uu, Uu, Uu, Uu, Xu, Xu
Xu, Xu, Xu, Xu, Xu, Xu, Xu, Xu, Xu, Xu, Xu, Xu, Xu, Xu, Xu, Qxv, Qxv, Xu, Uh, Uu, Uu, Uh, Ur, Uh, Uu, Xu, Xu, Xu, Xu, Xu, Xu, Qxv, Xu, Xu, Uu, Ur, Ur, Uu, Rb, Rb, Uu, Ur, Ur, Ur^Ii, Rb^Ii, Ur, Ur, Ur^Ii, Uu, Ce, Ce, Ce, Uu, Ur^Es, Uu, Ur, Uu, Ur, Uu, Uu, Uh, Uu, Uu, Uu, Uu, Uu
Xu, Xu, Xu, Xu, Xu, Xu, Xu, Xu, Xu, Xu, Xu, Xu, Xu, Xu, Xu, Ql, Qxv, Uh, Uu, Uu, Rb, Rb, Uu, Uu, Ur, Uu, Xu, Xu, Xu, Xu, Xu, Qxv, Uh, Uh, Uu^Vu, Ur, Rb, Rb, Qxu, Qxu, Xu, Uu, Uh, Uu, Uu^Ii, Ur, Ur, Uu, Xu, Uu, Uu, Uu, Uu^Vu, Rb, Rb, Uu, Uu, Uu^Ii, Uu, Uu, Uh, Uh, Uh, Uh, Uh, Uh
Xu, Xu, Xu, Xu, Xu, Xu, Xu, Xu, Xu, Xu, Xu, Xu, Xu, Xu, Xu, Xu, Uu, Uu, Ur, Uu, Uu, Uu, Xu, Uu, Rb, Uu, Xu, Xu, Xu, Xu, Xos, Xos, Xos, Uu, Uu, Uu, Uu, Uu, Qxu, Qxu, Qxu, Xu, Xu, Xu, Uu, Ur^Es, Ur, Uu^Vu, Uu, Xu, Xu, Uu, Uu, Rb, Uu, Qlf, Qlf, Uu, Uu, Uh, Uu, Xu, Xu, Xu, Xu, Xu
Xu, Xu, Xu, Xu, Xu, Xu, Xu, Xu, Xu, Xu, Xu, Xu, Xu, Xu, Xu, Xu, Uu, Ur, Ur, Uh, Uh, Xu, Xu, Uh, Uh, Uu, Uu, Xu, Xu, Xu, Xos, Xos, Uu, Uh, Uu, Ur, Uu, Xu, Xu, Xu, Xu, Xu, Xu, Uh, Uh, Ur, Ur^Es, Uu, Uh, Xu, Xu, Uu^Ii, Uu^Ii, Uh, Uh, Uu, Qlf, Qxv, Ql, Ql, Ql, Xu, Xu, Xu, Xu, Xu
Xu, Xu, Xu, Xu, Xu, Xu, Xu, Xu, Xu, Xu, Xu, Xu, Xu, Xu, Ql, Qxv, Uu, Uh, Ur, Uu, Uu, Xu, Xu, Xu, Xu, Ur, Uu, Xu, Xu, Xu, Xu, Uu, Ur, Uu, Rb, Ur, Uh, Xu, Xu, Xu, Xu, Xu, Uu, Uh, Uu, Uu^Ii, Ur, Ur^Es, Uh, Xu, Xu, Xu, Xu, Uu, Uu, Uu, Xu, Qxv, Ql, Ql, Qxv, Qxv, Qxv, Qxv, Qxv, Xu
Xu, Xu, Xu, Xu, Xu, Xu, Xu, Xu, Xu, Xu, Xu, Xu, Xu, Xu, Ql, Qxv, Qxv, Uh, Uh, Qxv, Qxv, Uh, Xu, Xu, Xu, Uh, Uh, Uu, Uu, Uh, Uu, Uu, Ur, Rb, Uu, Uh, Xu, Xu, Xu, Xu, Xu, Xu, Xu, Uu, Uh, Uu, 1 Ur, Uu, Uu, Xu, Ql, Xu, Xu, Xu, Xu, Xu, Xu, Xu, Xu, Ql, Qxv, Qxv, Qxv, Qxv, Qxv, Xu
Xu, Xu, Xu, Xu, Xu, Xu, Xu, Xu, Xos, Xu, Xu, Xu, Xu, Ql, Xu, Xu, Xu, Xu, Xu, Qxv, Qxv, Uh, Xu, Xu, Xu, Xu, Xu, Uu^Uf, Uu, Ur, Uu, Uu, Ur, Rb, Uh, Uh, Xu, Xu, Xu, Qxv, Qxv, Xu, Xu, Xu, Uh, Uu, Uu, Uu, Uu^Ii, Uh, Ql, Xu, Xu, Xu, Xu, Xu, Xu, Xu, Xu, Qxv, Qxv, Qxv, Qxv, Qxv, Qxv, Qxv
Xu, Xu, Xu, Xu, Xu, Xu, Xos, Xos, Xos, Xos, Xos, Xu, Xu, Xu, Xu, Xu, Xu, Xu, Xu, Qxv, Qxv, Qxv, Xu, Xu, Xu, Xu, Xu, Uu^Em, Xu, Uu, Xu, Ur, Xu, Uu, Xu, Xu, Xu, Xu, Xu, Qxv, Qxv, Xu, Qxv^Xo, Xu, Ql, Uh, Uu, Uu, Uh, Uh, Ql, Ql, Xu, Xu, Qxv, Xu, Qxv, Xu, Xu, Xu, Qxv, Qxv, Qxv, Qxv, Qxv, Qxv
Xu, Xu, Xu, Xu, Xos, Xos, Xos, Xos, Xos, Xos, Xos, Xu, Xu, Xu, Xu, Xu, Xu, Xu, Xu, Xu, Xu, Ql, Xu, Xu, Xu, Xu, Xu, Xu, Xu, Uu, Uu, Ur, Xu, Ur, Uu, Xu, Xu, Xu, Xu, Qxv, Qxv, Qxv, Qxv^Xo, Qxv, Qxv, Qxv, Qxv, Qxv, Qxv, Xu, Qxv, Ql, Qxv^Xo, Qxv, Qxv, Qxv, Qxv, Xu, Xu, Xu, Xu, Qxv, Qxv, Qxv, Xu, Xu
Xu, Xu, Xu, Xos, Xos, Xos, Xu, Xu, Xu, Xos, Xu, Xu, Xu, Xu, Xu, Xu, Xu, Xu, Xu, Xu, Xu, Xu, Xu, Xu, Xu, Xu, Xu, Xu, Xu, Xu, Uu^Vu, Uu, Rb, Ur, Uu^Uf, Xu, Xu, Xu, Xu, Qxv, Qxv, Qxv, Qxv, Qxv^Xo, Qxv^Xo, Qxv, Qxv^Xo, Qxv, Qxv^Xo, Qxv, Qxv^Xo, Qxv^Xo, Qxv, Qxv, Qxv, Qxv, Xu, Xu, Xu, Xu, Xu, Qxv, Qxv, Qxv, Xu, Xu
Xu, Xu, Xu, Xos, Xos, Xu, Xu, Xu, Uh, Uu, Uu, Xu, Uh, Uh, Uh, Xu, Xu, Xu, Xu, Xu, Xu, Xu, Xu, Xu, Xu, Xu, Xos, Xos, Xos, Uh, Uh, Uu, Urb, Rb^Uf, Uu^Uf, Uu^Uf, Uu, Xu, Xu, Xu, Xu, Qxv, Qxv, Qxv, Qxv, Qxv^Xo, Qxv, Qxv^Xo, Qxv, Qxv^Xo, Qxv, Qxv, Qxv, Qxv, Xu, Xu, Xu, Xu, Xu, Xu, Xu, Xu, Xu, Xu, Xu, Xu
Xu, Xu, Xu, Xos, Xos, Xu, Xu, Uh, Uh, Uu, Cud, Uu, Uu, Uu, Uh, Uh, Xu, Xu, Xu, Xu, Xu, Xu, Xu, Xu, Xu, Xos, Xos, Xos, Uh, Uh, Uu, Urb, Urb, Uu, Uu^Uf, Uu^Uf, Uu, Xos, Xos, Xu, Xu, Xu, Xu, Qxv, Qxv, Qxv, Qxv, Qxv, Qxv, Qxv, Qxv, Qxv, Xu, Xu, Xu, Xu, Xu, Xu, Xu, Xu, Xu, Xu, Xu, Xu, Xu, Xu
Xu, Xu, Xu, Xos, Xos, Xu, Uu, Uu, Uu, Cud, 2 Kud, Cud, Uu, Uu^Vu, Uh, Uh, Xu, Xu, Xu, Xu, Uh, Xu, Xu, Xu, Xu, Xos, Xos, Xos, Urb, Uu^Uf, Xu, Cud, Cud, Qxv, Qxv, Cud, Uu, Xos, Xos, Xos, Xos, Xu, Xu, Xu, Xu, Qxv, Xu, Qxv, Xu, Qxv, Xu, Xu, Xu, Xu, Xu, Xu, Qxv, Xu, Xu, Xu, Xu, Xu, Xu, Xu, Xu, Xu
Xu, Xu, Xu, Xos, Xos, Xu, Uh, Uu, Uu, Cud, Uu^Ii, Cud, Uu, Uu, Uu, Uu, Xu, Xu, Xu, Uh, Uu^Vud, Uu^Uf, Xu, Xu, Xu, Xos, Xos, Urb, Wwf, Wwf, Wwf, Cud, Cud, Cud, Kud, Cud, Cud, Uu, Uu, Xos, Xos, Xu, Xu, Xu, Xu, Xu, Xu, Xu, Xu, Xu, Xu, Xu, Xu, Xu, Xu, Qxv, Qxv, Qxv, Qxv, Xu, Xu, Xu, Xu, Xu, Xu, Xu
Xu, Xu, Xu, Xos, Xos, Uh, Uu, Uu^Vud, Uu, Cud, Cud, Cud, Uu, Uu^Vud, Uu, Xu, Xu, Xu, Xu, Xu, Uh, Uu, Xu, Xu, Xu, Xos, Xos, Wwf, Wwf, Xu, Urb, Cud, Uu, Uu, Cud, Cud, Wwf, Urb, Urb, Uu, Wwf, Xu, Xu, Xu, Wwg, Xu, Xu, Xu, Xu, Xu, Xu, Xu, Xu, Xu, Uh, Uh, Uu, Qxv, Xu, Xu, Xu, Xu, Xu, Xu, Xu, Xu
Xu, Xu, Xu, Xos, Xos, Uh, Uu, Uu, Uu, Uu, Uu, Uu, Uu, Ur, Uu, Uh, Xu, Xu, Xu, Uh, Uu, Ur, Xu, Xu, Xu, Xos, Xos, Xos, Uh, Uu, Xos, Urb, Uu, Uu, Uu, Wwf, Wwf, Ur^Em, Ur, Uu^Vu, Wwf, Wwf, Uh, Wwg, Wwg, Wog, Wog, Xu, Xu, Xu, Uh, Uh, Uu^Uf, Uu, Uu, Uh, Uh, Xu, Xu, Xu, Xu, Xu, Xu, Xu, Xu, Xu
Xu, Xu, Xu, Xos, Xos, Xu, Uh, Uh, Uu, Uu^Vu, Uu, Uu, Uu, Ur, Ur, Uu, Xu, Xu, Uu, Wwf, Uu, Uh, Xu, Xu, Xu, Xos, Xos, Xos, Uh, Urb, Uu, Wwg, Wwg, Xos, Wwg, Wwg, Wwg, Wwf^Es, Ur^Em, Uu, Urb, Uu, Uu, Wwf, Wwg^Es, Wog, Xu, Xu, Xu, Xu, Uu^Uf, Uu^Uf, Uu^Uf, Uu, Uu^Ii, Uu, Uu, Uh, Xu, Xu, Xu, Xu, Xu, Xu, Xu, Xu
Xu, Xu, Xu, Xos, Xos, Xos, Xos, Uh, Uu, Uu, Xu, Uu, Xu, Uh, Uu, Uu, Uu, Uu, Wwf^Es, Wwf, Uu, Xu, Xu, Xu, Xu, Xu, Xu, Xos, Uu, Uh, Wwg^Es, Wwg^Es, Wog, Wwg, Wog, Wwg, Wwf^Es, Uh, Uu^Vud, Ur, Ur, Urb, Uu, Wwf, Wwf, Wwg, Xu, Xu, Xu, Uh, Uu^Uf, Uu^Uf, Ur^Emf, Ur, Uu, Uu, Uu^Uf, Uu, Xu, Xu, Qxv, Xu, Xu, Xu, Xu, Xu
Xu, Xu, Xu, Xu, Xu, Xos, Xu, Xu, Xu, Xu, Xu, Xu, Xu, Uh, Uu^Uf, Wwf, Ur, Uu, Wwf, Wwf, Uu, Xu, Xu, Xu, Xu, Xu, Uu, Wwf, Ur^Em, Urb, Wwg, Wwg, Wog, Wog, Wog, Wwg, Uh, Uh, Uu, Uu, Uu, Uu, Rb, Uu, Uu, Uu, Uu, Xu, Uu^Vu, Uh, Uu, Ur, Urb^Es, Uu, Uu^Uf, Uu^Emf, Uu^Uf, Uu^Uf, Uh, Qxv, Qxv, Qxv, Xu, Xu, Xu, Xu
Xu, Xu, Xu, Xu, Xu, Xu, Xu, Xu, Uh, Xu, Xu, Xu, Xu, Xu, Ur, Uu, Uu, Ur, Wwf, Uu, Wwf^Es, Uu, Uu, Xu, Xu, Xu, Uu, Cud, Ur, Wwf, Xu, Xu, Xu, Wog, Wog, Wwg, Uu, Uu, Xu, Xu, Uh, Uu, Uu, Rb, Urb, Ur, Ur, Uu, Uu, Uu, Uu, Urb, Uh, Uu, Uh, Uu^Uf, Uu^Uf, Uh, Uh, Xu, Qxv, Qxv, Xu, Xu, Xu, Xu
Xu, Xu, Xu, Xu, Uu, Xu, Uu^Uf, Uh, Uu, Uh, Uu, Uh, Ur, Uu, Uu, Uu, Xu, Uu, Uu, Uu, Wwf, Wwf, Ur, Uu, Uu, Uu, Ur, Ur^Em, Wwf, Uu, Uh, Xu, Xu, Xu, Wog, Wwg^Es, Xu, Xu, Xu, Qxv, Uu, Uu, Rb, Uu, Uu, Ur, Uu, Urb, Uu, Ur, Uh, Uu, Xu, Uh, Uh, Uu^Uf, Uu, Uh, Qxv, Qxv, Xu, Xu, Xu, Xu, Xu, Xu
Xu, Xu, Xu, Xu, Uh, Uh, Uu^Uf, Uu^Uf, Ur, Ur, Ur, Ur, Uh, Uu^Uf, Uu^Uf, Xu, Xu, Xu, Xu, Uu, Xu, Uu, Uh, Ur, Wwf, Uu, Wwf, Wwf, Uu^Vu, Uu, Uh, Xu, Xu, Xu, Xu, Wwg, Xu, Xu, Qxv, Qxv, Cud, Ur, Rb, Uu, Uu, Xu, Xu, Uu, Uh, Uh, Xu, Xu, Xu, Xu, Xu, Uh, Xu, Xu, Qxv, Qxv, Xu, Xu, Xu, Xu, Xu, Xu
Xu, Xu, Xu, Xu, Uh, Uh, Uu, Ur, Xu, Uu, Xu, Uh, Xu, Uu^Uf, Xu, Xu, Xu, Xu, Xu, Xu, Uh, Uh, Uu, Uu, Wwf, Uu, Uu, Wwf, Uu, Ur, Rb, Uh, Uu, Xu, Xu, Xu, Xu, Xu, Qxv, Uu, Uu, Ur, Rb, Uu, Uu, Xu, Xu, Uh, Uh, Xu, Xu, Xu, Xu, Xu, Xu, Xu, Xu, Xu, Xu, Xu, Xu, Xu, Xu, Xu, Xu, Xu
Xu, Xu, Xu, Xu, Xu, Uh, Ur, Xu, Xu, Xu, Xu, Xu, Xu, Xu, Xu, Xu, Xu, Xu, Xu, Uh, Uu^Emf, Uh, Cud, Wwf^Es, Wwf, Uu, Xu, Uh, Xu, Uu^Uf, Uu, Uu, Rb, Uu^Uf, Uu^Uf, Xu, Uu, Qxv, Uu, Uu, Rb, Uu, Uu, Rb, Uu^Vu, Uu, Uu, Uh, Uh, Xu, Xu, Xu, Xu, Xu, Xu, Xu, Xu, Xu, Xu, Xu, Xu, Xu, Xu, Xu, Xu, Xu
Xu, Xu, Xu, Xu, Xu, Xu, Xu, Ur, Uu, Xu, Xu, Xu, Xu, Xu, Xu, Xu, Xu, Xu, Xu, Uu, Wwf, Uu, Ur, Uu^Em, Uu, Uu^Uf, Xu, Xu, Xu, Xu, Uh, Uh, Ur, Rb^Uf, Ur, Uu^Emf, Uu^Uf, Uu^Uf, Uu, Rb, Uu, Uu, Xu, Uu, Uu, Rb, Uu^Ii, Uu, Urb, Uh, Ql, Xu, Ql, Xu, Xu, Xu, Xu, Xu, Xu, Xu, Xu, Xu, Xu, Xu, Xu, Xu
Xu, Xu, Xu, Xu, Xu, Xu, Xu, Uu, Ur, Xu, Xu, Xu, Uu^Uf, Uu^Uf, Uh, Xu, Xu, Xu, Uu^Emf, Uu^Uf, Wwf, Wwf, Uu^Vud, Uu, Uu, Uu, Xu, Xu, Xu, Xu, Uu, Uh, Uu, Uu, Uu, Ur, Uu^Uf, Urb, Uu, Uu, Xu, Xu, Xu, Xu, Xu, Uu, Uh, Uu, Urb, Urb, Uu, Ql, Ql, Xu, Xu, Xu, Xu, Xu, Xu, Xu, Xu, Xu, Xu, Xu, Xu, Xu
Xu, Xu, Xu, Xu, Xu, Xu, Xu, Xu, Xu, Ur, Ur, Uu, Uu, Uu, Uu, Uh, Xu, Xu, Uu, Wwf^Es, Wwf, Wwf^Es, Ur, Uu, Uu, Wwf, Xu, Xu, Xu, Xu, Qxv, Qxv, Qxv, Xu, Xu, Uu^Uf, Uu, Ur, Ur^Em, Uu, Xu, Xu, Xu, Xu, Xu, Uh, Uh, Uu, Uu, Urb, Uu, Uu, Ql, Ql, Xu, Xu, Xu, Xu, Xu, Xu, Xu, Xu, Xu, Xu, Xu, Xu
Xu, Xu, Xu, Xu, Xu, Xu, Xu, Xu, Uh, Uu^Uf, Uu, Ur, Cud, Cud, Cud, Uu, Wwf, Uu, Ur, Uu, Uu, Wwf, Uu, Wwf, Uu, Uu, Uu^Uf, Xu, Xu, Xu, Xu, Qxv, Qxv, Xu, Xu, Xu, Uu, Ur, Ur^Em, Uu^Uf, Xu, Xu, Xu, Xu, Xu, Uh, Xu, Xu, Uu, Urb, Urb, Uu, Xu, Ql, Xu, Xu, Xu, Xu, Xu, Xu, Xu, Xu, Xu, Xu, Xu, Xu
Xu, Xu, Xu, Xu, Xu, Xu, Xu, Xu, Uh, Uu, Uu^Vu, Uu^Emf, Cud, 4 Kud, Cud, Ur, Uu^Em, Ur, Uu, Uu, Wwf, Ur, Uu^Em, Wwf, Wwf, Uu, Wwf, Xu, Xu, Xu, Xu, Xu, Qxv, Qxv, Xu, Xu, Xu, Uu, Urb, Uu, Xu, Xu, Xu, Xu, Xu, Xu, Uh, Uu^Uf, Uu, Uu, Urb, Uu, Xu, Xu, Xu, Xu, Xu, Xu, Xu, Xu, Xu, Xu, Xu, Xu, Xu, Xu
Xu, Xu, Xu, Xu, Xu, Xu, Xu, Xu, Uu^Uf, Uu^Uf, Uu, Uu^Uf, Uu, Uu^Ii, Uu, Uu, Uu, Uu^Vud, Uu^Uf, Uu, Wwf^Es, Wwf, Uu^Em, Uu, Uu, Uu^Em, Uu, Xu, Xu, Xu, Re, Uu, Uu, Uu, Uu, Xu, Uu, Uu, Rb, Rb, Uu^Vu, Uh, Uh, Xu, Xu, Uh, Uu^Uf, Uu, Urb, Uu^Ii, Uu, Uu, Uu, Uh, Uh, Xu, Xu, Xu, Xu, Xu, Xu, Xu, Xu, Xu, Xu, Xu
Xu, Xu, Xu, Xu, Xu, Xu, Xu, Xu, Uu^Uf, Uu^Uf, Uu^Emf, Uu^Uf, Uu^Uf, Uu, Uu^Uf, Uu, Uu, Uu^Uf, Xu, Xu, Xu, Wwf, Xu, Uu^Emf, Uu, Ur, Ur, Uu^Uf, Uu, Re, Uu, Re, Uu, Re, Urb, Uu, Uh, Uu, Xu, Rb, Rb, Uu, Rb, Uu^Uf, Uu, Uu, Urb, Urb, Uu, Uu, Xu, Uu^Uf, Xu, Uu, Uh, Uh, Xu, Xu, Xu, Xu, Xu, Xu, Xu, Xu, Xu, Xu
Xu, Xu, Xu, Xu, Xu, Xu, Xu, Xu, Xu, Uh, Uh, Uu^Vud, Uu, Uu, Uu^Uf, Uu^Uf, Uu^Uf, Uu^Emf, Xu, Xu, Xu, Xu, Xu, Xu, Xu, Uu, Cud, Ur, Uu, Uu, Qxv, Uu, Xos, Xos, Uu, Urb, Uh, Xu, Xu, Xu, Uu, Qxv, Qxv, Rb, Uu, Cud, Urb, Urb, Uu, Xu, Xu, Xu, Xu, Xu, Uh, Uu, Xu, Xu, Xu, Xu, Xu, Xu, Xu, Xu, Xu, Xu
Xu, Xu, Xu, Xu, Xu, Xu, Xu, Xu, Xu, Xu, Uh, Uu^Uf, Uu^Emf, Uu, Uu^Uf, Uh, Xu, Xu, Xu, Xu, Uu, Xu, Xu, Xu, Qxv, Qxv, Uu, Ur, Uu, Qxv, Qxv, Qxv, Xos, Uu, Uu^Ii, Urb, Cud, Xu, Xu, Uh, Uh, Qxv, Qxv, Uu, Uu^Vu, Uu, Ur, Uu, Uh, Uu, Uu, Xu, Uh, Uh, Xu, Xu, Xu, Xu, Xu, Xu, Xu, Xu, Xu, Xu, Xu, Xu
Xu, Xu, Xu, Xu, Xu, Xu, Xu, Xu, Xu, Xu, Xu, Uu, Xu, Uu^Uf, Xu, Xu, Xu, Xu, Uu, Uu, Xu, Xu, Xu, Xu, Qxv, Qxv, Uu, Ur, Uu, Qxv, Ur, Uu, Urb, Urb, Urb, Cud, 3 Kud, Cud, Urb, Urb, Rb, Ur, Ur, Uu, Ur, Rb, Uu, Uh, Uh, Uu, Uu, Uh, Uh, Yhs, Xu, Xu, Xu, Xu, Xos, Xu, Xu, Xu, Xu, Xu, Xu, Xu
Xu, Xu, Xu, Xu, Xu, Xu, Xu, Xu, Xu, Xu, Xu, Xu, Xu, Xu, Xu, Xu, Xu, Uu, Ur, Uu, Xu, Xu, Xu, Xu, Qxv, Uu, Uu^Uf, Uu, Urb, Urb, Uu^Vu, Ur, Xos, Uu, Uu^Ii, Cud, Cud, Cud, Uu^Ii, Re^Uf, Uu, Ur, Qxv, Uu, Rb, Rb, Xu, Uh, Uh, Xu, Xu, Xu, Xu, Xu, Ur, Xu, Xu, Xu, Xos, Xos, Xos, Xu, Xu, Xu, Xu, Xu
Xu, Xu, Xu, Xu, Xu, Xu, Xu, Xu, Ql, Ql, Xu, Xu, Xu, Xu, Xu, Xu, Uu, Ur, Uh, Xu, Uh, Xu, Xu, Xu, Xu, Uu, Ur, Uu, Uu, Uu, Uu, Uu, Xos, Uu, Urb, Urb, Uu^Ii, Uu, Uh, Uu^Uf, Uu, Uh, Qxv, Uu, Uh, Uu, Xu, Xu, Uh, Uh, Xu, Xu, Xu, Xu, Uu, Xu, Xu, Xu, Yhs, Xos, Xos, Xos, Xu, Xu, Xu, Xu
Xu, Xu, Xu, Xu, Xu, Xu, Uu, Uh, Uu, Ql, Xu, Xu, Xu, Ql, Ql, Uh, Uu, Ur, Uu, Uh, Ur, Uu, Ur, Xu, Uu, Urb, Uu, Qxv, Uu, Uh, Uh, Uu, Uu, Xos, Urb, Urb, Urb, Uu, Uh, Xos, Uu, Qxv, Qxv, Uu, Uu, Uh, Xu, Xu, Xu, Uh, Xu, Xu, Uh, Xu, Ur, Uu, Yhs, Yhs^Xp, Yhs, Xos, Xos, Xos, Xu, Xu, Xu, Xu
Xu, Xu, Xu, Xu, Cud^Xo, Uu, Ur, Ur, Ur, Uu, Ur, Uu, Uu, Ql, Uu, Uu, Ur, Ur, Uu, Ur, Uu, Ur, Uu^Uf, Uu, Urb, Urb, Cud, Uu, Uu^Uf, Uu^Uf, Uh, Qxv, Qxv, Ur, Uu, Xos, Uu, Ur, Uu^Uf, Uu, Uu^Vu, Uu, Uu, Uu, Uh, Uh, Qxv, Qxv, Xu, Xu, Xu, Xu, Uh, Uu^Uf, Uu, Ur, Uu, Yhs^Xp, Xu, Xu, Xos, Xos, Xu, Xu, Xu, Xu
Xu, Ql, Ql, Xu, Uu^Xo, Cud^Ii, Cud^Xo, Uu, Uu, Ur, Uu, Ur, Ur, Uu, Ur, Ur, Uu, Uu, Xu, Xu, Xu, Xu, Xu, Uu, Uu, Uu, Uu, Uh, Uh, Uu^Uf, Ur, Qxv, Qxv, Uu, Uu^Vu, Uu, Uu^Uf, Rb, Rb, Uu, Uu, Uu, Uu, Xu, Xu, Uh, Qxv, Qxv, Xu, Xu, Xu, Uh, Xu, Uh, Uu^Uf, Ur, Ur, Xu, Xu, Xu, Xos, Xos, Xos, Xu, Xu, Xu
Ql, Ql, Ql, Ql, Uu, Ur^Xo, Uu, Xu, Xu, Uh, Xu, Uu, Ql, Uu, Uu, Uu, Uh, Uh, Xu, Xu, Xu, Xu, Uu, Uu, Ur, Uu, Uu^Uf, Uh, Uh, Uu, Uu, Ur, Uu, Uu, Ur, Uu, Uu, Uu, Rb, Ur, Uu, Uu, Qxv, Xu, Xu, Xu, Qxv, Qxv, Xu, Xu, Xu, Xu, Xu, Uu^Uf, Yhs^Xp, Uu, Uu, Xu, Yhs^Xp, Xu, Uh, Xos, Xos, Xos, Xos, Xu
Ql, Ql, Ql, Uu, Ur, Ur, Uu, Uh, Uh, Xu, Xu, Xu, Xu, Ql, Xu, Ql, Xu, Xu, Xu, Xu, Uu, Uu, Ur, Urb, Xu, Uu, Xu, Uu, Qxv, Xu, Qxv, Ur, Uu, Ur, Uh, Qxv, Qxv, Uh, Uu, Rb, Uu, Uu, Uu, Qxv, Xu, Xu, Xu, Xu, Xu, Xu, Xu, Xos, Xos, Yhs, Xu, Xu, Yhs^Xp, Yhs, Yhs^Ii, Yhs, Uh, Uh, Xu, Xos, Xos, Xos
Uu, Uu, Uu, Ur, Ur, Uu, Uh, Uh, Ql, Xu, Xu, Xu, Xu, Ql, Ql, Ql, Ql, Xu, Xu, Xu, Uu^Uf, Uu^Uf, Ur, Uu, Xu, Uu, Xu, Xu, Xu, Xu, Qxv, Qxv, Xu, Uh, Uh, Uh, Qxv, Qxv, Qxv, Uh, Uu, Ur, Uu, Qxv, Qxv, Xu, Xu, Xu, Xu, Xu, Xu, Xos, Xos, Xos, Xu, Xu, Uh, Yhs, Uh, Uh, Uh, Uu^Vu, Xu, Xu, Xu, Xos
Ur, Ur, Uu, Uu, Uu, Uu, Ql, Ql, Ql, Ql, Xu, Xu, Xu, Ql, Ql, Ql, Xu, Xu, Xu, Uh, Uu, Ur, Uu, Xu, Xu, Xu, Xu, Xu, Xu, Xu, Xu, Xu, Uh, Uh, Xu, Uh, Xu, Qxv, Qxv, Xu, Xu, Uh, Uu, Ur, Uu, Xu, Uu, Xu, Uu, Xu, Xu, Xu, Xu, Xu, Xu, Xu, Xu, Uh, Uh, Xu, Xu, Xu, Xu, Xu, Xu, Xu
Uu, Uu, Ql, Ql, Xu, Xu, Ql, Ql, Ql, Ql, Xu, Xu, Xu, Xu, Xu, Xu, Xu, Xu, Xu, Xu, Uu, Ur, Ur, Uu, Uu, Xu, Wwf, Xu, Xu, Xu, Xos, Xos, Xos, Xu, Xu, Xu, Qxv, Qxv, Xu, Xu, Xu, Uh, Uh, Ur, Ur, Ur, Ur, Uu, Cud^Xo, Xu, Xu, Xu, Xu, Xu, Xu, Xu, Xu, Uh, Uu^Vu, Xu, Xu, Xu, Xu, Xu, Xu, Xu
Ql, Ql, Ql, Ql, Ql, Xu, Xu, Xu, Xu, Xu, Xu, Xu, Xu, Xu, Xu, Xu, Xu, Xu, Xu, Xu, Wwf, Uu, Uu, Ur, Uu, Uh, Wwf, Xu, Xu, Xu, Xu, Xos, Xu, Xu, Xu, Qxv, Xu, Xu, Xu, Xu, Xu, Xu, Xu, Uu, Uh, Uu, Cud^Xo, Cud^Ii, Ur^Xo, Uu, Uh, Xu, Xu, Xu, Xu, Xu, Xu, Xu, Xu, Xu, Xu, Xu, Xu, Xu, Xu, Xu
Ql, Ql, Ql, Ql, Xu, Xu, Xu, Xu, Xu, Xu, Xu, Xu, Xu, Xu, Xu, Xu, Xu, Xu, Xu, Xu, Xu, Wwf, Xu, Uu, Ur, Uu, Uu, Wwf, Xu, Xu, Xu, Xu, Xu, Xu, Xu, Xu, Xu, Xu, Xu, Xu, Xu, Xu, Xu, Uh, Xu, Xu, Uu, Ur^Xo, Ur^Em, Uu^Emf, Uu^Emf, Xu, Xu, Xu, Xu, Xu, Xu, Xu, Xu, Xu, Xu, Xu, Xu, Xu, Xu, Xu
Xu, Ql, Xu, Ql, Xu, Xu, Xu, Xu, Xu, Xu, Xu, Xu, Xu, Xu, Xu, Xu, Xu, Xu, Xu, Xu, Xu, Xu, Xu, Xu, Cud^Xo, Ur, Cud^Xo, Xu, Xu, Xu, Xu, Xu, Xu, Xu, Xu, Xu, Xu, Xu, Xu, Xu, Xu, Xu, Xu, Xu, Xu, Xu, Uu^Uf, Uu, Ur, Ur, Uh, Xu, Xu, Xu, Xu, Xu, Xu, Xu, Xu, Xu, Xu, Xu, Xu, Xu, Xu, Xu
Xu, Xu, Xu, Xu, Xu, Xu, Xu, Xu, Xu, Xu, Xu, Xu, Xu, Xu, Xu, Xu, Xu, Xu, Xu, Xu, Xu, Xu, Xu, Uu, Uu^Xo, Cud^Ii, Uu^Xo, Uu, Xu, Xu, Xu, Xu, Xu, Xu, Xu, Xu, Xu, Xu, Xu, Xu, Xu, Xu, Xu, Xu, Uh, Uh, Uu^Uf, Ur^Em, Ur, Uu, Xu, Xu, Xu, Xu, Xu, Xu, Xu, Xu, Xu, Xu, Xu, Xu, Xu, Xu, Xu, Xu
Xu, Xu, Xu, Xu, Xu, Xu, Xu, Xu, Xu, Xu, Xu, Xu, Xu, Xu, Xu, Xu, Xu, Xu, Xu, Xu, Xu, Xu, Wwf, Uh, Uh, Uu^Xo, Ur, Uu, Uu, Wwf, Wwf, Xu, Xu, Xu, Xu, Xu, Xu, Xu, Xu, Xu, Xu, Xu, Xu, Xu, Xu, Uh, Uh, Uu^Uf, Uu^Emf, Uu, Uh, Xu, Xu, Xu, Xu, Xu, Xu, Xu, Xu, Xu, Xu, Xu, Xu, Xu, Xu, Xu
Xu, Xu, Xu, Xu, Xu, Xu, Xu, Xu, Xu, Xu, Xu, Xu, Xu, Xu, Xu, Xu, Xu, Xu, Xu, Xu, Xu, Xu, Wwf, Wwf, Uh, Wwf, Wwf, Ur, Uh, Wwf, Xu, Xu, Xu, Xu, Xu, Xu, Xu, Xu, Xu, Xu, Xu, Xu, Xu, Xu, Xu, Xu, Xu, Uu^Uf, Uu^Em, Ur, Uu, Xu, Xu, Xu, Xu, Xu, Xu, Xu, Xu, Xu, Xu, Xu, Xu, Xu, Xu, Xu
Xu, Xu, Xu, Xu, Xu, Xu, Xu, Xu, Xu, Xu, Xu, Xu, Xu, Xu, Xu, Xu, Xu, Xu, Xu, Xu, Xu, Wwf, Xu, Xu, Xu, Wwf, Wwf, Ur, Ur, Uh, Xu, Xu, Xu, Xu, Xu, Xu, Xu, Xu, Xu, Xu, Xu, Xu, Xu, Xu, Xu, Xu, Xu, Xu, Uu, Ur^Em, Ur, Uu^Emf, Uh, Xu, Xu, Xu, Xu, Xu, Xu, Xu, Xu, Xu, Xu, Xu, Xu, Xu
Xu, Xu, Xu, Xu, Xu, Xu, Xu, Xu, Xu, Xu, Xu, Xu, Xu, Xu, Xu, Xu, Xu, Xu, Xu, Xu, Xu, Xu, Xu, Xu, Xu, Uh, Uu, Ur, Ur, Uu, Xu, Xu, Xu, Xu, Xu, Xu, Xu, Xu, Xu, Xu, Xu, Xu, Xu, Xu, Xu, Xu, Xu, Xu, Xu, Uu, Uu, Ur, Ur, Uh, Xu, Xu, Xu, Xu, Xu, Xu, Xu, Xu, Xu, Xu, Xu, Xu
