Xu, Xu, Xu, Xu, Xu, Xu, Xu, Xu, Xu, Xu, Xu, Xu, Xu, Xu, Xu, Xu, Xu, Xu, Xu, Xu, Xu, Xu, Xu, Xu, Xu, Xu, Xu, Xu, Xu, Xu, Xu, Xu, Xu, Xu, Xu, Xu, Xu, Xu, Xu, Xu, Xu, Xu, Xu, Xu, Xu, Xu, Xu, Uu, Uu, Ur, Uu, Uu, Uh, Xu, Xu, Xu, Xu, Xu, Xu, Xu, Uh, Uu^Tf, Qxu, Qxu, Uh, Uu, Uu, Uu, Xu, Xu
Xu, Xu, Xu, Xu, Xu, Xu, Xu, Xu, Xu, Xu, Xu, Xu, Xu, Xu, Xu, Xu, Xu, Xu, Xu, Xu, Xu, Xu, Xu, Xu, Xu, Xu, Xu, Xu, Xu, Xu, Xu, Xu, Xu, Xu, Xu, Xu, Xu, Xu, Xu, Xu, Xu, Xu, Xu, Xu, Xu, Xu, Xu, Uh, Uu, Ur, Uu, Uh, Uu, Xu, Xu, Xu, Xu, Xu, Xu, Qxu, Qxu, Qxu, Uh, Uu^Tf, Tb^Tf, Uu, Uu, Uh, Xu, Xu
Xu, Xu, Xu, Xu, Xu, Xu, Xu, Xu, Xu, Xu, Xu, Xu, Uu^Tf, Xu, Xu, Xu, Xu, Xu, Xu, Xu, Qxu, Qxu, Qxu, Qxu, Qxu, Qxu, Qxu, Xu, Xu, Xu, Xu, Xu, Xu, Xu, Xu, Xu, Xu, Xu, Xu, Xu, Xu, Xu, Xu, Xu, Xu, Xu, Xu, Xu, Xu, Uu^Tf, Uu^Tf, Ur, Uu^Tf, Uu, Xu, Xu, Xu, Xu, Uu, Uh, Uu, Qxu, Re, Re, Re^Tf, Uu, Uu^Vud, Re, Xu, Xu
Xu, Xu, Xu, Xu, Xu, Xu, Xu, Xu, Uh, Uh^Qspd, Uu, Uh, Uu, Uh, Xu, Xu, Xu, Xu, Xu, Xu, Qxu, Qxu, Qxu, Qxu, Qxu, Qxu, Qxu, Qxu, Xu, Xu, Xu, Xu, Xu, Xu, Xu, Xu, Xu, Xu, Xu, Xu, Xu, Xu, Xu, Xu, Xu, Xu, Xu, Xu, Qxu, Uh, Uh, Ur, Ur, Uu, Uu, Qxu, Qxu, Qxu, Uh, Uu^Tf, Ur, Re, Uu, Uu^Tf, Tb^Tf, Uu, Uu, Uh, Qxu, Xu
Xu, Xu, Xu, Xu, Xu, Xu, Xu, Xu, Xu, Uh, Xu, Uu, Uu^Vu, Xu, Xu, Xu, Xu, Xu, Qxu, Qxu, Qxu, Qxu, Uh, Uh, Uh, Qxu, Qxu, Xu, Xu, Xu, Xu, Xu, Xu, Xu, Xu, Xu, Xu, Xu, Xu, Xu, Xu, Xu, Xu, Xu, Xu, Xu, Xu, Xu, Xu, Qxu, Qxu, Uu, Re, Re, Uu, Qxu, Qxu, Qxu, Uu^Tf, Uu, Qxu, Re, Uh, Uh, Uh, Uh, Uh, Uh, Qxu, Qxu
Xu, Xu, Xu, Xu, Xu, Xu, Xu, Xu, Xu, Xu, Xu, Uu, Uh, Uu, Xu, Xu, Xu, Xu, Qxu, Qxu, Qxu, Uh, Uh, Uu, Uu, Qxu, Qxu, Qxu, Xu, Xu, Xu, Xu, Xu, Xu, Uh, Uh, Tb^Tf, Uh, Uu^Tf, Xu, Uh, Xu, Uh, Xu, Xu, Xu, Qxu, Xu, Xu, Qxu, Qxu, Uu, Ce, Ce, Ce, Uh, Qxu, Qxu, Qxu, Qxu, Qxu, Uh, Uu, Qxu, Xu, Xu, Uh, Qxu, Qxu, Xu
Xu, Xu, Xu, Xu, Xu, Xu, Xu, Xu, Xu, Xu, Xu, Uh, Tb^Tf, Uu^Tf, Xu, Xu, Xu, Xu, Xu, Qxu, Qxu, Uh, Uu, Ur^_mh, Ur, Uh, Uh, Qxu, Qxu, Xu, Xu, Xu, Xu, Uh, Uu^Tf, Tb^Tf, Uu^Tf, Tb^Tf, Uh, Xu, Uu^Tf, Uh, Uh, Xu, Xu, Qxu, Qxu, Xu, Xu, Xu, Qxu, Uu^Tf, Ce, 1 Ke, Ce, Uu^Tf, Uh, Qxu, Ur, Qxu, Qxu, Qxu, Uh, Qxu, Qxu, Xu, Qxu, Qxu, Qxu, Qxu
Xu, Xu, Xu, Xu, Xu, Xu, Xu, Xu, Xu, Xu, Uu, Uh, Tb^Tf, Uh, Xu, Xu, Xu, Xu, Xu, Qxu, Qxu, Qxu, Qxu, Uh, Ur^Qhh, Ur, Uu, Qxu, Qxu, Xu, Xu, Xu, Uu^Tf, Uh, Uu^Emf, Tb^Emf, Re, Uu^Tf, Uu, Re, Re, Uu, Uh, Uh, Qxu, Qxu, Qxu, Xu, Xu, Xu, Uu^Vu, Uu, Uu, Ce, Uu, Uu^Tf, Re, Uu, Uu, Uh, Qxu, Qxu, Qxu, Qxu, Uu, Uh, Uh, Qxu, Xu, Qxu
Xu, Xu, Xu, Xu, Xu, Xu, Xu, Xu, Xu, Xu, Xu, Uh, Uh, Xu, Xu, Xu, Xu, Xu, Xu, Xu, Qxu, Qxu, Qxu, Uh^Qhh, Uu, Ur^Qhh, Qxu, Qxu, Xu, Xu, Xu, Uh, Uu^Tf, Uu, Uu^Tf, Uu^Tf, Re, Uu, Uhe, Uu, Uu^Tf, Re, Uue, Uu^Vu, Qxu, Uu^Tf, Uu^Tf, Uh, Uh, Uh, Ur, Ur, Ur, Ur, Ur, Uh, Uu^Vud, Uu, Uh, Qxu, Qxu, Qxu, Qxu, Qxu, Uh, Uu, Wwf, Xu, Xu, Xu
Xu, Xu, Xu, Xu, Xu, Xu, Xu, Xu, Xu, Xu, Wwf, Uh, Qxu, Qxu, Qxu, Qxu, Qxu, Xu, Xu, Xu, Qxu, Qxu, Qxu, Qxu, Uu, Ur, Qxu, Qxu, Xu, Xu, Uh, Uh, Urb, Uu, Urb, Re^Em, Uue, Uue, Uhe, Xue, Xue, Re, Re^Tf, Uue^Tf, Uu, Ur, Ur, Ur, Ur, Uu, Re, Uu^Vud, Uu, Uu^Tf, Qxu, Uh, Qxu, Qxu, Qxu, Qxu, Qxu, Qxu, Qxu, Uh, Uu, Uu^Tf, Wwg, Xu, Xu, Xu
Xu, Xu, Xu, Xu, Xu, Xu, Xu, Xu, Qxu, Qxu, Uh, Uh, Qxu, Qxu, Qxu, Qxu, Qxu, Xu, Xu, Xu, Tb^Tf, Qxu, Uu^Vu, Uh, Uu, Ur, Uu, Xu, Xu, Xu, Xu, Urb, Uu^Tf, Urb, Uu^Vud, Re, Re^Em, Uue^Tf, Uue, Xue, Xue, Uue, Uue^Tf, Re, Re^Es, Re^Em, Uu, Uu, Uu, Uu^Tf, Uh, Uh, Qxu, Uh, Qxu, Qxu, Qxu, Qxu, Qxu, Qxu, Xu, Xu, Qxu, Uu, Uu, Cud, Wwg, Wwg, Xu, Xu
Xu, Xu, Xu, Xu, Xu, Xu, Xu, Xu, Qxu, Qxu, Qxu, Qxu, Qxu, Qxu, Uh, Uh, Ur, Qxu, Xu, Uh^Qspd, Uh, Qxu, Uu, Uu, Ur, Ur, Uh, Uu, Uh, Xu, Xu, Uu, Xu, Uu^Tf, Qxu, Uh, Uu^Tf, Re^Tf, Uue^Emf, Xue, Uhe, Xue, Uue, Re, Re, Uu^Em, Qxu, Qxu, Uu^Tf, Uu, Uh, Uh, Xu, Qxu, Qxu, Qxu, Xu, Qxu, Xu, Xu, Xu, Xu, Uu, Uu, Uu^Emf, Wwf, Xu, Xu, Xu, Xu
Xu, Xu, Xu, Xu, Uh, Uh^Qspd, Uh, Qxu, Qxu, Qxu, Uh, Qxu, Qxu, Qxu, Uu^Tf, Ur, Uu, Re, Ur, Xu, Uu, Uh, Uu, Ur, Uu, Uh, Uu, Uu, Uh, Xu, Xu, Uh, Wwf, Xu, Qxu, Qxu, Uh, Urb^Emf, Uue, Uhe, Uhe, Uue, Re^Es, Uu, Uu, Uu^Em, Qxu, Qxu, Xu, Xu, Xu, Xu, Xu, Xu, Xu, Qxu, Xu, Xu, Xu, Xu, Xu, Xu, Xu, Uu, Xu, Wwg, Xu, Xu, Xu, Xu
Xu, Xu, Xu, Xu, Uu, Uu^Vud, Uh, Qxu, Qxu, Qxu, Qxu, Qxu, Qxu, Uh, Uu, Ur, Qxu, Qxu, Uu, Re, Re, Re^Em, Uu, Uu, Tb^Tf, Uh, Uu^Tf, Uh, Xu, Xu, Xu, Uu, Xu, Xu, Qxu, Qxu, Qxu, Uu, Re, Uue, Uue, Ur, Re, Uu, Uu, Qxu, Qxu, Qxu, Xu, Xu, Xu, Xu, Xu, Xu, Xu, Xu, Xu, Xu, Xu, Qxu, Xu, Xu, Xu, Xu, Xu, Xu, Xu, Xu, Xu, Xu
Xu, Xu, Xu, Xu, Xu, Uh, Wwf, Uu, Xu, Qxu, Qxu, Qxu, Uh, Uh, Re, Qxu, Qxu, Qxu, Qxu, Uu, Uu, Uu, Xu, Uu^Tf, Uh, Uh, Xu, Xu, Xu, Xu, Xu, Xu, Xu, Xu, Xoa, Qxu, Uu, Qxu, Uu, Urb, Uu, Re^Es, Uh, Uu, Qxu, Qxu, Qxu, Xu, Xu, Xu, Xu, Xu, Xu, Xu, Xu, Xu, Qxu, Xu, Qxu, Qxu, Xu, Xu, Xu^Qhu, Xu, Xu, Xu, Xu, Xu, Xu, Xu
Xu, Xu, Xu, Xu, Xu, Xu, Xu, Wwf, Wwf, Qxu, Qxu, Qxu, Qxu, Ur, Ur, Uu, Xu, Xu, Uh^Qspd, Qxu, Xu, Xu, Xu, Xu, Xu, Xu, Xu, Xu, Xu, Xu, Xu, Xu, Uh, Xu, Uh, Uh, Urb, Uu, Re, Urb, Uu^Tf, Uu, Uh, Uu, Qxu, Qxu, Qxu, Xu, Xu, Xu, Uh, Uh, Uh, Xu, Xu, Qxu, Qxu, Qxu, Qxu, Xu, Xu^Qhu, Xu^Qhu, Xu, Xu^Qhu, Xu^Qhu, Xu, Xu, Xu, Xos, Xos
Xu, Xu, Xu, Xu, Xu, Xu, Xu, Xu, Qxu, Qxu, Qxu, Uh, Uh, Ur, Uu^Tf, Xu, Xu, Xu, Xu, Uh, Qxu^Qspd, Xu, Xu, Xu, Xu, Xu, Xu, Xu, Xu, Xu, Xu, Xu, Uh, Uu^Tf, Uu^Vu, Urb, Re, Re, Cte, Uu, Xoa, Xu, Xu, Qxu, Xu, Qxu, Xu, Xu, Xu, Uh, Uh, Uu, Uh, Uh, Qxu, Qxu, Qxu, Qxu, Xu^Qhu, Xu^Qhu, Xu, Xu, Xu, Xu, Xu, Xu^Qhu, Xu^Qhu, Xos, Xos, Xos
Xu, Xu, Xu, Xu, Uh^Qspd, Xu, Xu, Xu, Qxu, Qxu, Qxu, Qxu, Uh, Ur, Uu^Tf, Uu, Xu, Xu, Xu, Qxu, Xu, Xu, Xu, Xu, Xu, Xu, Xu, Xu, Xu, Xu, Qxu, Xoa, Uu^Tf, Uu^Tf, Uu, Uu, Re^Em, Uu, Uh, Qxu, Qxu, Xu, Xu, Xu, Xu, Xu, Xu, Xu, Xu, Uh, Uu^Tf, Rb, Ur, Uh, Qxu, Qxu, Xu, Xu, Xu^Qhu, Xu, Uh, Uh, Uh, Xu, Xu, Xu, Xu, Xos^Qhu, Xos^Qhu, Xos
Xu, Xu, Xu, Xu, Uh^Qspd, Uu, Uu, Xu, Xu, Xu, Uu, Uh, Ur, Uu, Ur, Uu^Tf, Xu, Xu, Xu, Xu, Xu^Qhu, Xu^Qhu, Xu^Qhu, Xu^Qhu, Xu^Qhu, Xu^Qhu, Xu^Qhu, Xu, Xu, Xu, Qxu, Qxu, Cte, Uu, Uue, Rp, Uue, Uue, Uh, Qxu, Qxu, Qxu, Xu, Xu, Xu, Xu, Xu, Xu, Xu, Uh, Uh, Rb, Rb, Uh, Qxu, Qxu, Xu, Xu, Xu^Qhu, Xu, Uh, Cte, Urb^_ml, Urb, Uh, Xu, Wwg, Wwg, Xos, Xos^Qhu
Xu^Qhu, Xu, Xu, Xu, Xu, Uu^Tf, Urb, Uu, Xu, Xu, Uu, Ur, Uu, Ur, Ur, Ur, Uu, Xu, Xu, Xu^Qhu, Wog, Wog, Wwg, Wwg, Wwg, Xu, Uu^Qhu, Xu, Uu, Xu, Qxu, Qxu, Qxu, Uu, Re^Edt, Uue, Uue, Uue^Tf, Uue^Tf, Uh, Qxu, Qxu, Qxu, Xu, Xu, Xu, Xu, Xu, Qxu, Qxu, Uh, Uu^Tf, Urb, Qxu, Qxu, Xu, Xu, Xu, Xu^Qhu, Xu, Uu, Uu, Urb, Urb^Ii, Uu, Uh, Wwrg, Xu, Xu, Xos
Xu, Xu^Qhu, Xu^Qhu, Xu, Qxu, Qxu, Uh, Urb, Uu, Uu^Tf, Uu, Uu^Vu, Uu^Tf, Qxu, Uh, Ur, Ur, Uu, Ur^Qhu, Wwg^Qhu, Wog, Wog, Wwf, Wwg, Uu^Tf, Uu, Tb^Tf, Uu^Qhu, Uu, Uu^Edt, Uu^Edt, Qxu, Qxe, Uue^Tf, Re^Edt, Re, Uue, Uue^Tf, Cte, Uu^Tf, Uu^Tf, Qxu, Qxu, Qxu, Xu, Xu, Xu, Xu, Qxu, Uu, Qxu, Qxu, Qxu, Urb, Rb, Uu^Tf, Xu, Xu, Xu^Qhu, Xu^Qhu, Uu^Qhu, Urb, Uu, Uu, Cte, Uh, Xu, Xu, Xu, Xu
Xu, Xu, Xu, Xu^Qhu, Xu^Qhu, Qxu, Uu^Tf, Uu, Urb, Uu^Tf, Urb, Uu, Uu, Qxu^Qspd, Qxu^Qspd, Uh, Uh, Ur^Qhu, Wwf^Es, Wwf^Es, Wwg, Wwg, Wwf^Es, Wwg, Uu^Tf, Ur, Ur^Qhu, Uu^Qhu, Uu^Vud, Uu^Edt, Uu^Edt, Uu, Cte, Re, Uue, Uue, Uue, 2 Kte, Cte, Xu, Xoa, Xu, Xu, Xu, Xu, Xu, Uu^Tf, Uh, Qxu, Ur^Ii, Ur, Qxu, Uu, Urb, Uu^Tf, Rb, Uu^Tf, Uh, Urb, Urb, Xu^Qhu, Uu, Uh, Wwrg, Wwrg, Uh, Xu, Xu, Xu, Xu
Wog, Xu, Xu, Xu, Xu, Xu^Qhu, Xu^Qhu, Uu, Uu, Urb, Urb, Urb, Uu, Uu^Tf, Uh, Uh, Uh, Uh^Qhu, Wwg^Qhu, Wwrg, Wwf, Wwrg, Wwg, Wwf, Xu, Uu, Ur^Qhu, Tb^Tf, Qxu, Qxu, Uu, Uu, Cte, Kte, Uh, Re, Rp, Isa, Uh, Qxu, Qxu, Uh, Uh, Qxu, Xu, Xu, Uh, Uh, Uu^Tf, Uh^Ii, Uh, Urb, Qxu, Ur, Uu^Ii, Urb, Uu^Emf, Uu^Tfi, Uh, Xu, Xu^Qhu, Xu, Uh, Wwg^Es, Wog, Wwg, Xu, Xu, Xu, Xu
Xu, Wog, Wog, Xu, Xu, Xu, Xu^Qhu, Uu^Tf, Uh, Uu, Uh, Uu, Uh, Uh, Xu, Uh^Qspd, Xu^Qhu, Uh, Wog^Qhu, Wog, Wwf, Wwf^Es, Uu^Tf, Xu, Xu, Xu, Uu^Tf, Ur^Qhu, Uu^Qhu, Qxu, Qxu, Qxu, Ur, Uu^Tf, Uu, Uu, Uu, Re^Tf, Tb^Tf, Uh, Qxu, Qxu, Qxu, Qxu, Qxu, Xu, Xu, Xu, Uh, Uu^Tf, Uu^Tfi, Urb^Ii, Urb, Qxu, Cte, Uu, Uu^Tfi, Uh^Ii, Xu, Xu, Xu, Xu^Qhu, Xu^Qhu, Xu, Wog, Wog^Es, Wog, Xu, Xu^Qhu, Xu^Qhu
Uh, Xu, Wog, Wog, Xu, Xu, Xu^Qhu, Qxu, Qxu, Uh, Uu, Rb, Rb, Xu, Xu^Qhu, Xu^Qhu, Xu, Uh^Qhu, Wog, Wwrg, Wwrg, Wwg, Uu^Tf, Uh, Tb^Tf, Qxu, Qxu, Uu, Uu, Uu^Qhu, Uh, Uu^Tf, Ur, Uu, Uu, Xoa, Uu, Re^Emf, Re^Em, Uu^Tf, Uu, Uu, Uu^Tf, Qxu, Uh, Xu, Xu, Xu, Uh^Ii, Uh, Uu^Tfi, Uh, Cte, Qxu, Cte, Uu, Uu^Tf, Uu^Tf, Xu, Xu, Xu, Xu, Xu, Xu^Qhu, Xu^Qhu, Wog, Xu^Qhu, Xu^Qhu, Xu, Xu
Uh, Uu^Tf, Uh, Wog, Wog, Xu, Xu, Xu^Qhu, Xu^Qhu, Uu, Wwf^Qhu, Wwf^Qhu, Rb^Qhu, Uu^Qhu, Uu, Xu, Uh, Wog, Wog, Wwf, Wwrg^Qhu, Wwg^Qhu, Uh^Qhu, Tb^Tf, Uh, Qxu, Qxu, Uu^Tf, Uu, Uh^Qhu, Uu, Ur, Uh, Uh, Uu, Uu, Uh, Uh, Uu^Edt, Ur^Edt, Ur, Uh, Uh, Tb^Tf, Tb^Tf, Uh, Xu^Qhh, Xu, Xu, Uu, Uu^Vu, Rb^Es, Rb, 3 Kte, Urb, Uh, Uu^Tf, Xu, Xu, Xu, Xu, Xu, Xu, Xu, Xu, Xu^Qhu, Xu, Xu, Xu, Xu
Uh, Tb^Tf, Uu^Tf, Wog, Wog, Xu, Xu, Xu, Wwrg, Wwf^Qhu, Wwrg, Wwf, Wwrg, Wwf, Wwg, Uh, Wog, Wog, Wwf^Qhu, Wwf^Qhu, Uh, Uh, Uh^Qhu, Tb^Tf, Xu, Qxu, Qxu, Uu, Rp^Qhu, Rp^Qhu, Xoa, Rp^Efm, Uh, Uh, Xu, Xu, Xu, Uh, Uh, Uu^Edt, Xoa, Uu, Ur, Uu^Tf, Uu, Uh^Qhh, Uu^Vud, Xu^Qhh, Xu^Qhh, Uh, Uu, Uu, Uh, Urb, Urb, Qxu, Qxu, Uh, Xu, Xu, Xu, Xu, Xu, Xu, Xu, Xu, Xu, Xu, Xu, Xu
Xu, Uh, Xu, Xu, Ss, Ss, Ss, Wwf, Wwrg, Wwrg, Ss, Wwg, Wwrg, Wwrg, Ss, Wwf, Wwg, Wwg^Qhu, Wwg, Wwf, Xu^Qhu, Uh^Qhu, Xu, Xu, Xu^Qhu, Xu, Uh^Qhu, Uh^Qhu, Rp^Edt, Uu^Edt, Uu, Uu, Xu, Xu, Xu^Zok, Xu^Zok, Xu^Zok, Xu, Xu, Uu, Uu, Uu, Rp, Gll^Gvs, Cte^Qhh, Uu^Qhh, Uu, Xu, Xu, Xu^Qhh, Xu, Uu^Ii, Qxu, Qxu, Qxu, Qxu^Bcx\, Rb, Uh, Uh, Xu, Uh, Xu, Uh, Xu, Qxu, Qxu, Qxu, Xu, Xu, Xu
Xu, Xu, Xu, Xu, Ss, Ss, Uh, Uh, Uh, Wwg, Wwg^Vm, Ss, Chw, Chs, Wwf, Wwrg, Wwg, Wwf^Qhu, Wwrg, Xu^Qhu, Xu^Qhu, Xu, Xu^Qhu, Xu^Qhu, Wwf, Xoa^Qhu, Uh, Uu^Tf, Wwrg, Uu^Edt, Uh, Uh, Xu, Xu^Zok, Uu^Zok, Uu^Zok, Uu^Zok, Xu^Zok, Xu, Uh, Uh, Ur, Rp^Efm, Kte^Qhh, Cte, Uh, Ur^_mh, Uu, Xu, Xu^Qhh, Xu, Uh, Qxu, Qxu, Xu, Qxu, Cud, Urb^Ii, Urb, Urb, Urb, Uh, Uu, Uh, Qxu, Qxu, Qxu, Qxu, Xu, Xu
Xu, Xu, Ss, Ss, Ss, Uu^_ml, Uu, Uu, Wwf, Wwrg, Wwrg, Wwf, Chw, Wwrg, Wwg, Wwf^Es, Wog, Wog^Qhu, Wwf, Wwf, Wwf, Xu^Qhu, Wwg, Wwf, Wwrg, Wwg, Wwg, Wwrg, Rp^Qhu, Wwg, Qxu, Qxu, Xu, Xu^Zok, Uu^Zok, Uu^Zok, Uu^Zok, Xu^Zok, Xu, Uh, Uu, Uu, Isa, Cte^Qhh, Xu^Qhh, Uh, Rb^Es, Uu, Xu^Qhh, Xu^Qhh, Xu, Xu, Qxu, Qxu, Qxu, Qxu, Qxu, Uh, Uh, Uh, Urb^Ii, Uu, Uh, Qxu, Uu, Uu, Qxu, Qxu, Xu, Xu
Xu, Xu, Ss, Ss, Ss, Uh, Uh, Rb, Rb, Uh, Ss^Bw/, 6 Khw, Chs, Wwrg, Wwf, Wwf, Wwf, Wwf, Wog, Wwg, Wwg, Wwrg, Wwg, Wwf^Es, Xu, Xu, Uu^Tf, Uu, Rp^Qhu, Qxu, Qxu, Qxu, Xu, Xu^Zok, Uu^Zok, Uu^Zok, Uu^Zok, Xu^Zok, Xu, Uh, Uu, Rp, Re^Em, Uu^Tf, Qxu, Xu^Qhh, Uu^Qhh, Rb^Qhh, Uh, Xu, Xu, Xu, Uh, Uh, Uh, Qxu, Qxu, Qxu, Qxu, Qxu, Rb, Uu, Qxu, Qxu, Urb, Uu^Vud, Qxu, Xu, Xu, Xu
Ss, Ss, Ss, Ss, Ss, Uh, Uh, Uh, Ss, Uu, Ss, Ss, Chw, Ss, Wwrg, Wwg, Wwf, Wog, Wwf^Es, Wwg, Wwf, Wwg, Wwf^Es, Wwf, Wwg, Uu^Tf, Uu, Wwf, Uu^Qhu, Qxu, Xoa, Uu, Uh, Xoa, Xoa, Xu^Zok, Xoa, Xoa, Uh, Uu, Xoa, Ur^Gvs, Rp^Tf, Tb^Tf, Uh, Qxu, Uh, Rb, Rb, Uu^Tf, Uu, Uu^Tf, Rb, Uu^Tf, Uu, Uh, Uu, Uu, Rb, Qxu^Bcx/, Qxu, Qxu, Xu, Uh, Uu, Urb, Qxu, Xu, Xu, Xu
Xu, Xu, Xu, Xu, Wog, Ss, Ss, Uh, Ss, Ss, Ss, Wwrg, Wwrg, Ss, Wwf, Wwg, Wwg, Wwf, Wwf, Wwrg, Uu^Qhu, Uu^Tf, Wwf, Wwg, Wwg, Wwf, Wwf, Wwf, Uu, Rp^Qhu, Rp^Qhu, Uu, Uh, Uh, Uu^Eb, Xu, Uu^Eb, Uu, Uh, Uh, Uu^Edt, Ur^Edt, Ur, Uh, Uh, Xu, Xu, Uu, Uh, Rb, Ur, Ur, Uu, Rb, Rb, Urb, Uu^Vud, Urb, Rb, Qxu, Qxu, Qxu, Xu, Xu, Qxu, Qxu, Qxu, Xu, Xu, Xu
Xu, Xu, Xu, Xu, Wog, Ss, Ss, Ss, Xu, Ss, Ss, Ss, Xu, Wwg, Xu, Wwrg, Uh^Qhu, Xu^Qhu, Xu^Qhu, Uh^Qhu, Ur, Uu^Qhu, Uu^Tf, Wwf, Xu, Wwrg, Uu^Tf, Uu^Tf, Ur, Uu, Rp^Qhu, Rb, Uh, Uu, Rb, Isa, Rb^Gvs, Uu, Uu, Ur^Edt, Ur^Edt, Ur^Edt, Ur, Uu, Uu^Vu, Xu, Xu^Qhu, Xu^Qhu, Xu^Qhu, Xu, Xu, Uh, Uh, Rb^Tf, Rb^Es, Urb, Urb, Uu^Tf, Uu, Uu, Qxu, Qxu, Qxu, Qxu, Qxu, Xu, Urb, Uh, Xu, Xu
Xu, Xu, Xu, Wog, Xu, Xu, Ss, Ss, Xu, Xu, Xu, Xu, Xu^Qhu, Xu, Xu^Qhu, Uu^Qhu, Ur, Cte, Cte, Uu, Ur, Ur^Qhu, Xu^Qhu, Xu^Qhu, Xu^Qhu, Xu, Uu^Tf, Uu^Vu, Ur^Qhu, Uu^Qhu, Cte, Cte, Rb^Em, Rb^Tf, Uu, Xoa, Rp, Rp^Efm, Rb^Tf, Rb^Edt, Uh, Qxu, Uh, Uu, Ur, Xu^Qhu, Xu, Xu, Xu, Xu^Qhu, Xu^Qhu, Uu^Tf, Uu, Rb^Em, Urb, Urb, Uu, Uu, Urb, Xu, Qxu, Xu, Xu, Qxu, Qxu, Uu^Tf, Uh, Uh, Xu, Xu
Uh, Xu, Wog, Wog, Xu, Xu, Uh, Uh, Xu^Qhu, Xu^Qhu, Xu^Qhu, Xu^Qhu, Xu, Xu^Qhu, Uh, Uh, Uu, Cte, Xu, Xu, Uu, Ur, Ur, Xu, Xu^Qhu, Xu, Uu, Ur, Uu^Qhu, Uu^Tf, Qxu, Kte, Uh, Rb, Ur, Uu, Rb^Em, Rb^Tf, Tb^Tf, Uh, Qxu, Qxu, Xu, Uu, Re^Qhu, Uu^Qhu, Uh, Xu, Xu, Xu, Xu^Qhu, Uu^Tf, Uh, Urb, Urb, Rb, Uu^Tf, Uu^Tf, Xu, Xu, Xu^Qhu, Xu, Xu, Qxu, Qxu, Qxu, Xu, Xu, Xu, Xu
Wog, Wog, Uu, Xu, Xu, Xu, Xu^Qhu, Xu^Qhu, Xu, Xu, Xu, Xu, Uu^Tf, Uu, Urb, Urb, Urb, Qxu, Qxu, Xu, Qxu, Ur, Rb, Uu, Xu^Qhu, Uu, Ur^Qhu, Ur^Qhu, Qxu, Qxu, Xu, Qxu, Uh, Ur, Uh, Rb, Rb, Rb^Emf, Uh, Qxu, Qxu, Qxu, Xu, Xu^Qhu, Uu, Ur, Uu, Xu, Ql, Xu, Xu, Xu^Qhu, Xu^Qhu, Uh, Uu^Tf, Uh, Uu^Tf, Uu^Tf, Xu^Qhu, Xu^Qhu, Xu, Xu^Qhu, Xu^Qhu, Xu, Qxu, Qxu, Xu, Xu, Xu, Xu
Wog, Wog, Xu, Xu, Xu^Qhu, Xu^Qhu, Xu, Xu, Xu, Xu, Xu, Uh, Uu, Urb, Tb^Tf, Uu^Tf, Ur, Uu, Uu, Qxu, Qxu, Uu, Qxu, Rb, Uu, Uu^Qhu, Uh, Xu, Xu, Xu, Xu, Qxu, Uh, Uu^Vud, Qxu, Uh, Uh, Uh, Xu, Qxu, Xu, Xu, Xu^Qhu, Xu^Qhu, Xu, Ur, Re, Uu, Uu, Ql, Ql, Xu, Xu, Xu^Qhu, Xu^Qhu, Xu^Qhu, Xu^Qhu, Xu^Qhu, Xu, Xu, Qxu, Xu, Xu, Xu^Qhu, Xu^Qhu, Xu, Xu, Xu, Xu, Xu
Xu, Xu, Xu^Qhu, Xu^Qhu, Xu, Xu, Qxu, Qxu, Qxu, Xu, Xu, Xu, Urb, Urb^Emf, Uh, Tb^Tf, Ur, Ur, Uh, Qxu, Qxu, Qxu, Qxu, Uu, Rb, Uu, Uh, Xu, Uu, Xu, Xu, Xu, Xu, Uh, Uu, Uh, Uu, Xu, Xu, Xu, Xu^Qhu, Xu^Qhu, Xu, Xu, Ql, Uh, Uu, Re, Ur, Uu, Uh, Ql, Xu, Xu, Xu, Xu, Xu, Xu, Qxu, Qxu, Qxu, Xu, Xu, Xu, Xu, Xu^Qhu, Xu^Qhu, Xu, Xu, Xu
Xu^Qhu, Xu^Qhu, Xu, Xu, Qxu, Xu, Qxu, Qxu, Tb^Tf, Qxu, Uu, Urb, Uu^Tf, Tb^Tf, Uh, Uu^Tf, Ur, Uu, Uh, Xu, Qxu, Qxu, Qxu, Uue^Tf, Rb, Uu, Uu, Uh, Rb, Uu^Tf, Uh, Xu, Xu, Uh, Xu, Ur, Uu, Xu, Xu, Xu^Qhu, Xu, Xu, Ql, Ql, Ql, Ql, Ur, Ur, Ql, Ur, Re, Uh, Uu, Uh, Uh, Uh, Uu^Vu, Uh, Uh^Ii, Qxu, Xu, Ql, Ql, Xu, Xu, Xu, Xu, Xu^Qhu, Xu^Qhu, Xu
Xu, Xu, Xu, Xu, Qxu, Qxu, Uu^Tf, Tb^Tf, Urb, Urb, Uu, Uh, Qxu, Ur, Ur, Uh, Uu, Uh, Qxu, Qxu, Qxu, Qxu, Uh, Uue^Tf, Tb^Tf, Rb^Es, Uu, Rb, Uu, Rb^Em, Rb^Tf, Uh, Uue^Tf, Uu, Uh, Xu, Uh, Uh, Xu, Xu^Qhu, Xu, Xu, Ql, Ql, Uu, Uu, Ur, Uu, Ql, Ql, Ql^Bs/, Re, Re^_ml, Uu, Xu, Uh, Uu, Uu, Uh^Ii, Xu, Xu, Xu, Ql, Xu, Xu, Xu, Xu, Xu, Xu, Xu^Qhu
Xu, Xu, Xu, Xu, Xu, Qxu, Uh, Ur, Qxu, Qxu, Qxu, Qxu, Qxu, Uh, Qxu, Ur, Uu, Ur, Uh, Qxu, Qxu, Uu, Uu^Tf, Uh, Ur, Rb^Em, Uh, Uh, Xu, Rb, Rb, Rb^Tf, Uue, Tb^Tf, Tb^Tf, Uh, Ur, Uh, Uh, Xu^Qhu, Xu^Qhu, Xu, Uh, Ql, Uu, Ur, Ql, Ql, Ql, Uu, Ql, Ql, Xu, Re, Re, Xu, Xu, Re^Ii, Uu^Ii, Xu, Ql, Ql, Xu, Xu, Xu, Xu, Xu, Xu, Xu, Xu
Xu, Xu, Xu, Xu, Xu, Qxu, Uh, Uu^Vud, Ur, Qxu, Qxu, Qxu, Qxu, Uh, Qxu, Uh, Ur, Uu, Ur, Qxu, Uu, Ur, Ur, Ur, Uh, Uu, Xu, Xu, Xu, Xu, Xu, Rb, Rb^Em, Uue, Uue^Tf, Uh, Uu^Tf, Uu, Ur, Uu, Uu^Qhu, Uu, Uu, Uh, Uh^Ii, Re, Uu, Ql, Cud, Ql, Ql, Ql, Xu, Re, Re, Uu^Tf, Xu, Uu^Ii, Uu, Ql, Ql, Xu, Xu, Xu, Xu, Uh, Uu, Xu, Xu, Xu
Xu, Xu, Xu, Xu, Xu, Xu, Xu, Uu, Uu, Ur, Uu, Xu, Xu, Xu, Xu, Qxu, Uu, Uu, Uu, Ur, Xu, Uh, Rb, Uh, Rb^Tf, Xu, Xu, Xu, Uu, Xu, Xu, Uu^Tf, Rb, Uh, Uu^Vu, Uu, Uu, Ur, Ur, Uu, Xu^Qhu, Ur, Xu, Uu, Xu, Re, Re, Uu, Uu, Cud, Uu, Uh, Xu, Uu, Uu, Uh, Uu, Uu, Ql, Ql, Ql, Ql, Xu, Xu, Uh, Uh, Cud, Uh, Xu, Xu
Xu, Xu, Xu, Xu, Xu, Xu, Qxu, Qxu, Uu, Urb, Uu, Uh, Xu, Xu, Xu, Uu, Urb, Ur, Xu, Xu, Xu, Uu, Rb, Uue^Tf, Rb^Tf, Xu, Xu, Xu, Ur^Pr/, Xu, Ur, Uu, Rb, Uu^Em, Uu, Uu, Qxu, Ur, Uu, Uh, Xu, Xu^Qhu, Xu^Qhu, Xu, Xu, Uh, Uu, Re, Re, Re, Uu, Xu, Uu, Re, Uu, Uu, Re, Re, Uu, Ql, Ql, Ql, Ql, Xu, Ql, Uu, Uu, Uu, Xu, Xu
Xu, Xu, Xu, Xu, Xu, Xu, Xu, Qxu, Qxu, Uu, Ur, Xu, Xu, Xu, Uu^Tf, Uu, Urb, Uu, Xu, Xu, Xu, Xu, Xu, Uue^Tf, Uue^Tf, Rb^Emf, Xu, Xu, Uu, Ur, Ur, Rb, Uu, Uu^Em, Uu, Qxu, Qxu, Qxu, Uh, Uu^Tf, Xu, Xu, Xu^Qhu, Xu, Xu, Xu, Uh, Tb^Tf, Re, Re^Ii, Xu, Xu, Ur, Uu, Uh, Uh, Ql, Ql, Ql^Bcx|, Ql, Ql, Ql, Ql, Ql, Ql, Uu, Xu, Xu, Xu, Xu
Xu, Xu, Xos, Xos, Xos, Xu, Qxu, Qxu, Qxu, Uu, Uu, Rb, Rb^Emf, Uu, Uu, Uh, Rb, Uu, Xu, Qxu, Qxu, Xu, Xu, Uhe, Uhe, Uue, Rb^Emf, Rb^Em, Rb, Uu, Uu^Tf, Ur, Ur, Uu, Qxu, Qxu, Qxu, Uh, Ur, Uu, Uu, Xu, Uh^Qhu, Uh, Uu, Xu, Xu, Uh, Re, Uh, Uh, Ur, Uu^Ii, Uu, Uh, Uh, Ql, Ql, Uu, Ql, Ql, Ql, Xu, Ql, Ql, Ql, Xu, Xu, Xu, Xu
Xu, Xu, Xos, Xos, Xos, Qxu, Qxu, Qxu, Qxu, Qxu, Uu, Uh, Uu^Tf, Urb, Urb, Rb, Uu^Tf, Uu^Tf, Xu, Xu, Qxu, Xu, Xu, Xu, Xu, Uhe, Uue^Tf, Rb^Tf, Uu^Tf, Uu^Tf, Xu, Uh, Xu, Qxu^Bp\, Qxu^Bp\, Qxu, Qxu, Uu, Cud, Uu, Ur, Uu, Re, Uh^Qhu, Uu, Xu, Xu, Uu, Re^Em, Uu^Tf, Re, Ur, Uu^Ii, Uh, Xu, Ql, Ql, Ur, Ql, Cud, Ql, Ql, Ql, Ql, Ql, Ql, Xu, Xu, Xu, Xu
Xu, Xu, Xu, Xos, Xu, Xu, Qxu, Qxu, Xu, Qxu, Uh, Tb^Tf, Uu^Emf, Urb, Cte, Rb, Uu, Uh, Uu^Tf, Xu, Qxu, Qxu, Xu, Xu, Xu, Uhe, Xu, Xu, Xu, Xu, Xu, Xu, Qxu, Qxu, Qxu, Cud, Cud, Uu, Uu, Ur, Uu^Tf, Uu, Uh, Uu^Qhu, Re, Xu, Uu, Uu, Re, Uu, Re, Uu^Ii, Uu, Uu, Xu, Xu, Uu^Vu, Ur, Ql, Ql, Uh, Ql, Ql, Ql, Ql, Uh, Xu, Xu, Xu, Xu
Xu, Xu, Xu, Xu, Xu, Xu, Xu, Xu, Xu, Uu, Uh, Tb^Tf, Uu, Cte, Uu, Cte, Uu, Uu, Uu^Emf, Tb^Tf, Qxu, Qxu, Xu, Xu, Xu, Xu, Xu, Xu, Xu, Xu, Xu, Xu, Qxu, Qxu, Xu, Cud, Qxu, Ur, Ur, Ur, Uu, Qxu, Xu^Qhu, Uh^Qhu, Re^Ii, Re, Uu, Uu, Re, Re, Uu^Ii, Ur^Ii, Re, Uu^Tf, Xu, Uu, Xu, Xu, Cud, Cud, Uh, Ql, Ql, Ql, Uu, Xu, Xu, Xu, Xu, Xu
Xu, Xu, Xu, Xu, Xu, Xu, Xu, Xu, Xu, Uu^Tf, Uh, Uu^Tf, Uu, Cte, Cte, 5 Kte, Uu, Uu, Uh, Uu^Tf, Qxu, Qxu, Qxu, Xu, Qxu, Xu, Xu, Xu, Xu, Xu, Xu, Qxu, Qxu, Qxu, Xu, Xu, Qxu, Qxu, Uu, Ur, Cud, Qxu, Xu^Qhu, Xu, Re, Uu, Ql, Ql, Ql, Uh, Uh, Uh, Re, Xu, Xu, Xu, Uh, Uh, Uh, 4 Kud, Ql, Ql, Ql, Ql, Xu, Xu, Xu, Xu, Xu, Xu
Xu, Xu, Xu, Xu, Xu, Qxu, Qxu, Xu, Xu, Uu^Tf, Uh, Uu, Uu, Uu, Uu, Uu, Uu, Uh, Uu^Tf, Qxu, Xu, Qxu, Qxu, Qxu, Xu, Xu, Xu, Xu, Xu, Xu, Xu, Qxu, Qxu, Xu, Xu, Xu, Qxu, Qxu, Qxu, Ur, Qxu, Qxu, Xu^Qhu, Xu, Ql, Ql, Ql, Ql, Ql, Ql, Uu^Vud, Ur, Re, Ur, Uh, Uh, Uu, Uh, Uh, Xu, Ql, Cud, Ql, Ql, Ql, Xu, Uu, Xu, Uu, Uu^Emf
Xu, Xu, Uh, Xu, Qxu, Qxu, Xu, Xu, Qxu, Qxu, Qxu, Uu^Tf, Uu^Tf, Uu^Emf, Uu^Vu, Uu, Uh, Uu, Qxu, Qxu, Xu, Xu, Uh, Uu, Xu, Xu, Xu, Xu, Xu, Qxu, Qxu, Qxu, Qxu, Xu, Uh, Qxu, Qxu, Qxu, Qxu, Qxu^Bs|, Qxu, Qxu, Xu^Qhu, Xu, Xu, Ql, Ql, Ql, Ql, Ql, Ql, Uh, Re, Re, Re, Ur, Uu, Uh, Ql, Ql, Ql, Ql, Ql, Ql, Ql, Ql, Uu, Uh, Ur, Ur
Xu, Uu, Qxu, Qxu, Qxu, Qxu, Xu, Xu, Xu, Qxu, Qxu, Uh, Uh, Uu^Tf, Uu^Tf, Uu, Uu, Uu, Qxu, Qxu, Xu, Xu, Uu^Em, Xu, Xu, Xu, Xu, Qxu, Qxu, Uu, Uu^Vud, Qxu, Qxu, Qxu, Uu^Vu, Uu, Xu, Qxu, Qxu, Uu^Ii, Qxu, Xu, Xu^Qhu, Xu, Xu, Ql, Ql, Ql, Ql, Ql, Ql, Uh, Uh, Ur, Uh, Uh, Cud, Ql, Ql, Ql, Xu, Ql, Qlf, Qlf, Ql, Xu, Xu, Uu, Tb^Tf, Uh
Uh, Uh, Uh, Qxu, Qxu, Qxu, Qxu, Xu, Uh, Uh, Qxu, Qxu, Qxu, Uh, Qxu, Qxu, Qxu, Qxu, Qxu, Qxu, Qxu, Uu, Uh, Uh, Xu, Xu, Xu, Qxu, Qxu, Uh, Uu, Qxu, Qxu, Qxu, Xu, Xu, Xu, Qxu, Qxu, Qxu, Qxu, Xu, Xu^Qhu, Xu, Xu, Xu, Xu, Ql, Ql, Ql, Ql, Ql, Ql, Ql, Ql, Ql, Ql, Ql, Ql, Ql, Xu, Xu, Qlf, Qlf, Xu, Xu, Uu, Ur, Uh, Uh
Urb, Uu, Uu, Qxu, Qxu, Qxu, Xu, Qxu, Xu, Uu, Uu, Qxu, Qxu, Qxu, Qxu, Qxu, Qxu, Qxu, Qxu, Qxu, Uu, Uu^Em, Xu, Xu, Xu, Xu, Xu, Xu, Xu, Xu, Qxu, Qxu, Qxu, Uh, Xu, Xu, Xu, Xu, Xu, Xu, Xu^Qhu, Xu^Qhu, Xu, Xu, Ql, Ql, Ql, Xu, Xu, Ql, Xu, Ql, Ql, Ql, Ql, Ql, Ql, Ql, Ql, Ql, Ql, Ql, Ql, Uh, Uh, Xu, Ur, Uu, Xu, Xu
Uh, Urb, Qxu^Bp\, Qxu, Qxu, Xu, Xu, Xu, Xu, Uh, Uu, Qxu, Qxu, Qxu, Qxu, Qxu, Qxu, Qxu, Qxu, Qxu, Uu, Uu, Qxu, Xu, Xu, Xu, Xu, Xu, Xu, Xu, Qxu, Qxu, Uh, Uh, Xu, Xu, Xu, Xu, Xu^Qhu, Xu^Qhu, Xu, Xu, Xu, Xu, Ql, Xu, Xu, Ql, Xu, Ql, Xu, Ql, Ql, Ql, Xu, Ql, Ql, Xu, Qlf, Ql, Ql, Ql, Ql, Uu, Uu, Ur, Uu, Xu, Xu, Xu
Uu, Uu, Qxu, Qxu, Qxu, Qxu, Xu, Xu, Xu, Xu, Uh, Tb^Emf, Uh, Qxu, Xu, Xu, Qxu, Qxu, Qxu, Qxu, Qxu, Qxu, Qxu, Xu, Xu, Xu, Xu, Xu, Qxu, Qxu, Qxu, Xu, Xu, Xu, Xu, Xu, Xu, Xu^Qhu, Xu, Qlf, Uu^Vu, Xu, Uh, Xu, Xu, Ql, Xu, Ql, Ql, Ql, Xu, Xu, Xu, Ql, Xu, Xu, Xu, Xu, Ql, Ql, Uu, Ql, Uh, Uu, Ur, Ur, Xu, Xu, Xu, Xu
Uu, Qxu, Qxu, Qxu, Uu, Uu, Uu, Xu, Qxu, Xu, Uh, Tb^Tf, Tb, Xu, Xu, Xu, Qxu, Qxu, Xu, Qxu, Qxu, Qxu, Uh, Qxu, Xu, Xu, Xu, Xu, Qxu, Qxu, Xu, Xu, Xu, Xu, Xu, Xu, Xu, Xu^Qhu, Qlf, Qlf, Uh, Uh, Cud, Xu, Ql, Ql, Xu, Xu, Ql, Ql, Ql, Xu, Xu, Xu, Xu, Xu, Xu, Xu, Uu, Uu, Uu, Uh, Uu, Uu^Vud, Uu, Xu, Xu, Xu, Xu, Xu
Xu, Uh, Xu, Qxu, Uu, Urb, Urb, Uu, Uh, Qxu, Xu, Tb^Tf, Uh, Xu, Xu, Qxu, Qxu, Xu, Xu, Qxu, Xu, Xu, Tb^Tf, Qxu, Xu, Xu, Xu, Qxu, Qxu, Qxu, Xu, Xu, Qxu, Xu, Xu, Xu, Xu, Xu^Qhu, Xu, Qlf, Xu, Uh, Xu, Ql, Xu, Xu, Xu, Xu, Ql, Ql, Xu, Ql, Ql, Xu, Xu, Xu, Uh, Uh, Ur, Ur, Xu, Uu, Xu, Uu, Ql, Ql, Xu, Xu, Xu, Xu
Xu, Xu, Xu, Xu, Xu, Uh, Urb, Uu, Uh, Qxu, Qxu, Uh, Xu, Xu, Xu, Xu, Qxu, Qxu, Qxu, Qxu, Xu, Xu, Xu, Qxu, Qxu, Xu, Xu, Qxu, Qxu, Qxu, Qxu, Qxu, Qxu, Qxu, Xu, Xu, Xu, Xu^Qhu, Xu, Xu, Xu, Xu, Xu, Xu, Xu, Xu, Xu, Ql, Ql, Ql, Xu, Xu, Xu, Xu, Xu, Xu, Ur, Uu, Uu^Emf, Uu, Xu, Xu, Xu, Xu, Xu, Ql, Ql, Xu, Xu, Xu
Xu, Xu, Xu, Xu, Xu, Uh, Uu, Urb, Qxu, Uu, Xu, Xu, Xu, Xu, Xu, Xu, Xu, Qxu, Qxu, Qxu, Qxu, Xu, Xu, Qxu, Qxu, Qxu, Qxu, Qxu, Qxu, Qxu, Qxu, Qxu, Qxu, Qxu, Qxu, Xu, Xu, Xu^Qhu, Xu, Xu, Xu, Xu, Xu, Xu, Xu, Xu, Xu, Ql, Ql, Ql, Xu, Xu, Xu, Xu, Xu, Uu, Uu, Uu, Xu, Xu, Xu, Xu, Xu, Xu, Xu, Ql, Ql, Ql, Xu, Xu
