Xu, Xu, Xu, Xu, Xu, Xu, Xu, Uu, Uu, Uu, Tb^Tf, Uu, Uu, Uu, Rr, Uu, Uu, Uu, Uu^Tf, Uu, Uh, Uh, Uu, Uu, Tb^Tf, Uu^Tf, Uh, Uh, Uu, Xu, Xu, Xu, Xu, Xu, Xu, Xu, Xu, Xu, Xu, Xu, Xu, Xu, Xu, Xu, Xu
Xu, Xu, Xu, Xu, Xu, Xu, Xu, Uh, Uu, Tb^Tf, Tb^Tf, Uu, Uu^Tf, Uu, Rr, Rr, Uu^Tf, Uu, Tb^Tf, Tb^Tf, Uu^Emf, Uh, Uu, Uu^Tf, Tb^Tf, Tb^Tf, Uh, Uh, Xu, Xu, Xu, Xu, Xu, Xu, Xu, Xu, Xu, Xu, Xu, Xu, Xu, Xu, Xu, Xu, Xu
Xu, Xu, Xu, Xu, Xu, Xu, Xu, Xu, Uh, Tb^Tf, Uu, Uu^Vud, Uh, Uu, Uu, Rr, Re, Uh^Ii, Rd, Re^Tf, Uh, Uh, Uh, Xu, Re, Re, Uu, Xu, Xu, Xu, Xu, Xu, Xu, Xu, Xu, Xu, Xu, Xu, Xu, Xu, Xu, Xu, Xu, Xu, Xu
Xu, Xu, Xu, Xu, Xu, Xu, Xu, Xu, Xu, Uu, Uu^Vu, Uh, Cer^Edb, Cer^Edb, Cer^Edb, Uu, Rr^Edb, Re^Edb, Re^Edb, Re^Tf, Re, Uh, Uu, Xu, Re, Rd, Uh, Uh, Xuc, Xu, Xu, Xu, Xu, Xu, Xu, Xu, Xu, Xu, Xu, Xu, Xu, Xu, Xu, Xu, Xu
Xue, Xu, Xue, Xu, Xu, Xu, Xu, Xu, Xuc, Qxu, Qxu, Uh, Cer^Edb, 6 Ker^Edb, Cer^Edb, Uu, Re^Edb, Re, Re, Re, Re, Uu^Tf, Re, Re, Re^Edb, Re, Uh, Uh, Uu^Tf, Xuc, Xuc, Xu, Xu, Xu, Xu, Xu, Xu, Xu, Xu, Xu, Xu, Xu, Xu, Xu, Xu
Xue, Xue, Xue, Xue, Xue, Xu, Xu, Xu, Xu, Xuc, Qxu, Qxu, Re^Tf, Cer^Edb, Uu, Uu, Re, Xuc, Re, Re^Tf, Uh, Re, Uu^Vu, Re, Uu^Tf, Uh, Uh, Uu^Tf, Tb^Tf, Xu, Uh^Ii, Xuc, Xu, Xu, Xu, Xu, Xu, Xu, Xu, Xu, Xu, Xu, Xu, Xu, Xu
Uue, Qxe, Qxe, Qxe, Qxe, Xue, Xue, Xu, Xu, Xuc, Qxu, Qxu, Re^Tf, Re^Tf, Re^Edb, Re, Uu^Tf, Uu, Tb^Tf, Uh, Uu^Tf, Uu^Tf, Uu^Ii, Re, Uu, Uu, Re^Tf, Tb^Tf, Re^Emf, Uh^Ii, Uh^Ii, Xuc, Xu, Xu, Xu, Xu, Xu, Xu, Xu, Xu, Xu, Xu, Xu, Xu, Xu
Uue, Uue, Uhe, Qxe, Uhe, Qxe, Qxe, Qxe, Qxu, Qxu, Uu^Ii, Uu^Ii, Re^Ii, Re, Re, Rr, Uu^Tf, Tb^Tf, Uu^Tf, Uh, Uu^Emf, Uu, Re^Tf, Rd^Edb, Re, Uu^Ii, Re^Emf, Tb^Tf, Uu^Tf, Uh, Xu, Xuc, Xu, Xu, Xu, Xu, Xu, Xu, Xu, Xu, Xu, Xu, Xu, Xu, Xu
Rr, Uue, Rr, Uue, Uue, Uue, Re, Uue, Re, Uu, Uu, Uu^Ii, Re^Ii, Re^Tf, Rr^Edb, Rr, Re, Uh, Uh^Ii, Uh, Uh, Re^Tf, Rd, Rd^Tf, Re^Tf, Uu^Vud, Uu, Uu^Emf, Uh, Re^Emf, Xu, Xuc, Xuc, Xu, Xu, Xu, Xu, Xu, Xu, Xu, Xu, Xu, Uh, Uh, Uu
Uue^Br\, Rr, Uue^Br\, Rr, Rr, Rr, Re, Re, Rr, Re, Rr, Uu, Re, Re, Re, Rr, Rr, Re, Uu^Ii, Uu^Ii, Uu, Rd, Xu, Re, Uu, Uu, Uu, Uh, Uh^Ii, Uh^Ii, Uu^Tf, Uh, Uh, Xuc, Xu, Xu, Xue, Xu, Xue, Xu, Xu, Xuc, Uu, Uu, Re
Xu, Uue^Br/, Uhe, Uue^Br\, Uue^Br\, Uue, Uue, Tb^Tf, Tb^Tf, Tb^Tf, Uue, Rr, Re, Uue, Uue^Tf, Uue, Uue^Vu, Rr^Edt, Re, Uu, Uu, Xuc, Xu, Uu, Uu, Uh, Uu, Uu^Tf, Uu^Vu, Uh^Ii, Tb^Tf, Re^Tf, Qxu, Xuc, Xu, Xue, Xue, Xu, Xue, Xue, Xue, Uu, Re^Tf, Re^Tf, Uu
Xu, Uue, Uue^Tf, Uue^Tf, Uhe, Uu^Vud, Uu, Uu^Tf, Re, Re^Tf, Uue, Xue, Xue, Rr, Rr, Uue, Uue, Rr, Uue, Uue, Uu, Xu, Uu, Uu^Vu, Uu, Uu, Uu, Uu, Uu, Uh, Uu, Uh, Qxu, Qxu, Xue, Xue, Uue, Xue, Uue, Uue^Tf, Uue, Uue^Tf, Re, Tb^Tf, Xu
Xu, Xu, Tb^Tf, Tb^Tf, Re, Re, Cud, Uu^Tf, Uu^Vu, Re, Xue, Xue, Xue, Uue^Tf, Cud, Rr, Uue, Rd, Re, Uue, Re, Uu, Uu, Uu, Uu, Uu^Tf, Tb^Tf, Uu, Uu^Ii, Uu, Uu, Uu, Uu, Qxu, Uue^Tf, Uue^Tf, Cer, Uue, Cer^Edt, Uue, Re^Edb, Re^Edb, Uu, Uh, Xu
Xu, Xu, Uu, Tb^Tf, Uu, Cud, 9 Kud, Cud, Re^Tf, Rd, Rd, Xue, Uue, Uue, Uue, Rr, Rr, Rd^Tf, Rd, Uue, Re, Uu, Uu, Uu^Tf, Uu, Uu, Re^Em, Uh, Cud, Uu, Uu, Uu^Vud, Uu, Uu, Uue, Uue^Tf, Uue^Edt, Cer^Edb, 3 Ke^Edb, Cer, Re^Edb, Re^Edb, Xu, Xu, Xu
Xu, Xu, Xu, Uu, Uh, Cud, Cud, Cud, Uue, Tb^Tf, Rd^Tf, Re, Uue, Rr, Uue, Uue, Uhe, Rr, Rr, Re^Edb, Re^Em, Uh, Uu^Vu, Tb^Tf, Tb^Tf, Re, Re, Uh, Rd, Uu, Uu, Uu^Tf, Tb^Tf, Uh, Uu, Uue^Edt, Uue^Edt, Cer^Edb, Cer, Cer^Edt, Tb^Tf, Uu, Xu, Xu, Xu
Xu, Xu, Xu, Xu, Xuc, Uh, Uh, Uh, Uue^Vud, Uue, Uue, Uue, Cud, Rr, Uue^Vud, Uue, Uhe, Uhe, Uu^Tf, Rr, Rr, Re^Tf, Uu, Uu^Em, Uu^Tf, Uu, Rd, Re, Re^Em, Uu^Tf, Uu, Uu, Uu, Uu, Uu, Uue^Edt, Uue, Uue, Cer^Edt, Uu^Tf, Tb^Tf, Uu, Xu, Xuc, Uu^Tf
Xu, Xu, Xu, Xu, Xu, Uh, Uh, Uh, Xu, Uue, Uu, Uu^Tf, Re, Re, Re^Tf, Re, Uu^Tf, Uhe, Uu^Vud, Re, Rr^Edt, Re, Uu^Vud, Uu, Uu, Uu^Em, Tb^Tf, Rd, Re, Re, Cud, Uu^Vu, Uu, Uu, Uu, Uue^Tf, Re, Uue^Tf, Rr^Edb, Uu, Re, Uu, Uu, Uu, Uu
Xu, Xu, Xu, Xu, Xu, Xu, Xu, Xu, Xu, Xu, Uh, Uh, Rr^Edb, Re^Edb, Re^Em, Re^Tf, Rr^Emf, Tb^Tf, Cer^Em, Cer^Edt, Cer, Rr, Re^Edb, Uu, Uu, Uu, Rd, Rd, Uu^Vu, Re, Re, Re, Re, Uh, Re, Re, Re, Re^Edb, Re^Edb, Rr, Uu, Uu, Uu, Re, Re
Xu, Xu, Uh, Xuc, Xuc, Xu, Xuc, Xuc, Xuc, Xu, Uh, Uh, Rr, Uu^Tf, Uu, Re^Edb, Tb^Tf, Re^Tf, Cer^Edt, Cer^Es, Cer, Rr, Re, Re^Edb, Uu, Uu, Tb^Tf, Uu, Uu, Uu^Ii, Uu^Ii, Re^Ii, Rr, Re, Rr^Edt, Re^Edb, Uu, Re^Edt, Tb^Tf, Uu, Uu^Tf, Uh, Uh, Uu, Uu
Xu, Xuc, Uh, Uh, Cud, Cud, Uu, Uu, Uu, Xuc, Uu^Ii, Uh, Rr, Uu, Uh, Uu, Uu, Uu^Vu, Cer, 1 Ke, Rr^Edt, Rr^Edt, Uu, Uu^Vu, Uu, Uu, Cud, Uu, Uu, Tb^Tfi, Rr^Ii, Rr, Uu, Rr, Uu, Uu, Uu, Uu^Tf, Tb^Tf, Tb^Tf, Uu^Tf, Xu, Xu, Uu, Uu
Xu, Xu, Uu^Tf, Uu, Re^Edt, Cud, Re^Edt, Re, Rr, Rr, Rr^Ii, Rr, Uu, Uu, Uu^Tf, Uu, Uu, Uu, Uu, Cer, Rr, Uu^Vud, Uu, Uu, Uu, Cud, 8 Kud, Cud, Rr, Rr^Ii, Uu^Ii, Uu, Uh, Uu^Vu, Tb^Tf, Uu^Tf, Xu, Uu, Xu, Xu, Xu, Xu, Xu, Xu, Xu
Uu, Uh, Tb^Tf, Tb^Tf, Rr, Rr^Edt, Cud, Uu, Re, Uh, Uh^Ii, Re^Ii, Re, Uu^Vu, Tb^Tf, Uh, Uu^Tf, Uu, Rd, Rd, Rr^Edt, Rd, Uu, Re^Tf, Uu, Cud, Cud, Cud, Rr, Uu, Uu, Uu^Vud, Uh, Tb^Tf, Xu, Xu, Xu, Xu, Xu, Xu, Xu, Xu, Xu, Xu, Xu
Uu, Uu, Uu, Rr, Uu, Uu, Uu, Rd^Edt, Re, Uh^Ii, Uh^Ii, Uu^Ii, Re, Uu, Tb^Tf, Tb^Tf, Uu^Tf, Uu^Tf, Cud, Cud, Rr, Cud, Cud, Uu, Re^Tf, Uu, Re^Tf, Rr, Uu^Vud, Uu, Uu^Ii, Uh, Uu^Tf, Tb^Tf, Xu, Xu, Xu, Xu, Xu, Xu, Xu, Xu, Xu, Xu, Xu
Rr, Rr, Tb^Tf, Uu, Xu, Xu, Uu, Uu, Uu^Ii, Rd^Ii, Uu, Uu, Uu, Rr, Rr, Uu, Cud, Cud, Uu^Vud, Wog, Wog^Bsb|, Wog, Uu^Vud, Cud, Cud, Re^Tf, Rr, Rr, Uu, Uu, Uh, Uu, Xu, Xu, Xu, Xu, Xu, Xu, Xu, Xu, Xu, Xu, Xu, Xu, Xu
Cud, Uu, Uh, Tb^Emf, Xu, Xuc, Uh, Uu^Tf, Uu^Ii, Rd^Ii, Uu^Vu, Uu, Uu, Uh, Uh, Rr, Rr, Wog, Wog, Wog, Cud, Wog, Wog, Wog, Rr, Rr, Uu^Vud, Uu, Uu, Uh, Xu, Xu, Xu, Xu, Xu, Xu, Xu, Xu, Xu, Xu, Xu, Xu, Uh, Xu, Uh
Cud, Cud, Uu, Uu^Emf, Uh, Tb^Emf, Uu, Uu, Tb^Tf, Uu, Uu, Uu, Uu^Tf, Tb^Tf, Cud, Cud, Wog, Wog^Bsb\, Cud, Cud, Rrc^Cov, Cud, Cud, Wog^Bsb/, Wog, Cud, Cud, Uu, Uh, Uh, Xu, Xu, Xu, Xu, Xu, Xu, Xu, Xu, Xu, Xu, Xuc, Uu^Tf, Uu, Uu, Uu
Uh, Uh, Uh, Uu^Em, Xuc, Tb^Emf, Uu^Emf, Uh, Tb^Tf, Tb^Tf, Uu, Uu, Uh, Uu^Vu, Cud, Uu^Vud, Wog, Wog, Cud, Rrc^Cov, 2 Urb^Kov, Rrc^Cov, Cud, Wog, Wog, Uu^Vud, Cud, Uu, Uu, Xu, Xu, Xu, Xu, Xuc, Xuc, Xuc, Tb^Tf, Uu, Uu^Tf, Tb^Tf, Uu, Uu, Re, Re, Uu
Xu, Xu, Xu, Uu, Uh, Uh, Uh, Uh, Uh, Tb^Tf, Uh^Ii, Uh^Ii, Uu, Uu, Cud, Uu^Tf, Wog, Wog, Cud, Rrc^Cov, Rrc^Cov, Rrc^Cov, Cud, Wog, Wog, Uu, Cud, Uu, Uu, Uh, Uh, Xuc, Uu^Vu, Uh, Uh, Uu^Tf, Re, Uu, Re, Uu, Re, Uu, Uu, Uu, Uu^Tf
Xu, Xu, Xu, Uh, Re, Re, Re^Em, Uu^Tf, Re^Em, Uu, Uu^Ii, Uh^Ii, Uu, Uu, Uh, Cud, Rr, Wog^Bsb/, Wog, Cud, Cud, Cud, Wog, Wog^Bsb\, Rr, Cud, Uu, Uu^Vud, Rr, Uh, Re, Uu, Re, Rr, Rr, Re, Uu, Uu, Uu, Tb^Tf, Uu^Tf, Uu^Tf, Uh, Xu, Xu
Xu, Xu, Xu, Uh, Uh, Re, Uu, Rd, Uu^Tf, Rd, Re, Uu^Ii, Rd, Uu, Rr, Rr, Cud, Wog, Uu^Vud, Wog, Wog^Bsb|, Wog, Uu^Vud, Wog, Cud, Rr, Rr, Rr, Uu^Ii, Re, Rr, Re, Uu, Uu, Tb^Tf, Tb^Tf, Uh, Uh, Uh, Uu^Tf, Xu, Tb^Tf, Xu, Xu, Xu
Xu, Xu, Xu, Xu, Xu, Uh, Xu, Xu, Uu, Uu, Uu^Vud, Re, Rr, Rr, Uu^Vu, Uu, Uh, Cud, Cud, Wog, Rr, Wog, 4 Kud, Cud, Uu, Uu, Rr, Uu^Ii, Uu^Tfi, Uu^Ii, Uu, Uu, Uh, Uu^Tf, Uh, Uh, Xu, Uh, Xuc, Xuc, Xu, Xu, Xu, Xu, Xu
Xu, Xu, Xuc, Xuc, Uh, Uh, Uh, Uh, Re, Rd^Edt, Rr, Re, Uu^Ii, Uu, Uu^Tf, Uu, Uu, Uu^Tf, Uu^Vu, Cud, Rr, Cud, Cud, Cud, Uu, Uu, Rr, Uu^Vud, Uu^Tfi, Uu^Tfi, Uu, Qxu, Uh, Uh, Xuc, Xu, Xu, Xu, Xu, Xu, Xu, Xu, Xu, Xu, Xu
Xu, Xuc, Xuc, Uh, Uh^Ii, Uh, Uh, Uh, Re, Rr, Uu^Vud, Xu, Uu^Ii, Tb^Tf, Uu, Uh, Uh, Uu, Uu, Uu, Rr, Uu^Tf, Uu^Tf, Uh, Uu, Re, Rr^Ii, Uu, Uu^Ii, Uu^Tfi, Uu^Vud, Qxu, Qxu, Uh, Xu, Xu, Xu, Xu, Xu, Xu, Xu, Xu, Xu, Xu, Xu
Uh, Uh, Uu, Uu^Tf, Uu^Ii, Uu^Ii, Rr, Re^Edt, Rd, Uu, Uu^Ii, Uu, Xu, Uu, Uu, Uh, Uh, Uu, Rr, Rd, Uu, Uu, Uu, Uu, Uu, Re^Ii, Rr, Uu^Ii, Uu^Ii, Uu, Uu, Uu^Tf, Uu, Qxu, Xu, Xu, Xu, Xu, Xu, Xu, Xuc, Xuc, Xuc, Xu, Xu
Uh, Uh, Tb^Tf, Uu, Rr^Ii, Rr^Ii, Re^Edt, Re^Em, Uu, Uu, Uu^Ii, Uu, Xu, Xu, Uu^Tf, Uu, Re, Rr, Rr, Qxu, Uu^Tf, Uu, Uh, Uu^Vu, Rd, Rd, Re, Uu, Uu^Vu, Uu, Uu, Uu^Tf, Uu^Tf, Qxu, Qxu, Xu, Xu, Xu, Xu, Xuc, Uh, Uh, Uu, Uh, Uh
Uh, Uu^Tf, Tb^Tf, Uh, Rd, Rd^Edt, Re, Re^Em, Uh, Uu, Uu^Ii, Uu^Ii, Uu, Uu^Tf, Rd, Re, Uu, Uu, Rr, Uu, Uu^Vud, Uu, Uh, Uh, Uu, Uu, Uh, Re, Rr, Uu, Uu, Uu^Tf, Qxu, Qxu, Qxu, Xuc, Xuc, Xu, Xu, Uh, Xu, Uu, Ur^Edt, Ur, Uh
Uu, Uh, Uh, Uu^Tf, Uu, Uu^Edt, Re, Uu^Vud, Uh, Uu, Uu, Uu^Ii, Uh, Rd, Uu^Ii, Uu^Tf, Uu, Uh, Rr, Uu^Ii, Uu^Ii, Uu, Xu, Xu, Uu^Vud, Uu, Uu, Uh, Rr, Uu, Uu, Uu^Vud, Uu^Tf, Qxu, Qxu, Qxu, Xu, Xuc, Xuc, Xu, Xuc, Ur^Edt, Uu^Vud, Ur, Uh
Xu, Uh, Xu, Uu^Tf, Uh, Uh, Uh, Uu^Ii, Uu, Uu^Tf, Tb^Tf, Uu^Ii, Uu^Tfi, Re^Edt, Re, Uu^Tfi, Tb^Tfi, Uu^Ii, Uu, Rr, Uu^Ii, Uu^Tf, Xuc, Xu, Uu, Uu, Qxu, Re, Re, Rr, Rr, Uu^Tf, Uu, Qxu, Qxu, Qxu, Uh, Tb^Tf, Xu, Xu, Ur^Br/, Ur^Br/, Uu, Uh, Xu
Xu, Xu, Xu, Xu, Xu, Xu, Xuc, Xu, Uu, Uu, Uu^Tf, Uu, Uu^Ii, Re^Edt, Re^Edt, Uu, Uu, Uu, Uu^Ii, Rr, Rr, Uu, Uu, Xuc, Tb^Tf, Uu, Qxu, Qxu, Qxu, Qxu, Uu, Uu, Uu, Uu, Qxu, Qxu, Uu^Tf, Tb^Tf, Uu^Tf, Uu, Ur^Br|, Ur^Br|, Uu, Xuc, Xuc
Xu, Xu, Xu, Xu, Xuc, Xuc, Uh, Uu^Vu, Uu, Tb^Tf, Uu, Uu^Tf, Re^Ii, Re^Edt, Uu, Uu, Uu, Qxu, Uu^Ii, Uh, Uu, Rr, Rr, Tb^Emf, Tb^Tf, Rd, Re, Qxu, Qxu, Qxu, Rr, Re, Uh, Uh, Qxu, Qxu, Uh, Uu, Uu^Vud, Ur^Br/, Uu, Ur^Br\, Ur^Br\, Uh, Uu
Xu, Xu, Xu, Xu, Xuc, Uh, Uh, Uu, Cer^Edb, Re^Tf, Uu, Uu^Vu, Rd^Ii, Uu^Ii, Xuc, Uu, Xu, Uu, Uu^Tf, Tb^Tf, Uu^Ii, Uu^Ii, Rr, Uu^Vu, Uu^Emf, Uu, Re, Qxu, Qxu, Qxu, Rr, Re, Rd, Uu, Uu, Uu^Edt, Cud, Cud, Cud, Uu, Xu, Uh, Uh^Emf, Uu^Tf, Ur^Br\
Xu, Xu, Xu, Xu, Xu, Uh, Uu, Cer^Edb, 5 Ker^Edb, Cer^Edb, Uu^Tf, Uu, Uu, Rd^Ii, Xuc, Xu, Xu, Xu, Xu, Uu^Tf, Qxu, Qxu, Qxu, Rr, Rr, Uu^Tf, Uu, Re, Rr, Qxu^Bh/, Qxu, Rr, Rr^Edt, Uu^Vud, Rr^Edt, Rr^Edt, Cud, 7 Kud, Cud, Uh, Xu, Xu, Uu^Emf, Tb^Tf, Uu
Xu, Xu, Xu, Xuc, Uh, Uu^Vu, Uu, Cer^Edb, Cer^Edb, Cer^Edb, Uu, Uu^Vud, Uu, Uu^Ii, Xu, Xu, Xu, Xu, Xu, Qxu, Qxu, Qxu, Qxu, Qxu, Qxu, Rr, Rr, Rr, Qxu, Qxu, Qxu, Qxu, Qxu, Rr, Rr^Edt, Rr^Edt, Uu, Cud, Uu, Uh, Xuc, Xu, Xu, Uh, Uh
Xu, Xu, Xu, Xuc, Xu, Uh, Tb^Tf, Tb^Tf, Rd, Rd, Re, Re, Uu^Tf, Uu^Ii, Xu, Xu, Xu, Xu, Xu, Qxu, Qxu, Qxu, Qxu, Qxu, Qxu, Re, Rr, Re, Qxu, Qxu, Xuc, Qxu, Qxu, Uh, Rr^Edt, Rr, Uu^Vu, Uu, Uh, Uh, Uh, Xuc, Xu, Xu, Xu
Xu, Xu, Xu, Xu, Xu, Uu^Tf, Uu^Tf, Uh, Uu, Uu, Uu, Uu, Uh, Xu, Xu, Xu, Xu, Xu, Xu, Xu, Uh, Uh, Uu, Uu, Re, Re, Uu, Qxu, Qxu, Qxu, Xu, Xuc, Qxu, Qxu, Uu, Rr, Rr, Uu^Edt, Uu, Uu, Uu, Xuc, Xu, Xu, Xu
Xu, Xu, Xu, Xu, Xu, Xu, Uu, Uu, Uu, Uu, Uu, Uh, Xu, Xu, Xu, Xu, Xu, Xu, Xu, Xu, Xu, Uu, Uu, Re, Re, Uu, Uu, Qxu, Qxu, Xu, Xu, Xu, Xu, Qxu, Qxu, Uh, Uu, Rr, Rr, Uu, Uu, Uu, Uu, Xu, Xu
