border_size=1
usage=map

Xu          , Xu          , Xu          , Xu          , Xu          , Uu          , Uu          , Uh          , Uh          , Uu          , Uu          , Uu          , Uu          , Uh^Ii       , Rd          , Re^Uf       , Uh          , Uh          , Uu          , Xu          , Rd          , Rd          , Uu          , Xu          , Xu          , Xu          , Xu          , Xu          , Xu          , Xu          , Xu          , Xu          , Xu          , Xu          , Xu          , Xu          , Xu          
Xu          , Xu          , Xu          , Xu          , Xu          , Uu          , Uu          , Uh          , Ce          , Ce          , Ce          , Uu          , Uu          , Uu          , Re          , Re^Uf       , Re          , Uh          , Uu          , Xu          , Re          , Rd          , Uu          , Xu          , Xu          , Xu          , Xu          , Xu          , Xu          , Xu          , Xu          , Xu          , Xu          , Xu          , Xu          , Xu          , Xu          
Xu          , Xu          , Xu          , Xu          , Xu          , Qxu         , Qxu         , Uh          , Ce          , 6 Ke        , Ce          , Uu^Vu       , Re          , Re          , Re          , Re          , Re          , Uu^Uf       , Re          , Rd          , Re          , Re          , Uh          , Xu          , Uu^Uf       , Xu          , Xu          , Xu          , Xu          , Xu          , Xu          , Xu          , Xu          , Xu          , Xu          , Xu          , Xu          
Xu          , Xu          , Xu          , Xu          , Xu          , Xu          , Qxu         , Qxu         , Re^Uf       , Ce          , Uu^Vud      , Uu          , Re          , Uu          , Re          , Re^Uf       , Uh          , Re          , Uu^Vu       , Rd          , Uu^Uf       , Uh          , Uh          , Uu^Uf       , Uu^Uf       , Xu          , Uh^Ii       , Xu          , Xu          , Xu          , Xu          , Xu          , Xu          , Xu          , Xu          , Xu          , Xu          
Xu          , Xu          , Xu          , Xu          , Xu          , Xu          , Qxu         , Qxu         , Re^Uf       , Re^Uf       , Re          , Re          , Uu^Uf       , Uu          , Uu^Uf       , Uh          , Uu^Uf       , Uu^Uf       , Uu^Ii       , Rd          , Uu          , Uu          , Re^Uf       , Re^Uf       , Re^Uf       , Uh^Ii       , Uh^Ii       , Xu          , Xu          , Xu          , Xu          , Xu          , Xu          , Xu          , Xu          , Xu          , Xu          
Qxu         , Qxu         , Qxu         , Qxu         , Qxu         , Qxu         , Uu^Ii       , Uu^Ii       , Rd^Ii       , Rd          , Re          , Rr          , Uu^Uf       , Uu^Uf       , Uu^Uf       , Uh          , Uu          , Uu          , Re          , Re          , Rd          , Uu^Ii       , Re^Uf       , Uu^Uf       , Uu^Uf       , Uh          , Xu          , Xu          , Xu          , Xu          , Xu          , Xu          , Xu          , Xu          , Xu          , Xu          , Xu          
Uu          , Uu          , Re          , Uu          , Re          , Uu          , Uu          , Uu^Ii       , Rd^Ii       , Re^Uf       , Rr          , Rr          , Re          , Uh          , Uh^Ii       , Uh          , Uh          , Re          , Re          , Re^Uf       , Re^Uf       , Uu^Vud      , Uu          , Uu^Uf       , Uh          , Re^Uf       , Xu          , Xu          , Xu          , Xu          , Xu          , Xu          , Xu          , Xu          , Xu          , Xu          , Xu          
Rr          , Re          , Re          , Re          , Rr          , Re          , Rr          , Uu          , Re          , Re          , Re          , Rd          , Rd          , Re          , Uu^Ii       , Uu^Ii       , Uu          , Rd          , Re^Uf       , Rd          , Uu          , Uu          , Uu          , Uh          , Uh^Ii       , Uh^Ii       , Uu^Uf       , Uu^Vud      , Xu          , Xu          , Xu          , Xu          , Xu          , Xu          , Xu          , Xu          , Xu          
Uu          , Uu          , Uu          , Uu^Uf       , Uu^Uf       , Uu^Uf       , Uu          , Rr          , Re          , Uu          , Uu^Uf       , Uu          , Uu^Vu       , Re          , Rd          , Uu          , Uu          , Re^Uf       , Re^Uf       , Uu          , Uu          , Uh          , Uu          , Uu^Uf       , Uu^Vu       , Uh^Ii       , Uu^Uf       , Re^Uf       , Uh          , Xu          , Xu          , Xu          , Xu          , Xu          , Xu          , Xu          , Xu          
Uh          , Uu^Vu       , Uu          , Uu^Uf       , Re          , Re^Uf       , Uu          , Uu          , Uu          , Rr          , Rr          , Uu          , Uu          , Re          , Uu          , Uu          , Uu          , Uu          , Uu          , Uu^Vu       , Uu          , Uu          , Uu          , Uu          , Uu          , Uh          , Uu          , Uh          , Uu          , Uh          , Xu          , Xu          , Uu          , Xu          , Uu          , Uu^Uf       , Uu^Uf       
Rd          , Rd          , Ce          , Uu^Uf       , Uu^Vu       , Re          , Uu          , Uu          , Uu          , Uu^Uf       , Uu          , Rr          , Uu          , Re          , Re          , Uu          , Rd          , Uu          , Uu          , Uu          , Uu          , Uu^Uf       , Uu^Uf       , Uu          , Uu^Ii       , Uu          , Uu          , Uu          , Uu          , Uu          , Uu^Uf       , Uu^Uf       , Ce          , Uu          , Ce          , Uu          , Uu          
Uu          , Ce          , 9 Ke        , Ce          , Re^Uf       , Rd          , Re          , Uu          , Uu          , Uu          , Uu          , Rr          , Rr          , Re^Uf       , Re          , Uu          , Re          , Uu          , Uu          , Uu^Uf       , Uu          , Uu          , Re          , Uh          , Uu^Vud      , Uu          , Uu          , Uu^Vud      , Uu          , Uu          , Uu          , Uu^Uf       , Uu          , Ce          , 3 Ke        , Ce          , Uu          
Xu          , Ce          , Ce          , Ce          , Uu          , Re^Uf       , Re^Uf       , Re          , Uu          , Rr          , Uu          , Uu          , Uh          , Rr          , Rr          , Rd          , Re          , Uh          , Uu^Vu       , Uu^Uf       , Uu^Uf       , Re          , Re          , Uh          , Rd          , Uu^Uf       , Uu          , Uu^Uf       , Uu^Uf       , Uh          , Uu          , Uu          , Uu          , Ce          , Ce          , Ce          , Uu^Uf       
Xu          , Xu          , Uh          , Uh          , Uu^Vud      , Uu          , Uu          , Uu          , Uu          , Rr          , Uu^Vud      , Uu          , Uh          , Uh          , Uu^Uf       , Rr          , Rr          , Re^Uf       , Uu          , Uu^Uf       , Uu^Uf       , Uu          , Rd          , Re          , Re          , Uu^Uf       , Uu          , Uu          , Uu          , Uu          , Uu          , Uu          , Uu          , Uu          , Ce          , Uu^Uf       , Uu^Uf       
Xu          , Xu          , Uh          , Uh          , Xu          , Uu          , Uu          , Uu          , Rd          , Rd          , Re^Uf       , Rd          , Uu^Uf       , Uh          , Uu^Vud      , Rd          , Rr          , Rd          , Uu^Vud      , Uu          , Uu          , Uu          , Uu^Uf       , Rd          , Re          , Re          , Uu          , Uu^Vu       , Uu          , Uu          , Uu          , Uu^Uf       , Re          , Uu^Uf       , Rr          , Uu          , Rd          
Xu          , Xu          , Xu          , Xu          , Xu          , Xu          , Uh          , Uh          , Rr          , Re          , Re          , Re^Uf       , Rr          , Uu^Uf       , Ce          , Ce          , Ce          , Rr          , Rd          , Uu          , Uu          , Uu          , Rd          , Rd          , Uu^Vu       , Re          , Re          , Re          , Re          , Uh          , Re          , Re          , Rd          , Rr          , Rd          , Rr          , Uu          
Xu          , Xu          , Xu          , Xu          , Xu          , Xu          , Uh          , Uh          , Rr          , Uu^Uf       , Uu          , Re          , Uu^Uf       , Re^Uf       , Ce          , Ce          , Ce          , Rr          , Rd          , Rd          , Uu          , Uu          , Uu^Uf       , Uu          , Uu          , Uu^Ii       , Uu^Ii       , Re^Ii       , Rr          , Re          , Rr          , Re          , Uu          , Rd          , Uu^Uf       , Uu          , Uu^Uf       
Uu          , Uu          , Uu          , Uu          , Uu          , Xu          , Uu^Ii       , Uh          , Rr          , Uu          , Uh          , Uu          , Uu          , Uu^Vu       , Ce          , 1 Ke        , Rr          , Rr          , Uu          , Uu^Vu       , Uu          , Uu          , Cud         , Uu          , Uu          , Uu^Ii       , Rr^Ii       , Rr          , Uu          , Rr          , Uu          , Uu          , Uu          , Uu^Uf       , Uu^Uf       , Uu^Uf       , Uu^Uf       
Re          , Uu          , Re          , Re          , Rr          , Rr          , Rr^Ii       , Rr          , Uu          , Uu          , Uu^Uf       , Uu          , Uu          , Uu          , Uu          , Ce          , Rr          , Uu^Vud      , Uu          , Uu          , Uu          , Cud         , 8 Kud       , Cud         , Rr          , Rr^Ii       , Uu^Ii       , Uu          , Uh          , Uu^Vu       , Uu^Uf       , Uu^Uf       , Xu          , Uu          , Xu          , Xu          , Xu          
Re          , Re          , Uu          , Uu          , Re          , Uh          , Uh^Ii       , Re^Ii       , Re          , Uu^Vu       , Uu^Uf       , Uh          , Uu^Uf       , Uu          , Rd          , Rd          , Rr          , Rd          , Uu          , Re^Uf       , Uu          , Cud         , Cud         , Cud         , Rr          , Uu          , Uu          , Uu^Vud      , Uh          , Uu^Uf       , Xu          , Xu          , Xu          , Xu          , Xu          , Xu          , Xu          
Uu          , Uu          , Uu          , Rd          , Re          , Uh^Ii       , Uh^Ii       , Uu^Ii       , Re          , Uu          , Uu^Uf       , Uu^Uf       , Uu^Uf       , Uu^Uf       , Cud         , Cud         , Rr          , Cud         , Cud         , Uu          , Re^Uf       , Uu          , Re^Uf       , Rr          , Uu^Vud      , Uu          , Uu^Ii       , Uh          , Uu^Uf       , Uu^Uf       , Xu          , Xu          , Xu          , Xu          , Xu          , Xu          , Xu          
Uu          , Uu          , Uu          , Uu          , Uu^Ii       , Rd^Ii       , Uu          , Uu          , Uu          , Rr          , Rr          , Uu          , Cud         , Cud         , Uu^Vud      , Rd          , Wo^Bw|      , Uu          , Uu^Vud      , Cud         , Cud         , Re^Uf       , Rr          , Rr          , Uu          , Uu          , Uh          , Uu          , Xu          , Xu          , Xu          , Xu          , Xu          , Xu          , Xu          , Xu          , Xu          
Uh          , Uu          , Uh          , Uu^Uf       , Uu^Ii       , Rd^Ii       , Uu^Vu       , Uu          , Uu          , Uh          , Uh          , Rr          , Rr          , Uu          , Wo          , Wo          , Cud         , Wo          , Wo          , Uu          , Rr          , Rr          , Uu^Vud      , Uu          , Uu          , Uh          , Xu          , Xu          , Xu          , Xu          , Xu          , Xu          , Xu          , Xu          , Xu          , Xu          , Xu          
Uh          , Uu          , Uu          , Uu          , Uu^Uf       , Uu          , Uu          , Uu          , Uu^Uf       , Uu^Uf       , Cud         , Cud         , Uu          , Wo^Bw\      , Cud         , Cud         , Uu^Cd       , Cud         , Cud         , Wo^Bw/      , Uu          , Cud         , Cud         , Uu          , Uh          , Uh          , Xu          , Xu          , Xu          , Xu          , Xu          , Xu          , Xu          , Xu          , Xu          , Xu          , Xu          
Uh          , Uu          , Uu          , Uh          , Uu^Uf       , Uu^Uf       , Uu          , Uu          , Uh          , Uu^Vu       , Cud         , Uu^Vud      , Uh          , Wo          , Cud         , Uu^Cd       , 2 Uu^Kd     , Uu^Cd       , Cud         , Wo          , Uu          , Uu^Vud      , Cud         , Uu          , Uu          , Xu          , Xu          , Xu          , Xu          , Xu          , Xu          , Xu          , Uu^Uf       , Uu          , Uu^Uf       , Uu          , Uu          
Uh          , Uh          , Uh          , Uh          , Uh          , Uu^Uf       , Uh^Ii       , Uh^Ii       , Uu          , Uu          , Cud         , Uu^Uf       , Uh          , Wo          , Cud         , Uu^Cd       , Uu^Cd       , Uu^Cd       , Cud         , Wo          , Uu^Uf       , Uu          , Cud         , Uu          , Uu          , Uh          , Uh          , Xu          , Uu^Vu       , Uh          , Uh          , Uu^Uf       , Re          , Uu          , Re          , Uu          , Re          
Re          , Re          , Re          , Uu^Uf       , Re          , Uu          , Uu^Ii       , Uh^Ii       , Uu          , Uu          , Uh          , Cud         , Rr          , Wo^Bw/      , Wo          , Cud         , Cud         , Cud         , Wo          , Wo^Bw\      , Rr          , Cud         , Uu          , Uu^Vud      , Rr          , Uh          , Re          , Uu          , Re          , Rr          , Rr          , Re          , Uu          , Uu          , Uu          , Uu^Uf       , Uu^Uf       
Xu          , Re          , Uu          , Rd          , Uu^Uf       , Rd          , Re          , Uu^Ii       , Rd          , Uu          , Rr          , Rr          , Cud         , Uu^Uf       , Uu^Vud      , Wo          , Wo^Bw|      , Wo          , Uu^Vud      , Uu          , Cud         , Rr          , Rr          , Rr          , Uu^Ii       , Re          , Rr          , Re          , Uu          , Uu          , Uu^Uf       , Uu^Uf       , Uh          , Uh          , Uh          , Uu^Uf       , Xu          
Xu          , Xu          , Xu          , Xu          , Uu          , Uu          , Uu^Vud      , Re          , Rr          , Rr          , Uu^Vu       , Uu          , Uh          , Cud         , Cud         , Uu          , Rr          , Uu          , 4 Kud       , Cud         , Uu          , Uu          , Rr          , Uu^Ii       , Uu^Uf       , Uu^Ii       , Uu          , Uu          , Uh          , Uu^Uf       , Uh          , Uh          , Xu          , Uh          , Xu          , Xu          , Xu          
Xu          , Xu          , Uh          , Uh          , Re          , Rd          , Rr          , Re          , Uu^Ii       , Uu          , Uu^Uf       , Uu          , Uu          , Uu^Uf       , Uu^Vu       , Cud         , Rr          , Cud         , Cud         , Cud         , Uu          , Uu          , Rr          , Uu^Vud      , Uu^Uf       , Uu^Uf       , Uu          , Qxu         , Uh          , Uh          , Xu          , Xu          , Xu          , Xu          , Xu          , Xu          , Xu          
Uh^Ii       , Uh          , Uh          , Uh          , Re          , Rr          , Uu^Vud      , Xu          , Uu^Ii       , Uu^Uf       , Uu          , Uh          , Uh          , Uu          , Uu          , Uu          , Rr          , Uu^Uf       , Uu^Uf       , Uh          , Uu          , Re          , Rr^Ii       , Uu          , Uu^Ii       , Uu^Uf       , Uu^Vud      , Qxu         , Qxu         , Uh          , Xu          , Xu          , Xu          , Xu          , Xu          , Xu          , Xu          
Uu^Ii       , Uu^Ii       , Rr          , Re          , Rd          , Uu          , Uu^Ii       , Uu          , Qxu         , Uu          , Uu          , Uh          , Uh          , Uu          , Rr          , Rd          , Uu          , Uu          , Uu          , Uu          , Uu          , Re^Ii       , Rr          , Uu^Ii       , Uu^Ii       , Uu          , Uu          , Uu^Uf       , Uu          , Qxu         , Xu          , Xu          , Xu          , Xu          , Xu          , Xu          , Xu          
Rr^Ii       , Rr^Ii       , Re          , Re          , Uu          , Uu          , Uu^Ii       , Uu          , Uu          , Qxu         , Uu^Uf       , Uu          , Re          , Rr          , Rr          , Qxu         , Uu^Uf       , Uu          , Uh          , Uu^Vu       , Rd          , Rd          , Re          , Uu          , Uu^Vu       , Uu          , Uu          , Uu^Uf       , Uu^Uf       , Qxu         , Qxu         , Xu          , Xu          , Xu          , Xu          , Xu          , Xu          
Rd          , Rd          , Re          , Re          , Uh          , Uu          , Uu^Ii       , Uu^Ii       , Uu          , Uu^Uf       , Rd          , Re          , Uu          , Uu          , Rr          , Uu          , Uu^Vud      , Uu          , Uh          , Uh          , Uu          , Uu          , Uh          , Re          , Rr          , Uu          , Uu          , Uu^Uf       , Qxu         , Qxu         , Qxu         , Xu          , Xu          , Xu          , Xu          , Xu          , Xu          
Uu          , Uu          , Re          , Uu^Vud      , Uh          , Uu          , Uu          , Uu^Ii       , Uh          , Rd          , Uu^Ii       , Uu^Uf       , Uu          , Uh          , Rr          , Uu^Ii       , Uu^Ii       , Uu          , Rd          , Qxu         , Uu^Vud      , Uu          , Uu          , Uh          , Rr          , Uu          , Uu          , Uu^Vud      , Uu^Uf       , Qxu         , Qxu         , Qxu         , Xu          , Xu          , Xu          , Xu          , Xu          
Uh          , Uh          , Uh          , Uu^Ii       , Uu          , Uu          , Uu          , Uu^Ii       , Uu^Uf       , Re          , Re          , Uu^Uf       , Uu^Uf       , Uu^Ii       , Uu          , Rr          , Uu^Ii       , Uu^Uf       , Rd          , Qxu         , Uu^Uf       , Uu          , Uu          , Re          , Re          , Rr          , Rr          , Uu^Uf       , Uu          , Qxu         , Qxu         , Qxu         , Uh          , Uu^Uf       , Xu          , Xu          , Xu          
Xu          , Xu          , Xu          , Xu          , Uu          , Uu          , Uu          , Uu          , Uu^Ii       , Re          , Re          , Uu          , Uu          , Uu          , Uu^Ii       , Rr          , Rr          , Uu          , Uu          , Qxu         , Uu^Uf       , Uu          , Qxu         , Qxu         , Qxu         , Qxu         , Uh          , Uh          , Uu          , Uu          , Qxu         , Qxu         , Uu^Uf       , Uu^Uf       , Uu^Uf       , Xu          , Xu          
Xu          , Xu          , Xu          , Xu          , Uu          , Uu^Uf       , Uu          , Uu^Uf       , Re^Ii       , Re          , Uu          , Uu          , Uu          , Qxu         , Uu^Ii       , Uh          , Uu          , Rr          , Rr          , Uu          , Uu^Uf       , Rd          , Re          , Qxu         , Qxu         , Qxu         , Rr          , Re          , Uh          , Uh          , Qxu         , Qxu         , Uh          , Uu          , Uu^Vud      , Xu          , Xu          
Xu          , Xu          , Xu          , Uu^Vu       , Ce          , Re^Uf       , Uu          , Uu^Vu       , Rd^Ii       , Uu^Ii       , Xu          , Uu          , Xu          , Uu          , Uu^Uf       , Uu^Uf       , Uu^Ii       , Uu^Ii       , Rr          , Uu^Vu       , Uu^Uf       , Uu          , Re          , Qxu         , Qxu         , Qxu         , Rr          , Re          , Rd          , Uu          , Uu          , Uu          , Ce          , Ce          , Ce          , Xu          , Xu          
Xu          , Xu          , Uu^Vu       , Ce          , 5 Ke        , Ce          , Uu^Uf       , Uu          , Uu          , Rd^Ii       , Xu          , Xu          , Xu          , Xu          , Xu          , Uu^Uf       , Qxu         , Qxu         , Qxu         , Rr          , Rr          , Uu^Uf       , Uu          , Re          , Uu          , Qxu^Bs/     , Qxu         , Rr          , Rr          , Uu^Vud      , Rr          , Rr          , Ce          , 7 Ke        , Ce          , Uh          , Xu          
Xu          , Xu          , Uu          , Ce          , Ce          , Ce          , Uu^Vud      , Uu^Uf       , Uu          , Uu^Ii       , Xu          , Xu          , Xu          , Xu          , Xu          , Qxu         , Qxu         , Qxu         , Qxu         , Qxu         , Qxu         , Rr          , Rr          , Rd          , Qxu         , Qxu         , Qxu         , Qxu         , Qxu         , Rr          , Rr          , Rr          , Uu^Vu       , Ce          , Uu          , Uh          , Xu          
Xu          , Xu          , Uu          , Uu^Uf       , Rd          , Rd          , Re          , Re          , Uu^Uf       , Uu^Ii       , Xu          , Xu          , Xu          , Xu          , Xu          , Qxu         , Qxu         , Qxu         , Qxu         , Qxu         , Qxu         , Rr          , Rr          , Rd          , Qxu         , Qxu         , Qxu         , Qxu         , Qxu         , Rr          , Rr          , Rr          , Uu          , Uu          , Uh          , Uh          , Uh          
