border_size=1
usage=map

Xu, Xu, Xu, Xu, Xu, Xu, Xu, Uu, Uu, Uu, Uu^Uf, Uu, Uu, Uu, Rr, Uu, Uu, Uu, Uu^Uf, Uu, Uh, Uh, Uu, Uu, Uu^Uf, Uu^Uf, Uh, Uh, Uu, Xu, Xu, Xu, Xu, Xu, Xu, Xu, Xu, Xu, Xu, Xu, Xu, Xu, Xu, Xu, Xu
Xu, Xu, Xu, Xu, Xu, Xu, Xu, Uh, Uu, Uu^Uf, Uu^Uf, Uu, Uu^Uf, Uu, Rr, Rr, Uu^Uf, Uu, Uu^Uf, Uu^Uf, Uu^Emf, Uh, Uu, Uu^Uf, Uu^Uf, Uu^Uf, Uh, Uh, Xu, Xu, Xu, Xu, Xu, Xu, Xu, Xu, Xu, Xu, Xu, Xu, Xu, Xu, Xu, Xu, Xu
Xu, Xu, Xu, Xu, Xu, Xu, Xu, Xu, Uh, Uu^Uf, Uu, Uu^Vud, Uh, Uu, Uu, Rr, Re, Uh^Ii, Rd, Re^Uf, Uh, Uh, Uh, Xu, Re, Re, Uu, Xu, Xu, Xu, Xu, Xu, Xu, Xu, Xu, Xu, Xu, Xu, Xu, Xu, Xu, Xu, Xu, Xu, Xu
Xu, Xu, Xu, Xu, Xu, Xu, Xu, Xu, Xu, Uu, Uu^Vu, Uh, Ce, Ce, Ce, Uu, Rr^Edb, Re^Edb, Re^Edb, Re^Uf, Re, Uh, Uu, Xu, Re, Rd, Uh, Uh, Xu, Xu, Xu, Xu, Xu, Xu, Xu, Xu, Xu, Xu, Xu, Xu, Xu, Xu, Xu, Xu, Xu
Xue, Xu, Xue, Xu, Xu, Xu, Xu, Xu, Xu, Qxu, Qxu, Uh, Ce, 6 Ke, Ce, Uu, Re^Edb, Re, Re, Re, Re, Uu^Uf, Re, Re, Re^Edb, Re, Uh, Uh, Uu^Uf, Xu, Xu, Xu, Xu, Xu, Xu, Xu, Xu, Xu, Xu, Xu, Xu, Xu, Xu, Xu, Xu
Xue, Xue, Xue, Xue, Xue, Xu, Xu, Xu, Xu, Xu, Qxu, Qxu, Re^Uf, Ce, Uu, Uu, Re, Xu, Re, Re^Uf, Uh, Re, Uu^Vu, Re, Uu^Uf, Uh, Uh, Uu^Uf, Uu^Uf, Xu, Uh^Ii, Xu, Xu, Xu, Xu, Xu, Xu, Xu, Xu, Xu, Xu, Xu, Xu, Xu, Xu
Uue, Qxe, Qxe, Qxe, Qxe, Xue, Xue, Xu, Xu, Xu, Qxu, Qxu, Re^Uf, Re^Uf, Re^Edb, Re, Uu^Uf, Uu, Uu^Uf, Uh, Uu^Uf, Uu^Uf, Uu^Ii, Re, Uu, Uu, Re^Uf, Re^Uf, Re^Emf, Uh^Ii, Uh^Ii, Xu, Xu, Xu, Xu, Xu, Xu, Xu, Xu, Xu, Xu, Xu, Xu, Xu, Xu
Uue, Uue, Uhe, Qxe, Uhe, Qxe, Qxe, Qxe, Qxu, Qxu, Uu^Ii, Uu^Ii, Re^Ii, Re, Re, Rr, Uu^Uf, Uu^Uf, Uu^Uf, Uh, Uu^Emf, Uu, Re^Uf, Rd^Edb, Re, Uu^Ii, Re^Emf, Uu^Uf, Uu^Uf, Uh, Xu, Xu, Xu, Xu, Xu, Xu, Xu, Xu, Xu, Xu, Xu, Xu, Xu, Xu, Xu
Rr, Uue, Rr, Uue, Uue, Uue, Re, Uue, Re, Uu, Uu, Uu^Ii, Re^Ii, Re^Uf, Rr^Edb, Rr, Re, Uh, Uh^Ii, Uh, Uh, Re^Uf, Rd, Rd^Uf, Re^Uf, Uu^Vud, Uu, Uu^Emf, Uh, Re^Emf, Xu, Xu, Xu, Xu, Xu, Xu, Xu, Xu, Xu, Xu, Xu, Xu, Uh, Uh, Uu
Uue^Br\, Rr, Uue^Br\, Rr, Rr, Rr, Re, Re, Rr, Re, Rr, Uu, Re, Re, Re, Rr, Rr, Re, Uu^Ii, Uu^Ii, Uu, Rd, Xu, Re, Uu, Uu, Uu, Uh, Uh^Ii, Uh^Ii, Uu^Uf, Uh, Uh, Xu, Xu, Xu, Xue, Xu, Xue, Xu, Xu, Xu, Uu, Uu, Re
Xu, Uue^Br/, Uhe, Uue^Br\, Uue^Br\, Uue, Uue, Uu^Uf, Uu^Uf, Uue^Uf, Uue, Rr, Re, Uue, Uue^Uf, Uue, Uue^Vu, Rr^Edt, Re, Uu, Uu, Xu, Xu, Uu, Uu, Uh, Uu, Uu^Uf, Uu^Vu, Uh^Ii, Uu^Uf, Re^Uf, Qxu, Xu, Xu, Xue, Xue, Xu, Xue, Xue, Xue, Uu, Re^Uf, Re^Uf, Uu
Xu, Uue, Uue^Uf, Uue^Uf, Uhe, Uu^Vud, Uu, Uu^Uf, Re, Re^Uf, Uue, Xue, Xue, Rr, Rr, Uue, Uue, Rr, Uue, Uue, Uu, Xu, Uu, Uu^Vu, Uu, Uu, Uu, Uu, Uu, Uh, Uu, Uh, Qxu, Qxu, Xue, Xue, Uue, Xue, Uue, Uue^Uf, Uue, Uue^Uf, Re, Uu^Uf, Xu
Xu, Xu, Uu^Uf, Uue^Uf, Re, Re, Cud, Uu^Uf, Uu^Vu, Re, Xue, Xue, Xue, Uue^Uf, Cud, Rr, Uue, Rd, Re, Uue, Re, Uu, Uu, Uu, Uu, Uu^Uf, Uu^Uf, Uu, Uu^Ii, Uu, Uu, Uu, Uu, Qxu, Uue^Uf, Uue^Uf, Ce, Uue, Ce^Edt, Uue, Re^Edb, Re^Edb, Uu, Uh, Xu
Xu, Xu, Uu, Uu^Uf, Uu, Cud, 9 Kud, Cud, Re^Uf, Rd, Rd, Xue, Uue, Uue, Uue, Rr, Rr, Rd^Uf, Rd, Uue, Re, Uu, Uu, Uu^Uf, Uu, Uu, Re^Em, Uh, Cud, Uu, Uu, Uu^Vud, Uu, Uu, Uue, Uue^Uf, Uue^Edt, Ce^Edb, 3 Ke, Ce, Re^Edb, Re^Edb, Xu, Xu, Xu
Xu, Xu, Xu, Uu, Uh, Cud, Cud, Cud, Uue, Re^Uf, Rd^Uf, Re, Uue, Rr, Uue, Uue, Uhe, Rr, Rr, Re^Edb, Re^Em, Uh, Uu^Vu, Uu^Uf, Uu^Uf, Re, Re, Uh, Rd, Uu, Uu, Uu^Uf, Uu^Uf, Uh, Uu, Uue^Edt, Uue^Edt, Ce^Edb, Ce, Ce^Edt, Uu^Uf, Uu, Xu, Xu, Xu
Xu, Xu, Xu, Xu, Xu, Uh, Uh, Uh, Uue^Vud, Uue, Uue, Uue, Cud, Rr, Uue^Vud, Uue, Uhe, Uhe, Uu^Uf, Rr, Rr, Re^Uf, Uu, Uu^Em, Uu^Uf, Uu, Rd, Re, Re^Em, Uu^Uf, Uu, Uu, Uu, Uu, Uu, Uue^Edt, Uue, Uue, Ce^Edt, Uu^Uf, Uu^Uf, Uu, Xu, Xu, Uu^Uf
Xu, Xu, Xu, Xu, Xu, Uh, Uh, Uh, Xu, Uue, Uu, Uu^Uf, Re, Re, Re^Uf, Re, Uu^Uf, Uhe, Uu^Vud, Re, Rr^Edt, Re, Uu^Vud, Uu, Uu, Uu^Em, Uu^Uf, Rd, Re, Re, Cud, Uu^Vu, Uu, Uu, Uu, Uue^Uf, Re, Uue^Uf, Rr^Edb, Uu, Re, Uu, Uu, Uu, Uu
Xu, Xu, Xu, Xu, Xu, Xu, Xu, Xu, Xu, Xu, Uh, Uh, Rr^Edb, Re^Edb, Re^Em, Re^Uf, Rr^Emf, Uu^Uf, Ce^Em, Ce^Edt, Ce, Rr, Re^Edb, Uu, Uu, Uu, Rd, Rd, Uu^Vu, Re, Re, Re, Re, Uh, Re, Re, Re, Re^Edb, Re^Edb, Rr, Uu, Uu, Uu, Re, Re
Xu, Xu, Uh, Xu, Xu, Xu, Xu, Xu, Xu, Xu, Uh, Uh, Rr, Uu^Uf, Uu, Re^Edb, Uu^Uf, Re^Uf, Ce^Edt, Ce^Es, Ce, Rr, Re, Re^Edb, Uu, Uu, Uu^Uf, Uu, Uu, Uu^Ii, Uu^Ii, Re^Ii, Rr, Re, Rr^Edt, Re^Edb, Uu, Re^Edt, Uu^Uf, Uu, Uu^Uf, Uh, Uh, Uu, Uu
Xu, Xu, Uh, Uh, Cud, Cud, Uu, Uu, Uu, Xu, Uu^Ii, Uh, Rr, Uu, Uh, Uu, Uu, Uu^Vu, Ce, 1 Ke, Rr^Edt, Rr^Edt, Uu, Uu^Vu, Uu, Uu, Cud, Uu, Uu, Uu^Ufi, Rr^Ii, Rr, Uu, Rr, Uu, Uu, Uu, Uu^Uf, Uu^Uf, Uu^Uf, Uu^Uf, Xu, Xu, Uu, Uu
Xu, Xu, Uu^Uf, Uu, Re^Edt, Cud, Re^Edt, Re, Rr, Rr, Rr^Ii, Rr, Uu, Uu, Uu^Uf, Uu, Uu, Uu, Uu, Ce, Rr, Uu^Vud, Uu, Uu, Uu, Cud, 8 Kud, Cud, Rr, Rr^Ii, Uu^Ii, Uu, Uh, Uu^Vu, Uu^Uf, Uu^Uf, Xu, Uu, Xu, Xu, Xu, Xu, Xu, Xu, Xu
Uu, Uh, Uu^Uf, Uu^Uf, Rr, Rr^Edt, Cud, Uu, Re, Uh, Uh^Ii, Re^Ii, Re, Uu^Vu, Uu^Uf, Uh, Uu^Uf, Uu, Rd, Rd, Rr^Edt, Rd, Uu, Re^Uf, Uu, Cud, Cud, Cud, Rr, Uu, Uu, Uu^Vud, Uh, Uu^Uf, Xu, Xu, Xu, Xu, Xu, Xu, Xu, Xu, Xu, Xu, Xu
Uu, Uu, Uu, Rr, Uu, Uu, Uu, Rd^Edt, Re, Uh^Ii, Uh^Ii, Uu^Ii, Re, Uu, Uu^Uf, Uu^Uf, Uu^Uf, Uu^Uf, Cud, Cud, Rr, Cud, Cud, Uu, Re^Uf, Uu, Re^Uf, Rr, Uu^Vud, Uu, Uu^Ii, Uh, Uu^Uf, Uu^Uf, Xu, Xu, Xu, Xu, Xu, Xu, Xu, Xu, Xu, Xu, Xu
Rr, Rr, Uu^Uf, Uu, Xu, Xu, Uu, Uu, Uu^Ii, Rd^Ii, Uu, Uu, Uu, Rr, Rr, Uu, Cud, Cud, Uu^Vud, Wog, Wog^Bsb|, Wog, Uu^Vud, Cud, Cud, Re^Uf, Rr, Rr, Uu, Uu, Uh, Uu, Xu, Xu, Xu, Xu, Xu, Xu, Xu, Xu, Xu, Xu, Xu, Xu, Xu
Cud, Uu, Uh, Uh^Emf, Xu, Xu, Uh, Uu^Uf, Uu^Ii, Rd^Ii, Uu^Vu, Uu, Uu, Uh, Uh, Rr, Rr, Wog, Wog, Wog, Cud, Wog, Wog, Wog, Rr, Rr, Uu^Vud, Uu, Uu, Uh, Xu, Xu, Xu, Xu, Xu, Xu, Xu, Xu, Xu, Xu, Xu, Xu, Uu, Xu, Uu
Cud, Cud, Uu, Uu^Emf, Uh, Uu^Emf, Uu, Uu, Uu^Uf, Uu, Uu, Uu, Uu^Uf, Uu^Uf, Cud, Cud, Wog, Wog^Bsb\, Cud, Cud, Rrc^Cov, Cud, Cud, Wog^Bsb/, Wog, Cud, Cud, Uu, Uh, Uh, Xu, Xu, Xu, Xu, Xu, Xu, Xu, Xu, Xu, Xu, Xu, Uu, Uu, Uu, Uu
Uh, Uh, Uh, Uu^Em, Xu, Uu^Emf, Uu^Emf, Uh, Uu^Uf, Uu^Uf, Uu, Uu, Uh, Uu^Vu, Cud, Uu^Vud, Wog, Wog, Cud, Rrc^Cov, 2 Urb^Kov, Rrc^Cov, Cud, Wog, Wog, Uu^Vud, Cud, Uu, Uu, Xu, Xu, Xu, Xu, Xu, Xu, Xu, Uu^Uf, Uu, Uu^Uf, Uu, Uu, Uu, Uu, Uu, Uu
Xu, Xu, Xu, Uu, Uh, Uh, Uh, Uh, Uh, Uu^Uf, Uh^Ii, Uh^Ii, Uu, Uu, Cud, Uu^Uf, Wog, Wog, Cud, Rrc^Cov, Rrc^Cov, Rrc^Cov, Cud, Wog, Wog, Uu, Cud, Uu, Uu, Uh, Uh, Xu, Uu^Vu, Uh, Uh, Uu^Uf, Re, Uu, Re, Uu, Re, Uu, Uu, Uu, Uu
Xu, Xu, Xu, Uh, Re, Re, Re^Em, Uu^Uf, Re^Em, Uu, Uu^Ii, Uh^Ii, Uu, Uu, Uh, Cud, Rr, Wog^Bsb/, Wog, Cud, Cud, Cud, Wog, Wog^Bsb\, Rr, Cud, Uu, Uu^Vud, Rr, Uh, Re, Uu, Re, Rr, Rr, Re, Uu, Uu, Uu, Uu^Uf, Uu^Uf, Uu, Uu, Xu, Xu
Xu, Xu, Xu, Uh, Uh, Re, Uu, Rd, Uu^Uf, Rd, Re, Uu^Ii, Rd, Uu, Rr, Rr, Cud, Wog, Uu^Vud, Wog, Wog^Bsb|, Wog, Uu^Vud, Wog, Cud, Rr, Rr, Rr, Uu^Ii, Re, Rr, Re, Uu, Uu, Uu^Uf, Uu^Uf, Uh, Uh, Uh, Uu^Uf, Xu, Uu, Xu, Xu, Xu
Xu, Xu, Xu, Xu, Xu, Uh, Xu, Xu, Uu, Uu, Uu^Vud, Re, Rr, Rr, Uu^Vu, Uu, Uh, Cud, Cud, Wog, Rr, Wog, 4 Kud, Cud, Uu, Uu, Rr, Uu^Ii, Uu^Ufi, Uu^Ii, Uu, Uu, Uh, Uu^Uf, Uh, Uh, Xu, Uh, Xu, Xu, Xu, Xu, Xu, Xu, Xu
Xu, Xu, Xu, Xu, Uh, Uh, Uh, Uh, Re, Rd^Edt, Rr, Re, Uu^Ii, Uu, Uu^Uf, Uu, Uu, Uu^Uf, Uu^Vu, Cud, Rr, Cud, Cud, Cud, Uu, Uu, Rr, Uu^Vud, Uu^Ufi, Uu^Ufi, Uu, Qxu, Uh, Uh, Xu, Xu, Xu, Xu, Xu, Xu, Xu, Xu, Xu, Xu, Xu
Xu, Xu, Xu, Uh, Uh^Ii, Uh, Uh, Uh, Re, Rr, Uu^Vud, Xu, Uu^Ii, Uu^Uf, Uu, Uh, Uh, Uu, Uu, Uu, Rr, Uu^Uf, Uu^Uf, Uh, Uu, Re, Rr^Ii, Uu, Uu^Ii, Uu^Ufi, Uu^Vud, Qxu, Qxu, Uh, Xu, Xu, Xu, Xu, Xu, Xu, Xu, Xu, Xu, Xu, Xu
Uh, Uh, Uu, Uu^Uf, Uu^Ii, Uu^Ii, Rr, Re^Edt, Rd, Uu, Uu^Ii, Uu, Xu, Uu, Uu, Uh, Uh, Uu, Rr, Rd, Uu, Uu, Uu, Uu, Uu, Re^Ii, Rr, Uu^Ii, Uu^Ii, Uu, Uu, Uu^Uf, Uu, Qxu, Xu, Xu, Xu, Xu, Xu, Xu, Xu, Xu, Xu, Xu, Xu
Uh, Uh, Uu^Uf, Uu, Rr^Ii, Rr^Ii, Re^Edt, Re^Em, Uu, Uu, Uu^Ii, Uu, Xu, Xu, Uu^Uf, Uu, Re, Rr, Rr, Qxu, Uu^Uf, Uu, Uh, Uu^Vu, Rd, Rd, Re, Uu, Uu^Vu, Uu, Uu, Uu^Uf, Uu^Uf, Qxu, Qxu, Xu, Xu, Xu, Xu, Xu, Uh, Uh, Uu, Uh, Uh
Uh, Uu^Uf, Uu^Uf, Uh, Rd, Rd^Edt, Re, Re^Em, Uh, Uu, Uu^Ii, Uu^Ii, Uu, Uu^Uf, Rd, Re, Uu, Uu, Rr, Uu, Uu^Vud, Uu, Uh, Uh, Uu, Uu, Uh, Re, Rr, Uu, Uu, Uu^Uf, Qxu, Qxu, Qxu, Xu, Xu, Xu, Xu, Uh, Xu, Uu, Ur^Edt, Ur, Uh
Uu, Uh, Uh, Uu^Uf, Uu, Uu^Edt, Re, Uu^Vud, Uh, Uu, Uu, Uu^Ii, Uh, Rd, Uu^Ii, Uu^Uf, Uu, Uh, Rr, Uu^Ii, Uu^Ii, Uu, Xu, Xu, Uu^Vud, Uu, Uu, Uh, Rr, Uu, Uu, Uu^Vud, Uu^Uf, Qxu, Qxu, Qxu, Xu, Xu, Xu, Xu, Xu, Ur^Edt, Uu^Vud, Ur, Uh
Xu, Uh, Xu, Uu^Uf, Uh, Uh, Uh, Uu^Ii, Uu, Uu^Uf, Uu^Uf, Uu^Ii, Uu^Ufi, Re^Edt, Re, Uu^Ufi, Uu^Ufi, Uu^Ii, Uu, Rr, Uu^Ii, Uu^Uf, Xu, Xu, Uu, Uu, Qxu, Re, Re, Rr, Rr, Uu^Uf, Uu, Qxu, Qxu, Qxu, Uh, Uu^Uf, Xu, Xu, Ur^Br/, Ur^Br/, Uu, Uh, Xu
Xu, Xu, Xu, Xu, Xu, Xu, Xu, Xu, Uu, Uu, Uu^Uf, Uu, Uu^Ii, Re^Edt, Re^Edt, Uu, Uu, Uu, Uu^Ii, Rr, Rr, Uu, Uu, Xu, Uu^Uf, Uu, Qxu, Qxu, Qxu, Qxu, Uu, Uu, Uu, Uu, Qxu, Qxu, Uu^Uf, Uu^Uf, Uu^Uf, Uu, Ur^Br|, Ur^Br|, Uu, Xu, Xu
Xu, Xu, Xu, Xu, Xu, Xu, Uh, Uu^Vu, Uu, Uu^Uf, Uu, Uu^Uf, Re^Ii, Re^Edt, Uu, Uu, Uu, Qxu, Uu^Ii, Uh, Uu, Rr, Rr, Uu^Emf, Uu^Uf, Rd, Re, Qxu, Qxu, Qxu, Rr, Re, Uh, Uh, Qxu, Qxu, Uh, Uu, Uu^Vud, Ur^Br/, Uu, Ur^Br\, Ur^Br\, Uh, Uu
Xu, Xu, Xu, Xu, Xu, Uh, Uh, Uu, Ce, Re^Uf, Uu, Uu^Vu, Rd^Ii, Uu^Ii, Xu, Uu, Xu, Uu, Uu^Uf, Uu^Uf, Uu^Ii, Uu^Ii, Rr, Uu^Vu, Uu^Emf, Uu, Re, Qxu, Qxu, Qxu, Rr, Re, Rd, Uu, Uu, Uu^Edt, Cud, Cud, Cud, Uu, Xu, Uh, Uh^Emf, Uu^Uf, Ur^Br\
Xu, Xu, Xu, Xu, Xu, Uh, Uu, Ce, 5 Ke, Ce, Uu^Uf, Uu, Uu, Rd^Ii, Xu, Xu, Xu, Xu, Xu, Uu^Uf, Qxu, Qxu, Qxu, Rr, Rr, Uu^Uf, Uu, Re, Rr, Qxu^Bh/, Qxu, Rr, Rr^Edt, Uu^Vud, Rr^Edt, Rr^Edt, Cud, 7 Kud, Cud, Uh, Xu, Xu, Uu^Emf, Uu^Uf, Uu
Xu, Xu, Xu, Xu, Uh, Uu^Vu, Uu, Ce, Ce, Ce, Uu, Uu^Vud, Uu, Uu^Ii, Xu, Xu, Xu, Xu, Xu, Qxu, Qxu, Qxu, Qxu, Qxu, Qxu, Rr, Rr, Rr, Qxu, Qxu, Qxu, Qxu, Qxu, Rr, Rr^Edt, Rr^Edt, Uu, Cud, Uu, Uh, Xu, Xu, Xu, Uh, Uh
Xu, Xu, Xu, Xu, Xu, Uh, Uu^Uf, Uu^Uf, Rd, Rd, Re, Re, Uu^Uf, Uu^Ii, Xu, Xu, Xu, Xu, Xu, Qxu, Qxu, Qxu, Qxu, Qxu, Qxu, Re, Rr, Re, Qxu, Qxu, Xu, Qxu, Qxu, Uh, Rr^Edt, Rr, Uu^Vu, Uu, Uh, Uh, Uh, Xu, Xu, Xu, Xu
Xu, Xu, Xu, Xu, Xu, Uu^Uf, Uu^Uf, Uh, Uu, Uu, Uu, Uu, Uh, Xu, Xu, Xu, Xu, Xu, Xu, Xu, Uh, Uh, Uu, Uu, Re, Re, Uu, Qxu, Qxu, Qxu, Xu, Xu, Qxu, Qxu, Uu, Rr, Rr, Uu^Edt, Uu, Uu, Uu, Xu, Xu, Xu, Xu
Xu, Xu, Xu, Xu, Xu, Xu, Uu, Uu, Uu, Uu, Uu, Uh, Xu, Xu, Xu, Xu, Xu, Xu, Xu, Xu, Xu, Uu, Uu, Re, Re, Uu, Uu, Qxu, Qxu, Xu, Xu, Xu, Xu, Qxu, Qxu, Uh, Uu, Rr, Rr, Uu, Uu, Uu, Uu, Xu, Xu
