Xu, Xu, Xu, Xu, Xu, Xu, Xu, Xu, Xu, Xu, Xu, Xue, Xue, Xue, Ms^Xm, Ms^Xm, Ms^Xm, Ms^Xm, Mm^Xm, Ha, Ms, Ha, Ha^Fpa, Aa, Gd, Gd, Aa, Aa, Gll^Fp, Gll, Gll, Aa^Fpa, Ha, Ms, Ms, Ms, Ms^Xm, Ms^Xm, Ms^Xm, Ms^Xm, Ms^Xm, Xue, Xue, Xu, Xu, Wwg, Wwg, Wwg, Xu, Xu, Xu, Xu, Xu, Xu
Xu, Xu, Xu, Xu, Xu, Xu, Xu, Xu, Xu, Xu, Xu, Xue, Xue, Xue, Xue, Ms^Xm, Ms^Xm, Ms^Xm, Ms^Xm, Ms^Xm, Ha^Fma, Ha, Ha^Fpa, Gll^Fp, Gll, Aa^Fma, Gd, Aa, Gll^Fmw, Aa^Fma, Aa^Fma, Aa^Fpa, Ms, Ms, Ha, Ms^Xm, Ms^Xm, Ha, Ms^Xm, Ms^Xm, Xue, Xue, Xu, Xu, Wwg, Wwg, Wwg, Wwg, Xu, Xu, Xu, Xu, Xu, Xu
Xu, Xu, Xu, Xu, Xu, Xu, Xu, Xu, Xu, Xu, Xu, Xue, Xue, Xue, Xue, Ms^Xm, Ms^Xm, Ms^Xm, Ms, Ha, Ms, Ms, Ha, Gll^Fmw, Gll^Fp, Gd, Gd, Gll, Gll^Fp, Gll^Fmw, Ha, Hhd, Hhd, Ha, Ms, Ms^Xm, Ms^Xm, Ms^Xm, Ms^Xm, Ms^Xm, Xue, Xue, Xu, Xu, Wog, Wog, Wog, Wwg, Xu, Xu, Xu, Xu, Xu, Xu
Xu, Xu, Xu, Xu, Xu, Xu, Xu, Xu, Xu, Xu, Xu, Xu, Xue, Xue, Xue, Xue, Xue, Ms^Xm, Ms^Xm, Ms, Ms, Ms, Ha, Ha, Ms, Gs, Gs, Gd, Aa^Fpa, Ha, Ms, Hhd, Ms^Xm, Ms, Ms, Ms, Ms^Xm, Ms^Xm, Ms^Xm, Xue, Xue, Xue, Xu, Wog, Wog, Wog, Wog, Xu, Xu, Xu, Xu, Xu, Xu, Xu
Xu, Xu, Xu, Xu, Xu, Xu, Xu, Xu, Xu, Xu, Xu, Xu, Xu, Xue, Xue, Xue, Xue, Ms^Xm, Ms^Xm, Ms, Ms, Ms, Ms, Ms, Ms, Ms, Gs, Aa, Ms, Ms^Xm, Ms^Xm, Ms^Xm, Ms^Xm, Ms^Xm, Ms^Xm, Ms, Xue, Xue, Xue, Xue, Xu, Xu, Wog, Wog, Wog, Wog, Xu, Xu, Xu, Xu, Xu, Xu, Xu, Xu
Xu, Xu, Xu, Xu, Xu, Xu, Xu, Xu, Xu, Xu, Xu, Xu, Xu, Xue, Xue, Xue, Xue, Xue, Ms^Xm, Ms^Xm, Ms^Xm, Ms^Xm, Xue, Ms^Xm, Xue, Ms, Gs, Gd, Xue, Ms^Xm, Xue, Xue, Xue, Xue, Xue, Xue, Xue, Xue, Xu, Xu, Xu, Xu, Wog, Wog, Wog, Xu, Xu, Xu, Xu, Xu, Xu, Xu, Xu, Xu
Xu, Xu, Xu, Xu, Xu, Xu, Xu, Xu, Xu, Xu, Xu, Xu, Xu, Xu, Xue, Xue, Xue, Xue, Xue, Xue, Xue, Xue, Xue, Xue, Xue, Uue, Uue, Uue, Xue, Xue, Xue, Xue, Xue, Xue, Xue, Xue, Xu, Xu, Xu, Xu, Xu, Wog, Wog, Wog, Xu, Xu, Xu, Xu, Xu, Xu, Xu, Xu, Xu, Xu
Xu, Xu, Xu, Xu, Xu, Xu, Xu, Xu, Xu, Xu, Xu, Xu, Xu, Xu, Xu, Xue, Xue, Xue, Xue, Xue, Xue, Xue, Xue, Xue, Xue, Uue, Re, Uue, Uhe, Xue, Xue, Xue, Xue, Xue, Xu, Xu, Xu, Xu, Xu, Xu, Wog, Wog, Wog, Wog, Xu, Xu, Xu, Xu, Xu, Xu, Xu, Xu, Xu, Xu
Xu, Xu, Xu, Xu, Xu, Xu, Xu, Xu, Xu, Xu, Xu, Xu, Xu, Xu, Xu, Xu, Xu, Xue, Xu, Xue, Xue, Xue, Xue, Xue, Xue, Uhe, Uue, Re^Ii, Re, Uue, Uue, Xue, Xue, Xu, Xuc, Xu, Xu, Xu, Xu, Xu, Xu, Wog, Wog, Wog, Xu, Xu, Xu, Xu, Xu, Xu, Xu, Xu, Xu, Xu
Xu, Xu, Xu, Xu, Xu, Xu, Xu, Xu, Xu, Xu, Xu, Xu, Xu, Xu, Xu, Xu, Xu, Xu, Xu, Xu, Xu, Xu, Xu, Xu, Xuc, Xuc, Cud, Uue, Rr, Re, Uue, Uue^Uf, Uhe, Uh, Uh, Xuc, Xuc, Xu, Xu, Xu, Xu, Wog, Wog, Wog, Wog, Xu, Xu, Xu, Xu, Xu, Xu, Xu, Xu, Xu
Xu, Xu, Xu, Xu, Xu, Xu, Xu, Xu, Xu, Xu, Xu, Xu, Xu, Xu, Xu, Xu, Xu, Xu, Xu, Xu, Xu, Xu, Xu, Xuc, Uh, Cud, 5 Kud, Cud, Rr, Uue, Uue, Rr^Em, Uue, Uu^Vu, Uh, Xu, Wwf, Xuc, Wwg, Xu, Wog, Wog^Xo, Wog^Xo, Wog, Wog, Xu, Xu, Xu, Xu, Xu, Xu, Xu, Xu, Xu
Xu, Xu, Xu, Xu, Xu, Xu, Xu, Xu, Xu, Xu, Xu, Xu, Xu, Xu, Xu, Xu, Xu, Xu, Xu, Xu, Xu, Xuc, Uh, Uh, Uu, Cud, Cud, Cud, Rr, Uu^Vud, Ur, Rr, Uue, Uue, Uu, Uh, Wwf, Wwg, Wog, Wog, Wog, Wog, Xu, Wog, Wog, Xu, Xu, Xu, Xu, Xu, Xu, Xu, Xu, Xu
Xu, Xu, Xu, Xu, Xu, Xu, Xu, Xu, Xu, Xu, Xu, Xu, Xu, Xu, Xu, Xu, Xu, Xu, Xu, Xu, Xuc, Xuc, Uu, Uu^Uf, Uu^Vu, Rr, Rr, Uu, Re, Rr, Re, Re, Uu^Ufi, Uue^Uf, Uh, Uh, Wwf, Wwg, Wwg, Wog, Wog, Wog, Xu, Wog, Wog, Wog, Wog, Xu, Xu, Xu, Xu, Xu, Xu, Xu
Xu, Xu, Xu, Xu, Xu, Xu, Xu, Xu, Xu, Xu, Xu, Xu, Xu, Xu, Xu, Xu, Xu, Xu, Xu, Xu, Xu, Uh, Uu^Emf, Uu^Emf, Ur, Ur, Ur, Rr, Rr, Re^Ii, Ur, Rr^Uf, Uu^Uf, Uh^Ii, Uh, Uu^Vud, Xu, Wwf, Wwf, Wog, Wog, Xu, Xu, Wog, Wog, Wog, Wog, Xu, Xu, Xu, Xu, Xu, Xu, Xu
Xu, Xu, Xu, Xu, Xu, Xu, Xu, Xu, Xu, Xu, Xu, Xu, Xu, Xu, Xu, Xu, Xu, Xu, Xu, Xu, Uh, Uh^Ii, Uh, Uu^Uf, Uu^Uf, Uu^Ii, Uu, Uu, Re^Uf, Ur, Rr, Rr^Em, Qxu, Uh, Xuc, Xu, Xu, Xu, Xu, Xu, Xu, Xu, Xu, Xu, Wog, Wog, Wog, Wog, Xu, Xu, Xu, Xu, Xu, Xu
Xu, Xu, Xu, Xu, Xu, Xu, Xu, Xu, Xu, Xu, Xu, Xu, Xu, Xu, Xu, Xu, Xu, Xu, Xu, Xu, Xu, Uh, Xu, Uh^Emf, Uh, Uu^Vud, Qxu^Bp\, Uh, Rr^Em, Rr, Rr, Uh, Qxu, Xuc, Xuc, Xu, Xu, Xu, Xu, Xu, Xu, Xu, Xu, Xu, Wog, Wog, Wog, Wog, Wog, Xu, Xu, Xu, Wog, Wog
Xu, Xu, Xu, Xu, Xu, Xu, Xu, Xu, Xu, Xu, Xu, Xu, Xu, Xu, Xu, Xu, Xu, Xu, Xu, Xu, Xu, Xu, Xu, Xu, Xu, Qxu, Qxu, Cud, Uu, Ur, Rr, Uu, Qxu, Qxu, Xuc, Xu, Xu, Xu, Xu, Xu, Xu, Xu, Xu, Xu, Xu, Wog, Wog, Wog, Wog, Wog, Wog, Wog, Wog, Wog
Xu, Xu, Xu, Xu, Xu, Xu, Xu, Xu, Xu, Xu, Xu, Xu, Xu, Xu, Xu, Xu, Xu, Xu, Xu, Xu, Xu, Xu, Xu, Xu, Qxu, Qxu, Qxu, Qxu, Rr, Rr, Ur, Uu, Cud, Qxu, Qxu, Xu, Xu, Xu, Xu, Xu, Xu, Xu, Xu, Xu, Xu, Wog, Wog, Wog, Wog, Wog, Wog, Wog, Xu, Wog
Xu, Xu, Xu, Xu, Xu, Xu, Xu, Xu, Xu, Xu, Xu, Xu, Xu, Xu, Xu, Xu, Xu, Xu, Xu, Xu, Xu, Xu, Xu, Qxu, Qxu, Qxu, Qxu, Qxu, Rr, Rr, Qxu^Bcx\, Qxu, Qxu, Qxu, Qxu, Xu, Xu, Xu, Xu, Xu, Xu, Xu, Xu, Xu, Xu, Xu, Xu, Xu, Xu, Wog, Xu, Wog, Xu, Xu
Xu, Xu, Xu, Xu, Xu, Xu, Xu, Xu, Xu, Xu, Xu, Xu, Xu, Xu, Xu, Xu, Xu, Xu, Xu, Xu, Xu, Xu, Xu, Xu, Uu, Qxu, Qxu^Bcx/, Qxu^Bcx/, Qxu, Qxu, Qxu, Urb, Qxu, Qxu, Qxu, Xuc, Xu, Xu, Xu, Xu, Uh, Uh, Xu, Xu, Xu, Xu, Xu, Xu, Xu, Xu, Xu, Xu, Xu, Xu
Xu, Xu, Xu, Xu, Xu, Xu, Xu, Xu, Xu, Xu, Qxu, Xu, Qxu, Xu, Qxu, Xu, Xu, Xu, Xu, Xu, Xu, Xu, Xu, Xuc, Xuc, Urb, Ur, Qxu, Qxu, Qxu, Urb, Ur, Qxu^Bp\, Qxu, Xuc, Xuc, Xu, Xu, Uh, Xu, Ur, Uu^Vud, Xu, Xu, Xu, Xu, Xu, Xu, Xu, Xu, Xu, Xu, Xu, Xu
Xu, Xu, Xu, Xu, Xu, Xu, Xu, Xu, Xu, Qxu, Qxu, Qxu, Qxu, Qxu, Xu, Xu, Xuc, Xu, Xu, Xu, Xu, Xuc, Uu^Uf, Uh, Uu, Urb, Uu, Uu^Vud, Uu, Uu, Uu, Uu, Qxu, Uh, Uu, Xuc, Xu, Uh, Uu^Uf, Uu^Uf, Ur^Em, Uu^Uf, Xu, Xu, Xu, Xu, Xu, Xu, Xu, Xu, Xu, Xu, Xu, Xu
Xu, Xu, Xu, Xu, Xu, Xu, Xu, Xu, Qxu, Qxu, Qxu, Qxu, Qxu, Qxu, Xu, Xuc, Uh, Xu, Qxu, Xuc, Xu, Wwf, Uu^Uf, Uu^Uf, Uh, Cud, Ur, Uh, Uh, Urb, Cud, Uh, Qxu, Uu, Qxu, Qxu, Xu, Uu, Uu^Uf, Ur, Uh, Uu^Uf, Xu, Xu, Xu, Xu, Xu, Xu, Xu, Xu, Xu, Xu, Xu, Xu
Xu, Xu, Xu, Xu, Xu, Xu, Xu, Uu^Uf, Uu, Qxu, Qxu, Qxu, Uh, Qxu, Xu, Uh, Uh, Uh, Qxu, Xuc, Xu, Uu^Em, Cud, Uh, Uu, Uu, Urb, Urb, Uu, Uu, Urb, Uu, Uu^Vu, Qxu^Bp|, Qxu, Qxu, Qxu, Uu, Ur^Em, Ur, Uu, Xu, Xu, Xu, Xu, Xu, Xu, Xu, Xu, Xu, Xu, Xu, Xu, Xu
Xu, Xu, Xu, Xu, Xu, Xu, Xu, Xu, Xu, Qxu, Qxu, Uh, Uh, Qxu, Uh, Uu^Uf, Uu^Emf, Qxu, Uh, Uu, Uu^Vud, Uu, Urb, Urb, Uu, Urb, Uu, Urb, Ur, Urb, Uu, Ur, Urb, Uh, Qxu, Qxu, Xu, Ur, Xu, Uu^Em, Uh, Xu, Xu, Xu, Xu, Xu, Xu, Xu, Xu, Xu, Xu, Xu, Xu, Xu
Xu, Xu, Xu, Xu, Xu, Xu, Xu, Xu, Qxu, Qxu, Xu, Cud, Uu^Uf, Uu^Uf, Uu^Vud, Uh, Uu^Em, Uh, Uu, Uu, Uu, Ur, Urb, Urb, Ur, Urb, Uu, Ur, Urb, Uu, Uh, Ur, Qxu, Qxu^Bcx\, Qxu, Qxu, Qxu, Uu, Xu, Uh, Uh, Uu, Xu, Xu, Xu, Xu, Wog, Wog, Wog, Xu, Wog, Xu, Xu, Xu
Xu, Xu, Xu, Xu, Xu, Xu, Xu, Xu, Xu, Xu, Xu, Xu, Xuc, Uu^Uf, Uu^Em, Uu, 6 Cud, Uu^Uf, Uu, Rb, Uh, Uu, Uu, Uu, Cud, Uu, Urb, Ur, Urb, Cud, Uh, Uu, Qxu, Qxu, Qxu, Qxu, Uu, Qxu, Xu, Xu, Xu, Uu, Xu, Xu, Xu, Xu, Wog, Wog, Wog, Wog, Wog, Wog, Xu, Xu
Xu, Xu, Xu, Xu, Xu, Xu, Xu, Xu, Xu, Xu, Xu, Xu, Uu, Uu, Rb, Rb, Ur, Rb, Uu, Uu, Qxu, Uu, Uh, Uu, Uu, Urb, Uh, Uu^Vu, Uu, Uu, Uu, Qxu, Qxu, Qxu, Xu, Uh, Uh, Qxu, Qxu, Xu, Xu, Xu, Xu, Xu, Xu, Wog, Wog, Wog, Wog, Wog, Wog, Wog, Wog, Xu
Xu, Xu, Xu, Xu, Xu, Xu, Xu, Qxu, Qxu, Xu, Xuc, Xuc, Ur, Uu^Uf, Rb, Ur, Uu^Uf, Uu, Ur, Uu, Qxu, Qxu, Uh, Uh, Xu, Uu, Xuc, Uh, Uh, Uh, Qxu, Qxu, Qxu, Qxu, Xu, Xu, Qxu, Qxu, Xu, Uu, Xu, Xu, Xu, Xu, Wog, Wog, Wog, Xu, Xu, Xu, Xu, Wog, Wog, Wog
Xu, Xu, Xu, Xu, Xu, Xu, Xu, Xu, Qxu, Xu, Xu, Uu, Uu, Uu, Xu, Uu, Xu, Rb, Uh, Uu, Uu^Uf, Qxu, Xuc, Xu, Xu, Xuc, Xu, Xuc, Xu, Qxu, Xu, Qxu, Xu, Xu, Xu, Xu, Qxu, Qxu, Xu, Xu, Xu, Xu, Xu, Xu, Wog, Wog, Wog, Xu, Xu, Xu, Xu, Wog, Wog, Wog
Xu, Xu, Xu, Xu, Xu, Xu, Xu, Xu, Qxu, Qxu, Uu^Vu, Uu, Rb, Ur, Xu, Xu, Xu, Xu, Xu, Xu, Xu, Xuc, Xu, Xu, Xu, Xu, Xu, Xu, Xu, Xu, Xu, Xu, Xu, Xu, Xu, Xu, Xu, Xu, Xu, Xu, Xu, Xu, Xu, Xu, Wog, Wog, Wog, Xu, Xu, Xu, Xu, Xu, Xu, Wog
Xu, Xu, Xu, Xu, Xu, Xu, Xu, Xu, Qxu, Qxu, Uu, Ur, Uu, Xuc, Qxu, Xu, Xu, Xu, Xu, Xu, Xu, Xu, Xu, Xu, Xu, Xu, Xu, Xu, Xu, Xu, Xu, Xu, Xu, Xu, Xu, Xu, Xu, Xu, Xu, Xu, Xu, Xu, Xu, Xu, Wog, Wog, Wog, Wog, Xu, Xu, Xu, Xu, Xu, Xu
Xu, Xu, Xu, Xu, Xu, Xu, Qxu, Qxu, Qxu, Qxu, Ur, Uu, Qxu, Qxu, Qxu, Qxu, Xu, Xuc, Xuc, Xu, Cte, Cte, Cte, Xu, Uh, Uh, Uh, Uh, Xu, Xu, Xu, Xu, Xu, Xu, Xu, Xu, Xu, Xu, Xu, Xu, Xu, Xu, Xu, Xu, Xu, Wog, Wog, Wog, Xu, Xu, Xu, Xu, Xu, Xu
Xu, Xu, Xu, Xu, Xu, Xu, Qxu, Qxu, Uu^Uf, Uu^Uf, Ur, Uu^Vud, Qxu^Bp\, Qxu, Qxu, Qxu, Uh, Uh, Uh, Xu, Cte, 3 Kte, Cte, Uu, Uu, Uu^Vud, Uu^Uf, Uh, Uh, Xu, Xu, Xu, Xu, Xu, Xu, Xu, Xu, Xu, Xu, Xu, Xu, Xu, Xu, Xu, Xu, Xu, Wog, Wog, Wog, Xu, Xu, Xu, Xu, Xu
Xu, Xu, Xu, Xu, Xu, Xu, Xuc, Qxu, Uu, Uu^Uf, Ur, Uu, Qxu, Qxu, Cud, Uh, Uu^Vu, Uu^Uf, Rb^Uf, Rb^Uf, Uu, Cte, Uu, Ur, Rb^Edt, Rb^Uf, Uu^Uf, Uu^Uf, Uh, Xu, Xu, Xu, Xu, Xu, Xu, Xu, Xu, Xu, Xu, Xu, Xu, Xu, Xu, Xu, Xu, Xu, Xu, Wog, Wog, Xu, Xu, Xu, Xu, Xu
Xu, Xu, Xu, Xu, Xu, Xu, Xuc, Uh, Uu^Vu, Uu, Qxu, Qxu^Bcx\, Qxu^Bp\, Qxu, Qxu, Uu, Ur, Rb^Em, Rb^Edt, Ur, Rb^Edt, Rb^Uf, Re^Uf, Rb^Edt, Uu, Uh, Uu, Ur, Uh, Xu, Xu, Xu, Qxu, Xu, Xu, Xu, Uh, Xu, Uh, Xu, Xu, Xu, Xu, Xu, Xu, Xu, Xu, Wog, Wog, Wog, Xu, Xu, Xu, Xu
Xu, Xu, Xu, Xu, Xu, Xu, Xu, Xuc, Uh, Cud, Qxu, Qxu, Qxu, Qxu^Bcx\, Ur, Ur, Ur, Uh, Uu^Uf, Rb^Uf, Rb^Edt, Rb^Uf, Re^Uf, Ur^Edt, Ur^Edt, Ur, Uu, Re, Ur, Uu^Uf, Uu^Uf, Xu, Qxu, Xu, Xu, Uh, Uu^Vud, Uh, Uh, Uh, Uh, Uh, Uh, Xu, Xu, Xu, Xu, Wog, Wog, Wog, Xu, Xu, Xu, Xu
Xu, Xu, Xu, Xu, Xu, Xu, Xuc, Xuc, Qxu, Qxu, Qxu, Qxu, Qxu, Qxu, Ur^Uf, Cer, Cer, Uu^Uf, Uu^Uf, Uu, Uu, Uu^Uf, Uh, Re^Edt, Uu^Uf, Re^Uf, Uh, Re^Uf, Ur^Uf, Ur, Rb^Edt, Qxu, Uu^Vu, Qxu, Uu, Uu, Uu, Uu^Uf, Ur^Uf, Uu^Uf, Uu^Uf, Uu^Uf, Uh, Xu, Xu, Xu, Wog, Wog, Wog, Xu, Xu, Xu, Xu, Xu
Xu, Xu, Xu, Xu, Xu, Xuc, Qxu, Qxu, Qxu, Qxu, Xu, Qxu, Qxu, Uu, Cer, 2 Ke, Re, Uu, Uu, Ur, Ur, Re^Edt, Re^Uf, Re^Em, Uu^Uf, Uh, Uu, Ur^Uf, Xu, Ur^Em, Rb, Uu, Uu, Qxu, Uu, Uh, Uh, Ur, Rb^Uf, Rb^Em, Rb^Uf, Rb^Uf, Uh, Xu, Xu, Xu, Wog, Wog, Wog, Xu, Xu, Xu, Xu, Xu
Xu, Xu, Xu, Xu, Xu, Xuc, Xuc, Xuc, Xu, Xu, Xu, Qxu, Qxu, Uu, Uu^Uf, Cer, Uu, Uu, Uu^Uf, Uu^Uf, Uh, Ur, Uh, Uu^Uf, Uh, Uh, Uh, Xu, Xu, Uu, Rb^Uf, Re^Edt, Re^Edt, Uu, Ur, Uu, Ur, Uu^Uf, Uu^Uf, Rb^Uf, Uu^Uf, Uu^Vu, Xu, Xu, Xu, Wog, Wog, Wog, Xu, Xu, Xu, Xu, Xu, Xu
Xu, Xu, Xu, Xu, Xu, Xu, Xu, Xu, Xu, Xu, Xu, Xu, Qxu, Qxu, Uh, Uh, Uu, Uu^Vud, Uh, Uh, Uh, Uu^Uf, Xu, Uh, Uh, Uh, Qxu, Qxu, Qxu, Uu^Uf, Uu^Uf, Rb, Uu, Rb, Uu, Ur, Uu, Uh, Uh, Xu, Xu, Xu, Xu, Xu, Xu, Xu, Wog^Xo, Wog, Xu, Xu, Xu, Xu, Xu, Xu
Xu, Xu, Xu, Xu, Xu, Xu, Xu, Xu, Xu, Xu, Xu, Qxu, Qxu, Qxu, Qxu, Uu, Ur, Uu, Xu, Qxu, Qxu, Xu, Xu, Xu, Xu, Xu, Qxu, Qxu, Xu, Qxu, Xu, Uu, Xu, Uu, Ur, Uu^Uf, Rb^Em, Uu^Uf, Uu, Uu, Xu, Xu, Wog, Wog, Wog, Wog, Wog^Es, Xu, Xu, Xu, Xu, Xu, Xu, Xu
Xu, Xu, Xu, Xu, Xu, Xu, Xu, Xu, Xu, Xu, Xu, Xu, Qxu, Qxu, Qxu, Qxu, Ur, Xu, Xu, Qxu, Qxu, Xu, Xu, Xu, Xu, Xu, Qxu, Xu, Xu, Xu, Xu, Xu, Xu, Xu, Uu, Uu, Rb, Uu, Uu, Xu, Wwg^Es, Wog, Wog^Es, Wog^Es, Wog, Wog, Xu, Xu, Xu, Xu, Xu, Xu, Xu, Xu
Xu, Xu, Xu, Xu, Xu, Xu, Xu, Xu, Xu, Xu, Xu, Xu, Xu, Xu, Xu, Qxu, Uu, Uu, Ur, Qxu, Xu, Xu, Xu, Xu, Xu, Qxu, Xu, Xu, Xu, Xu, Xu, Xu, Xu, Xu, Wwg, Rb, Wwg, Wwf, Wwf, Wwg, Xuc, Wog, Wog, Xu, Xu, Xu, Xu, Xu, Xu, Xu, Xu, Xu, Xu, Xu
Xu, Xu, Xu, Xu, Xu, Xu, Xu, Xu, Xu, Xu, Xu, Xu, Xu, Xu, Xu, Xu, Xu, Uu, Uu, Ur, Uu^Vu, Xu, Uh, Xu, Xu, Xu, Xu, Xu, Xu, Xu, Xu, Xu, Wwg, Wwg, Wwg, Wwg, Wwg, Wwf, Wwg, Wwf, Wwg, Wog, Xu, Xu, Xuc, Xu, Xu, Xu, Xu, Xu, Xu, Xu, Xu, Xu
Xu, Xu, Xu, Xu, Xu, Xu, Xu, Xu, Xu, Xu, Xu, Xu, Xu, Xu, Xu, Xu, Uh, Uh, Ur, Uu, Uu, Uu, Uh, Uh, Wwf, Xu, Xu, Xu, Xu, Xu, Xu, Wwg^Es, Wwg, Wwf^Es, Uu, Uu, Xuc, Wwf, Wwg^Es, Wwf, Wwg, Xu, Uu^Uf, Xuc, Uh, Xuc, Uh, Xu, Xu, Xu, Xu, Xu, Xu, Xu
Xu, Xu, Xu, Xu, Xu, Xu, Xu, Xu, Xu, Xu, Xu, Xu, Xu, Xu, Xu, Wwf, Uu, Uu^Uf, Uu, Uu^Uf, Uu, Uh, Wwf, Uu, Xu, Xu, Xu, Xu, Xu, Xu, Wwg, Wwg, Wwg, Uh, Uu^Uf, Uu^Uf, Wwf, Wwg^Es, Wwg, Wwg, Wog, Wwf, Wwg, Wwg, Uu^Vud, Uh, Uh, Xu, Xu, Xu, Xu, Xu, Xu, Xu
Xu, Xu, Xu, Xu, Xu, Xu, Xu, Xu, Xu, Xu, Xu, Xu, Xu, Xu, Uh, Uh, Wwf, Wwf, Wwf, Uu, Uh, Wwf, Xu, Xu, Xu, Xu, Xu, Xu, Xu, Xu, Wog, Wwg^Es, Wog^Es, Xu, Xu, Wwg, Wwf, Uu^Vu, Uu^Uf, Wwg, Wwg, Rb^Uf, Re^Uf, Uu^Uf, Re^Em, Uu^Uf, Uu^Uf, Xu, Xu, Xu, Xu, Xu, Xu, Xu
Xu, Xu, Xu, Xu, Xu, Xu, Xu, Xu, Xu, Xu, Xu, Xu, Xu, Xu, Uh, Uu, Wwf, Wwf, Xu, Xu, Xu, Xu, Xu, Xu, Xu, Xu, Xu, Xu, Xu, Wog, Wog^Es, Wog, Wog, Xu, Xu, Xu, Uh, Uh, Uh, Wwf, Rb, Re^Em, Rr, Uu, Re, Uu, Uu^Vud, Xuc, Xu, Xu, Xu, Xu, Xu, Xu
Xu, Xu, Xu, Xu, Xu, Xu, Xu, Xu, Xu, Xu, Xu, Xu, Xu, Xu, Xu, Xu, Xu, Xu, Xu, Xu, Xu, Xu, Xu, Xu, Xu, Xu, Xu, Xu, Wog, Wog, Wog, Wog, Xu, Xu, Xu, Xu, Xu, Uh, Xu, Uh, Uu^Uf, Re, Re, Rr, Re, Re^Uf, Uu^Uf, Xu, Xu, Xu, Xu, Xu, Xu, Xu
Xu, Xu, Xu, Xu, Xu, Xu, Xu, Xu, Xu, Xu, Xu, Xu, Xu, Xu, Xu, Xu, Xu, Xu, Xu, Xu, Xu, Xu, Xu, Xu, Xu, Xu, Wog, Wog^Xo, Xu, Wog, Xu, Xu, Xu, Xu, Xu, Xu, Xu, Xu, Xuc, Uh, Uh, Uu^Vud, Xuc, Rr, Rr, Re^Uf, Uu^Uf, Uu^Uf, Xu, Xu, Xu, Xu, Xu, Xu
Xu, Xu, Xu, Xu, Xu, Xu, Xu, Xu, Xu, Xu, Xu, Xu, Xu, Xu, Xu, Xu, Xu, Xu, Xu, Xu, Xu, Xu, Xu, Xu, Wog, Wog, Wog, Wog, Wog, Wog^Xo, Xu, Xu, Xu, Xu, Xu, Xu, Xu, Xuc, Xuc, Xuc, Xuc, Xuc, Xuc, Cud, Rr, Re^Em, Re, Uu^Uf, Xu, Xu, Xu, Xu, Xu, Xu
Xu, Xu, Xu, Xu, Xu, Xu, Xu, Xu, Xu, Xu, Xu, Xu, Xu, Xu, Xu, Xu, Xu, Xu, Xu, Xu, Xu, Xu, Xu, Wog, Xu, Xu, Wog, Wog, Wog, Xu, Xu, Xu, Xu, Xu, Xu, Xu, Xuc, Xuc, Cud, Cud, Uu, Xuc, Uu, Uu, Rr, Cud, Xuc, Xuc, Xu, Xu, Xu, Xu, Xu, Xu
Xu, Xu, Xu, Xu, Xu, Xu, Xu, Xu, Xu, Xu, Xu, Xu, Xu, Xu, Xu, Xu, Xu, Xu, Xu, Xu, Xu, Xu, Wog, Wog, Xu, Xu, Wog, Wog, Wog, Xu, Xu, Xu, Xu, Xu, Xu, Xu, Xuc, Cud, Uu, Uu, Uu, Uu, Rr, Rr, Uu, Cud, Xuc, Xuc, Xu, Xu, Xu, Xu, Xu, Xu
Xu, Xu, Xu, Xu, Xu, Xu, Xu, Xu, Xu, Xu, Xu, Xu, Xu, Xu, Wog, Xu, Wog, Xu, Xu, Xu, Xu, Xu, Wog, Wog, Wog, Wog, Wog, Wog, Xu, Xu, Xu, Xu, Xu, Xu, Xu, Xuc, Uu^Uf, Uu^Emf, Uu^Uf, Uu, Cud, Cud, Cud, Uu, Uu^Vud, Cud, Xuc, Xu, Xu, Xu, Xu, Xu, Xu, Xu
Xu, Xu, Xu, Xu, Xu, Xu, Xu, Xu, Xu, Xu, Xu, Xu, Wog, Wog, Wog, Wog, Wog, Wog, Wog, Xu, Xu, Wog, Wog, Wog, Wog, Wog, Xu, Xu, Xu, Xu, Xu, Xu, Xu, Xu, Xu, Xuc, Uu^Uf, Uu^Uf, Re^Em, Uu, Cud, 1 Kud, Cud, Uu, Xuc, Xuc, Xu, Xu, Xu, Xu, Xu, Xu, Xu, Xu
Xu, Xu, Xu, Xu, Xu, Xu, Xu, Xu, Xu, Xu, Xu, Xu, Wog, Wog, Xu, Wog, Wog, Wog, Wog, Wog, Wog, Wog, Xu, Xu, Xu, Xu, Xu, Xu, Xu, Xu, Xu, Xu, Xu, Xu, Xu, Xu, Uu, Uu^Uf, Uu^Vud, Uu, Rr, Cud, Uu, Uu, Xuc, Xu, Xu, Xu, Xu, Xu, Xu, Xu, Xu, Xu
Xu, Xu, Xu, Xu, Xu, Xu, Xu, Xu, Xu, Xu, Xu, Wog, Wog, Wog, Wog, Xu, Xu, Wog, Xu, Wog, Xu, Wog, Xu, Xu, Xu, Xu, Xu, Xu, Xu, Xu, Xu, Xu, Xu, Xu, Xu, Xuc, Xuc, Xuc, Uu^Uf, Uu^Em, Rr, Rr, Uu, Xuc, Xuc, Xu, Xu, Xu, Xu, Xu, Xu, Xu, Xu, Xu
Xu, Xu, Xu, Xu, Xu, Xu, Xu, Xu, Xu, Xu, Xu, Wog, Wog, Wog, Wog, Xu, Xu, Xu, Xu, Xu, Xu, Xu, Xu, Xu, Xu, Xu, Xu, Xu, Xu, Xu, Xu, Xu, Xu, Xu, Xu, Xu, Xu, Xuc, Uu, Uu^Uf, Rr, Uu^Vud, Re^Em, Uu, Xuc, Xuc, Xu, Xu, Xu, Xu, Xu, Xu, Xu, Xu
Xu, Xu, Xu, Xu, Xu, Xu, Xu, Xu, Xu, Xu, Xu, Xu, Xu, Wog, Wog, Wog, Wog, Xu, Xu, Xu, Xu, Xu, Xu, Xu, Xu, Xu, Xu, Xu, Xu, Xu, Xu, Xu, Xu, Xu, Xu, Xu, Xu, Xuc, Uh, Uu, Uu, Rr, Re, Uu, Xu, Xuc, Xu, Xu, Xu, Xu, Xu, Xu, Xu, Xu
Xu, Xu, Xu, Xu, Xu, Xu, Xu, Xu, Xu, Xu, Xu, Xu, Xu, Wog, Wog, Wog, Wog, Xu, Xu, Xu, Xu, Xu, Xu, Xu, Xu, Xu, Xu, Xu, Xu, Xu, Xu, Xu, Xu, Xu, Xu, Xu, Xu, Xu, Xu, Uh, Uu, Ur, Rr, Uu, Uu, Uh, Uu, Xu, Xu, Xu, Xu, Xu, Xu, Xu
Xu, Xu, Xu, Xu, Xu, Xu, Xu, Xu, Xu, Xu, Xu, Xu, Xu, Wog, Wog, Wog, Wog, Xu, Xu, Xu, Xu, Xu, Xu, Xu, Xu, Xu, Xu, Xu, Xu, Xu, Xu, Xu, Xu, Xu, Xu, Xu, Xu, Xu, Xu, Xu, Uu, Uu, Rr, Rr, Rr, Uu, Uh, Xu, Xu, Xu, Xu, Xu, Xu, Xu
