Xu, Xu, Xu, Xu, Xu, Xu, Xu, Xu, Xu, Xu, Xu, Xue, Xue, Xue, Ms^Xm, Ms^Xm, Ms^Xm, Ms^Xm, Mm^Xm, Ha, Ms, Ha, Ha^Fpa, Aa, Gd, Gd, Aa, Aa, Gll^Fp, Gll, Gll, Aa^Fpa, Ha, Ms, Ms, Ms, Ms^Xm, Ms^Xm, Ms^Xm, Ms^Xm, Ms^Xm, Xue, Xue, Xu, Xu, Wwg, Wwg, Wwg, Xu, Xu, Xu, Xu, Xu, Xu
Xu, Xu, Xu, Xu, Xu, Xu, Xu, Xu, Xu, Xu, Xu, Xue, Xue, Xue, Xue, Ms^Xm, Ms^Xm, Ms^Xm, Ms^Xm, Ms^Xm, Ha^Fma, Ha, Ha^Fpa, Gll^Fp, Gll, Aa^Fma, Gd, Aa, Gll^Fmw, Aa^Fma, Aa^Fma, Aa^Fpa, Ms, Ms, Ha, Ms^Xm, Ms^Xm, Ha, Ms^Xm, Ms^Xm, Xue, Xue, Xu, Xu, Wwg, Wwg, Wwg, Wwg, Xu, Xu, Xu, Xu, Xu, Xu
Xu, Xu, Xu, Xu, Xu, Xu, Xu, Xu, Xu, Xu, Xu, Xue, Xue, Xue, Xue, Ms^Xm, Ms^Xm, Ms^Xm, Ms, Ha, Ms, Ms, Ha, Gll^Fmw, Gll^Fp, Gd, Gd, Gll, Gll^Fp, Gll^Fmw, Ha, Hhd, Hhd, Ha, Ms, Ms^Xm, Ms^Xm, Ms^Xm, Ms^Xm, Ms^Xm, Xue, Xue, Xu, Xu, Wog, Wog, Wog, Wwg, Xu, Xu, Xu, Xu, Xu, Xu
Xu, Xu, Xu, Xu, Xu, Xu, Xu, Xu, Xu, Xu, Xu, Xu, Xue, Xue, Xue, Xue, Xue, Ms^Xm, Ms^Xm, Ms, Ms, Ms, Ha, Ha, Ms, Gs, Gs, Gd, Aa^Fpa, Ha, Ms, Hhd, Ms^Xm, Ms, Ms, Ms, Ms^Xm, Ms^Xm, Ms^Xm, Xue, Xue, Xue, Xu, Wog, Wog, Wog, Wog, Xu, Xu, Xu, Xu, Xu, Xu, Xu
Xu, Xu, Xu, Xu, Xu, Xu, Xu, Xu, Xu, Xu, Xu, Xu, Xu, Xue, Xue, Xue, Xue, Ms^Xm, Ms^Xm, Ms, Ms, Ms, Ms, Ms, Ms, Ms, Gs, Aa, Ms, Ms^Xm, Ms^Xm, Ms^Xm, Ms^Xm, Ms^Xm, Ms^Xm, Ms, Xue, Xue, Xue, Xue, Xu, Xu, Wog, Wog, Wog, Wog, Xu, Xu, Xu, Xu, Xu, Xu, Xu, Xu
Xu, Xu, Xu, Xu, Xu, Xu, Xu, Xu, Xu, Xu, Xu, Xu, Xu, Xue, Xue, Xue, Xue, Xue, Ms^Xm, Ms^Xm, Ms^Xm, Ms^Xm, Xue, Ms^Xm, Xue, Ms, Gs, Gd, Xue, Ms^Xm, Xue, Xue, Xue, Xue, Xue, Xue, Xue, Xue, Xu, Xu, Xu, Xu, Wog, Wog, Wog, Xu, Xu, Xu, Xu, Xu, Xu, Xu, Xu, Xu
Xu, Xu, Xu, Xu, Xu, Xu, Xu, Xu, Xu, Xu, Xu, Xu, Xu, Xu, Xue, Xue, Xue, Xue, Xue, Xue, Xue, Xue, Xue, Xue, Xue, Uue, Uue, Uue, Xue, Xue, Xue, Xue, Xue, Xue, Xue, Xue, Xu, Xu, Xu, Xu, Xu, Wog, Wog, Wog, Xu, Xu, Xu, Xu, Xu, Xu, Xu, Xu, Xu, Xu
Xu, Xu, Xu, Xu, Xu, Xu, Xu, Xu, Xu, Xu, Xu, Xu, Xu, Xu, Xu, Xue, Xue, Xue, Xue, Xue, Xue, Xue, Xue, Xue, Xue, Uue, Re, Uue, Uhe, Xue, Xue, Xue, Xue, Xue, Xu, Xu, Xu, Xu, Xu, Xu, Wog, Wog, Wog, Wog, Xu, Xu, Xu, Xu, Xu, Xu, Xu, Xu, Xu, Xu
Xu, Xu, Xu, Xu, Xu, Xu, Xu, Xu, Xu, Xu, Xu, Xu, Xu, Xu, Xu, Xu, Xu, Xue, Xu, Xue, Xue, Xue, Xue, Xue, Xue, Uhe, Uue, Re^Ii, Re, Uue, Uue, Xue, Xue, Xu, Xuc, Xu, Xu, Xu, Xu, Xu, Xu, Wog, Wog, Wog, Xu, Xu, Xu, Xu, Xu, Xu, Xu, Xu, Xu, Xu
Xu, Xu, Xu, Xu, Xu, Xu, Xu, Xu, Xu, Xu, Xu, Xu, Xu, Xu, Xu, Xu, Xu, Xu, Xu, Xu, Xu, Xu, Xu, Xu, Xuc, Xuc, Cud, Uue, Rr, Re, Uue, Uue^Tf, Uhe, Uh, Uh, Xuc, Xuc, Xu, Xu, Xu, Xu, Wog, Wog, Wog, Wog, Xu, Xu, Xu, Xu, Xu, Xu, Xu, Xu, Xu
Xu, Xu, Xu, Xu, Xu, Xu, Xu, Xu, Xu, Xu, Xu, Xu, Xu, Xu, Xu, Xu, Xu, Xu, Xu, Xu, Xu, Xu, Xu, Xuc, Uh, Cud, 5 Kud, Cud, Rr, Uue, Uue, Rr^Em, Uue, Uu^Vu, Uh, Xu, Wwf, Xuc, Wwrg, Xu, Wog, Wog^Xo, Wog^Xo, Wog, Wog, Xu, Xu, Xu, Xu, Xu, Xu, Xu, Xu, Xu
Xu, Xu, Xu, Xu, Xu, Xu, Xu, Xu, Xu, Xu, Xu, Xu, Xu, Xu, Xu, Xu, Xu, Xu, Xu, Xu, Xu, Xuc, Uh, Uh, Uu, Cud, Cud, Cud, Rr, Uu^Vud, Ur, Rr, Uue, Uue, Uu, Uh, Wwf, Wwg, Wog, Wog, Wog, Wog, Xu, Wog, Wog, Xu, Xu, Xu, Xu, Xu, Xu, Xu, Xu, Xu
Xu, Xu, Xu, Xu, Xu, Xu, Xu, Xu, Xu, Xu, Xu, Xu, Xu, Xu, Xu, Xu, Xu, Xu, Xu, Xu, Xuc, Xuc, Uu, Uu^Tf, Uu^Vu, Rr, Rr^Edb, Uu^Edb, Re^Edb, Rr, Re, Re, Uu^Tfi, Uue^Tf, Uh, Uh, Wwf, Wwg, Wwrg, Wog, Wog, Wog, Xu, Wog, Wog, Wog, Wog, Xu, Xu, Xu, Xu, Xu, Xu, Xu
Xu, Xu, Xu, Xu, Xu, Xu, Xu, Xu, Xu, Xu, Xu, Xu, Xu, Xu, Xu, Xu, Xu, Xu, Xu, Xu, Xu, Uh, Uu^Emf, Uu^Emf, Ur, Ur, Ur, Rr^Edb, Rr, Re^Ii, Ur, Rr^Tf, Uu^Tf, Uh^Ii, Uh, Uu^Vud, Xu, Wwf, Wwf, Wwrg, Wog, Xu, Xu, Wog, Wog, Wog, Wog, Xu, Xu, Xu, Xu, Xu, Xu, Xu
Xu, Xu, Xu, Xu, Xu, Xu, Xu, Xu, Xu, Xu, Xu, Xu, Xu, Xu, Xu, Xu, Xu, Xu, Xu, Xu, Uh, Uh^Ii, Uh, Uu^Tf, Uu^Tf, Uu^Ii, Uu, Uu, Re^Tf, Ur, Rr, Rr^Em, Qxu, Uh, Xuc, Xu, Xu, Xu, Xu, Xu, Xu, Xu, Xu, Xu, Wog, Wog, Wog, Wog, Xu, Xu, Xu, Xu, Xu, Xu
Xu, Xu, Xu, Xu, Xu, Xu, Xu, Xu, Xu, Xu, Xu, Xu, Xu, Xu, Xu, Xu, Xu, Xu, Xu, Xu, Xu, Uh, Xu, Uh^Emf, Uh, Uu^Vud, Qxu^Bp\, Uh, Rr^Em, Rr, Rr^Edb, Uh, Qxu, Xuc, Xuc, Xu, Xu, Xu, Xu, Xu, Xu, Xu, Xu, Xu, Wog, Wog, Wog, Wog, Wog, Xu, Xu, Xu, Wog, Wog
Xu, Xu, Xu, Xu, Xu, Xu, Xu, Xu, Xu, Xu, Xu, Xu, Xu, Xu, Xu, Xu, Xu, Xu, Xu, Xu, Xu, Xu, Xu, Xu, Xu, Qxu, Qxu, Cud, Uu, Ur^Edb, Rr^Edb, Uu, Qxu, Qxu, Xuc, Xu, Xu, Xu, Xu, Xu, Xu, Xu, Xu, Xu, Xu, Wog, Wog, Wog, Wog, Wog, Wog, Wog, Wog, Wog
Xu, Xu, Xu, Xu, Xu, Xu, Xu, Xu, Xu, Xu, Xu, Xu, Xu, Xu, Xu, Xu, Xu, Xu, Xu, Xu, Xu, Xu, Xu, Xu, Qxu, Qxu, Qxu, Qxu, Rr, Rr, Ur, Uu, Cud, Qxu, Qxu, Xu, Xu, Xu, Xu, Xu, Xu, Xu, Xu, Xu, Xu, Wog, Wog, Wog, Wog, Wog, Wog, Wog, Xu, Wog
Xu, Xu, Xu, Xu, Xu, Xu, Xu, Xu, Xu, Xu, Xu, Xu, Xu, Xu, Xu, Xu, Xu, Xu, Xu, Xu, Xu, Xu, Xu, Qxu, Qxu, Qxu, Qxu, Qxu, Rr, Rr, Qxu^Bcx\, Qxu, Qxu, Qxu, Qxu, Xu, Xu, Xu, Xu, Xu, Xu, Xu, Xu, Xu, Xu, Xu, Xu, Xu, Xu, Wog, Xu, Wog, Xu, Xu
Xu, Xu, Xu, Xu, Xu, Xu, Xu, Xu, Xu, Xu, Xu, Xu, Xu, Xu, Xu, Xu, Xu, Xu, Xu, Xu, Xu, Xu, Xu, Xu, Uu, Qxu, Qxu^Bcx/, Qxu^Bcx/, Qxu, Qxu, Qxu, Urb, Qxu, Qxu, Qxu, Xuc, Xu, Xu, Xu, Xu, Uh, Uh, Xu, Xu, Xu, Xu, Xu, Xu, Xu, Xu, Xu, Xu, Xu, Xu
Xu, Xu, Xu, Xu, Xu, Xu, Xu, Xu, Xu, Xu, Qxu, Xu, Qxu, Xu, Qxu, Xu, Xu, Xu, Xu, Xu, Xu, Xu, Xu, Xuc, Xuc, Urb, Ur, Qxu, Qxu, Qxu, Urb, Ur, Qxu^Bp\, Qxu, Xuc, Xuc, Xu, Xu, Uh, Xu, Ur, Uu^Vud, Xu, Xu, Xu, Xu, Xu, Xu, Xu, Xu, Xu, Xu, Xu, Xu
Xu, Xu, Xu, Xu, Xu, Xu, Xu, Xu, Xu, Qxu, Qxu, Qxu, Qxu, Qxu, Xu, Xu, Xuc, Xu, Xu, Xu, Xu, Xuc, Uu^Tf, Uh, Uu, Urb, Uu, Uu^Vud, Uu, Uu^Edb, Uu^Edb, Uu, Qxu, Uh, Uu, Xuc, Xu, Uh, Uu^Tf, Uu^Tf, Ur^Em, Uu^Tf, Xu, Xu, Xu, Xu, Xu, Xu, Xu, Xu, Xu, Xu, Xu, Xu
Xu, Xu, Xu, Xu, Xu, Xu, Xu, Xu, Qxu, Qxu, Qxu, Qxu, Qxu, Qxu, Xu, Xuc, Uh, Xu, Qxu, Xuc, Xu, Wwf, Uu^Tf, Uu^Tf, Uh, Cud, Ur, Uh, Uh, Urb^Edb, Cud, Uh, Qxu, Uu, Qxu, Qxu, Xu, Uu, Uu^Tf, Ur, Uh, Uu^Tf, Xu, Xu, Xu, Xu, Xu, Xu, Xu, Xu, Xu, Xu, Xu, Xu
Xu, Xu, Xu, Xu, Xu, Xu, Xu, Uu^Tf, Uu, Qxu, Qxu, Qxu, Uh, Qxu, Xu, Uh, Uh, Uh, Qxu, Xuc, Xu, Uu^Em, Cud, Uh, Uu, Uu, Urb, Urb, Uu, Uu, Urb, Uu, Uu^Vu, Qxu^Bp|, Qxu, Qxu, Qxu, Uu, Ur^Em, Ur, Uu, Xu, Xu, Xu, Xu, Xu, Xu, Xu, Xu, Xu, Xu, Xu, Xu, Xu
Xu, Xu, Xu, Xu, Xu, Xu, Xu, Xu, Xu, Qxu, Qxu, Uh, Uh, Qxu, Uh, Uu^Tf, Uu^Emf, Qxu, Uh, Uu, Uu^Vud, Uu, Urb^Edb, Urb, Uu, Urb, Uu, Urb, Ur^Edb, Urb, Uu, Ur, Urb, Uh, Qxu, Qxu, Xu, Ur, Xu, Uu^Em, Uh, Xu, Xu, Xu, Xu, Xu, Xu, Xu, Xu, Xu, Xu, Xu, Xu, Xu
Xu, Xu, Xu, Xu, Xu, Xu, Xu, Xu, Qxu, Qxu, Xu, Cud, Uu^Tf, Uu^Tf, Uu^Vud, Uh, Uu^Em, Uh, Uu, Uu, Uu, Ur, Urb^Edb, Urb^Edb, Ur, Urb, Uu, Ur^Edb, Urb^Edb, Uu, Uh, Ur, Qxu, Qxu^Bcx\, Qxu, Qxu, Qxu, Uu, Xu, Uh, Uh, Uu, Xu, Xu, Xu, Xu, Wog, Wog, Wog, Xu, Wog, Xu, Xu, Xu
Xu, Xu, Xu, Xu, Xu, Xu, Xu, Xu, Xu, Xu, Xu, Xu, Xuc, Uu^Tf, Uu^Em, Uu, 6 Cud, Uu^Tf, Uu, Rb, Uh, Uu, Uu, Uu, Cud, Uu, Urb, Ur^Edb, Urb, Cud, Uh, Uu, Qxu, Qxu, Qxu, Qxu, Uu, Qxu, Xu, Xu, Xu, Uu, Xu, Xu, Xu, Xu, Wog, Wog, Wog, Wog, Wog, Wog, Xu, Xu
Xu, Xu, Xu, Xu, Xu, Xu, Xu, Xu, Xu, Xu, Xu, Xu, Uu, Uu, Rb^Edb, Rb, Ur, Rb, Uu, Uu, Qxu, Uu, Uh, Uu, Uu, Urb, Uh, Uu^Vu, Uu, Uu, Uu, Qxu, Qxu, Qxu, Xu, Uh, Uh, Qxu, Qxu, Xu, Xu, Xu, Xu, Xu, Xu, Wog, Wog, Wog, Wog, Wog, Wog, Wog, Wog, Xu
Xu, Xu, Xu, Xu, Xu, Xu, Xu, Qxu, Qxu, Xu, Xuc, Xuc, Ur, Uu^Tf, Rb^Edb, Ur^Edb, Uu^Tf, Uu, Ur, Uu, Qxu, Qxu, Uh, Uh, Xu, Uu, Xuc, Uh, Uh, Uh, Qxu, Qxu, Qxu, Qxu, Xu, Xu, Qxu, Qxu, Xu, Uu, Xu, Xu, Xu, Xu, Wog, Wog, Wog, Xu, Xu, Xu, Xu, Wog, Wog, Wog
Xu, Xu, Xu, Xu, Xu, Xu, Xu, Xu, Qxu, Xu, Xu, Uu, Uu, Uu, Xu, Uu, Xu, Rb, Uh, Uu, Uu^Tf, Qxu, Xuc, Xu, Xu, Xuc, Xu, Xuc, Xu, Qxu, Xu, Qxu, Xu, Xu, Xu, Xu, Qxu, Qxu, Xu, Xu, Xu, Xu, Xu, Xu, Wog, Wog, Wog, Xu, Xu, Xu, Xu, Wog, Wog, Wog
Xu, Xu, Xu, Xu, Xu, Xu, Xu, Xu, Qxu, Qxu, Uu^Vu, Uu, Rb, Ur, Xu, Xu, Xu, Xu, Xu, Xu, Xu, Xuc, Xu, Xu, Xu, Xu, Xu, Xu, Xu, Xu, Xu, Xu, Xu, Xu, Xu, Xu, Xu, Xu, Xu, Xu, Xu, Xu, Xu, Xu, Wog, Wog, Wog, Xu, Xu, Xu, Xu, Xu, Xu, Wog
Xu, Xu, Xu, Xu, Xu, Xu, Xu, Xu, Qxu, Qxu, Uu, Ur, Uu, Xuc, Qxu, Xu, Xu, Xu, Xu, Xu, Xu, Xu, Xu, Xu, Xu, Xu, Xu, Xu, Xu, Xu, Xu, Xu, Xu, Xu, Xu, Xu, Xu, Xu, Xu, Xu, Xu, Xu, Xu, Xu, Wog, Wog, Wog, Wog, Xu, Xu, Xu, Xu, Xu, Xu
Xu, Xu, Xu, Xu, Xu, Xu, Qxu, Qxu, Qxu, Qxu, Ur, Uu, Qxu, Qxu, Qxu, Qxu, Xu, Xuc, Xuc, Xu, Cte, Cte, Cte, Xu, Uh, Uh, Uh, Uh, Xu, Xu, Xu, Xu, Xu, Xu, Xu, Xu, Xu, Xu, Xu, Xu, Xu, Xu, Xu, Xu, Xu, Wog, Wog, Wog, Xu, Xu, Xu, Xu, Xu, Xu
Xu, Xu, Xu, Xu, Xu, Xu, Qxu, Qxu, Uu^Tf, Uu^Tf, Ur, Uu^Vud, Qxu^Bp\, Qxu, Qxu, Qxu, Uh, Uh, Uh, Xu, Cte^Edb, 3 Kte^Edb, Cte^Edb, Uu, Uu, Uu^Vud, Uu^Tf, Uh, Uh, Xu, Xu, Xu, Xu, Xu, Xu, Xu, Xu, Xu, Xu, Xu, Xu, Xu, Xu, Xu, Xu, Xu, Wog, Wog, Wog, Xu, Xu, Xu, Xu, Xu
Xu, Xu, Xu, Xu, Xu, Xu, Xuc, Qxu, Uu, Uu^Tf, Ur, Uu, Qxu, Qxu, Cud, Uh, Uu^Vu, Uu^Tf, Rb^Tf, Rb^Tf, Uu, Cte^Edb, Uu, Ur, Rb^Edt, Rb^Tf, Uu^Tf, Uu^Tf, Uh, Xu, Xu, Xu, Xu, Xu, Xu, Xu, Xu, Xu, Xu, Xu, Xu, Xu, Xu, Xu, Xu, Xu, Xu, Wog, Wog, Xu, Xu, Xu, Xu, Xu
Xu, Xu, Xu, Xu, Xu, Xu, Xuc, Uh, Uu^Vu, Uu, Qxu, Qxu^Bcx\, Qxu^Bp\, Qxu, Qxu, Uu, Ur, Rb^Em, Rb^Edt, Ur, Rb^Edt, Rb^Tf, Re^Tf, Rb^Edt, Uu, Uh, Uu, Ur, Uh, Xu, Xu, Xu, Qxu, Xu, Xu, Xu, Uh, Xu, Uh, Xu, Xu, Xu, Xu, Xu, Xu, Xu, Xu, Wog, Wog, Wog, Xu, Xu, Xu, Xu
Xu, Xu, Xu, Xu, Xu, Xu, Xu, Xuc, Uh, Cud, Qxu, Qxu, Qxu, Qxu^Bcx\, Ur, Ur, Ur, Uh, Uu^Tf, Rb^Tf, Rb^Edt, Rb^Tf, Re^Tf, Ur^Edt, Ur^Edt, Ur, Uu, Re, Ur, Uu^Tf, Uu^Tf, Xu, Qxu, Xu, Xu, Uh, Uu^Vud, Uh, Uh, Uh, Uh, Uh, Uh, Xu, Xu, Xu, Xu, Wog, Wog, Wog, Xu, Xu, Xu, Xu
Xu, Xu, Xu, Xu, Xu, Xu, Xuc, Xuc, Qxu, Qxu, Qxu, Qxu, Qxu, Qxu, Ur^Tf, Cer, Cer, Uu^Tf, Uu^Tf, Uu, Uu, Uu^Tf, Uh, Re^Edt, Uu^Tf, Re^Tf, Uh, Re^Tf, Ur^Tf, Ur, Rb^Edt, Qxu, Uu^Vu, Qxu, Uu, Uu, Uu, Uu^Tf, Ur^Tf, Uu^Tf, Uu^Tf, Uu^Tf, Uh, Xu, Xu, Xu, Wog, Wog, Wog, Xu, Xu, Xu, Xu, Xu
Xu, Xu, Xu, Xu, Xu, Xuc, Qxu, Qxu, Qxu, Qxu, Xu, Qxu, Qxu, Uu, Cer, 2 Ke, Re, Uu, Uu, Ur, Ur, Re^Edt, Re^Tf, Re^Em, Uu^Tf, Uh, Uu, Ur^Tf, Xu, Ur^Em, Rb, Uu, Uu, Qxu, Uu, Uh, Uh, Ur, Rb^Tf, Rb^Em, Rb^Tf, Rb^Tf, Uh, Xu, Xu, Xu, Wog, Wog, Wog, Xu, Xu, Xu, Xu, Xu
Xu, Xu, Xu, Xu, Xu, Xuc, Xuc, Xuc, Xu, Xu, Xu, Qxu, Qxu, Uu, Uu^Tf, Cer, Uu, Uu, Uu^Tf, Uu^Tf, Uh, Ur, Uh, Uu^Tf, Uh, Uh, Uh, Xu, Xu, Uu, Rb^Tf, Re^Edt, Re^Edt, Uu, Ur, Uu, Ur, Uu^Tf, Uu^Tf, Rb^Tf, Uu^Tf, Uu^Vu, Xu, Xu, Xu, Wog, Wog, Wog, Xu, Xu, Xu, Xu, Xu, Xu
Xu, Xu, Xu, Xu, Xu, Xu, Xu, Xu, Xu, Xu, Xu, Xu, Qxu, Qxu, Uh, Uh, Uu, Uu^Vud, Uh, Uh, Uh, Uu^Tf, Xu, Uh, Uh, Uh, Qxu, Qxu, Qxu, Uu^Tf, Uu^Tf, Rb, Uu, Rb, Uu, Ur, Uu, Uh, Uh, Xu, Xu, Xu, Xu, Xu, Xu, Xu, Wog^Xo, Wog, Xu, Xu, Xu, Xu, Xu, Xu
Xu, Xu, Xu, Xu, Xu, Xu, Xu, Xu, Xu, Xu, Xu, Qxu, Qxu, Qxu, Qxu, Uu, Ur, Uu, Xu, Qxu, Qxu, Xu, Xu, Xu, Xu, Xu, Qxu, Qxu, Xu, Qxu, Xu, Uu, Xu, Uu, Ur, Uu^Tf, Rb^Em, Uu^Tf, Uu, Uu, Xu, Xu, Wog, Wog, Wog, Wog, Wog^Es, Xu, Xu, Xu, Xu, Xu, Xu, Xu
Xu, Xu, Xu, Xu, Xu, Xu, Xu, Xu, Xu, Xu, Xu, Xu, Qxu, Qxu, Qxu, Qxu, Ur, Xu, Xu, Qxu, Qxu, Xu, Xu, Xu, Xu, Xu, Qxu, Xu, Xu, Xu, Xu, Xu, Xu, Xu, Uu, Uu, Rb, Uu, Uu, Xu, Wwg^Es, Wog, Wog^Es, Wog^Es, Wog, Wog, Xu, Xu, Xu, Xu, Xu, Xu, Xu, Xu
Xu, Xu, Xu, Xu, Xu, Xu, Xu, Xu, Xu, Xu, Xu, Xu, Xu, Xu, Xu, Qxu, Uu, Uu, Ur, Qxu, Xu, Xu, Xu, Xu, Xu, Qxu, Xu, Xu, Xu, Xu, Xu, Xu, Xu, Xu, Wwrg, Rb, Wwrg, Wwf, Wwf, Wwrg, Xuc, Wog, Wog, Xu, Xu, Xu, Xu, Xu, Xu, Xu, Xu, Xu, Xu, Xu
Xu, Xu, Xu, Xu, Xu, Xu, Xu, Xu, Xu, Xu, Xu, Xu, Xu, Xu, Xu, Xu, Xu, Uu, Uu, Ur, Uu^Vu, Xu, Uh, Xu, Xu, Xu, Xu, Xu, Xu, Xu, Xu, Xu, Wwg, Wwrg, Wwrg, Wwg, Wwg, Wwf, Wwg, Wwf, Wwrg, Wog, Xu, Xu, Xuc, Xu, Xu, Xu, Xu, Xu, Xu, Xu, Xu, Xu
Xu, Xu, Xu, Xu, Xu, Xu, Xu, Xu, Xu, Xu, Xu, Xu, Xu, Xu, Xu, Xu, Uh, Uh, Ur, Uu, Uu, Uu, Uh, Uh, Wwf, Xu, Xu, Xu, Xu, Xu, Xu, Wwrg, Wwg, Wwf^Es, Uu, Uu, Xuc, Wwf, Wwg^Es, Wwf, Wwrg, Xu, Uu^Tf, Xuc, Uh, Xuc, Uh, Xu, Xu, Xu, Xu, Xu, Xu, Xu
Xu, Xu, Xu, Xu, Xu, Xu, Xu, Xu, Xu, Xu, Xu, Xu, Xu, Xu, Xu, Wwf, Uu, Uu^Tf, Uu, Uu^Tf, Uu, Uh, Wwf, Uu, Xu, Xu, Xu, Xu, Xu, Xu, Wwg, Wwg, Wwg, Uh, Uu^Tf, Uu^Tf, Wwf, Wwg^Es, Wwrg, Wwg, Wog, Wwf, Wwrg, Wwg, Uu^Vud, Uh, Uh, Xu, Xu, Xu, Xu, Xu, Xu, Xu
Xu, Xu, Xu, Xu, Xu, Xu, Xu, Xu, Xu, Xu, Xu, Xu, Xu, Xu, Uh, Uh, Wwf, Wwf, Wwf, Uu, Uh, Wwf, Xu, Xu, Xu, Xu, Xu, Xu, Xu, Xu, Wog, Wwg^Es, Wog^Es, Xu, Xu, Wwg, Wwf, Uu^Vu, Uu^Tf, Wwrg, Wwg, Rb^Tf, Re^Tf, Uu^Tf, Re^Em, Uu^Tf, Uu^Tf, Xu, Xu, Xu, Xu, Xu, Xu, Xu
Xu, Xu, Xu, Xu, Xu, Xu, Xu, Xu, Xu, Xu, Xu, Xu, Xu, Xu, Uh, Uu, Wwf, Wwf, Xu, Xu, Xu, Xu, Xu, Xu, Xu, Xu, Xu, Xu, Xu, Wog, Wog^Es, Wog, Wog, Xu, Xu, Xu, Uh, Uh, Uh, Wwf, Rb, Re^Em, Rr, Uu, Re, Uu, Uu^Vud, Xuc, Xu, Xu, Xu, Xu, Xu, Xu
Xu, Xu, Xu, Xu, Xu, Xu, Xu, Xu, Xu, Xu, Xu, Xu, Xu, Xu, Xu, Xu, Xu, Xu, Xu, Xu, Xu, Xu, Xu, Xu, Xu, Xu, Xu, Xu, Wog, Wog, Wog, Wog, Xu, Xu, Xu, Xu, Xu, Uh, Xu, Uh, Uu^Tf, Re, Re, Rr, Re, Re^Tf, Uu^Tf, Xu, Xu, Xu, Xu, Xu, Xu, Xu
Xu, Xu, Xu, Xu, Xu, Xu, Xu, Xu, Xu, Xu, Xu, Xu, Xu, Xu, Xu, Xu, Xu, Xu, Xu, Xu, Xu, Xu, Xu, Xu, Xu, Xu, Wog, Wog^Xo, Xu, Wog, Xu, Xu, Xu, Xu, Xu, Xu, Xu, Xu, Xuc, Uh, Uh, Uu^Vud, Xuc, Rr, Rr, Re^Tf, Uu^Tf, Uu^Tf, Xu, Xu, Xu, Xu, Xu, Xu
Xu, Xu, Xu, Xu, Xu, Xu, Xu, Xu, Xu, Xu, Xu, Xu, Xu, Xu, Xu, Xu, Xu, Xu, Xu, Xu, Xu, Xu, Xu, Xu, Wog, Wog, Wog, Wog, Wog, Wog^Xo, Xu, Xu, Xu, Xu, Xu, Xu, Xu, Xuc, Xuc, Xuc, Xuc, Xuc, Xuc, Cud, Rr, Re^Em, Re, Uu^Tf, Xu, Xu, Xu, Xu, Xu, Xu
Xu, Xu, Xu, Xu, Xu, Xu, Xu, Xu, Xu, Xu, Xu, Xu, Xu, Xu, Xu, Xu, Xu, Xu, Xu, Xu, Xu, Xu, Xu, Wog, Xu, Xu, Wog, Wog, Wog, Xu, Xu, Xu, Xu, Xu, Xu, Xu, Xuc, Xuc, Cud, Cud, Uu, Xuc, Uu, Uu, Rr, Cud, Xuc, Xuc, Xu, Xu, Xu, Xu, Xu, Xu
Xu, Xu, Xu, Xu, Xu, Xu, Xu, Xu, Xu, Xu, Xu, Xu, Xu, Xu, Xu, Xu, Xu, Xu, Xu, Xu, Xu, Xu, Wog, Wog, Xu, Xu, Wog, Wog, Wog, Xu, Xu, Xu, Xu, Xu, Xu, Xu, Xuc, Cud, Uu, Uu, Uu, Uu, Rr, Rr, Uu, Cud, Xuc, Xuc, Xu, Xu, Xu, Xu, Xu, Xu
Xu, Xu, Xu, Xu, Xu, Xu, Xu, Xu, Xu, Xu, Xu, Xu, Xu, Xu, Wog, Xu, Wog, Xu, Xu, Xu, Xu, Xu, Wog, Wog, Wog, Wog, Wog, Wog, Xu, Xu, Xu, Xu, Xu, Xu, Xu, Xuc, Uu^Tf, Uu^Emf, Uu^Tf, Uu, Cud, Cud, Cud, Uu, Uu^Vud, Cud, Xuc, Xu, Xu, Xu, Xu, Xu, Xu, Xu
Xu, Xu, Xu, Xu, Xu, Xu, Xu, Xu, Xu, Xu, Xu, Xu, Wog, Wog, Wog, Wog, Wog, Wog, Wog, Xu, Xu, Wog, Wog, Wog, Wog, Wog, Xu, Xu, Xu, Xu, Xu, Xu, Xu, Xu, Xu, Xuc, Uu^Tf, Uu^Tf, Re^Em, Uu, Cud, 1 Kud, Cud, Uu, Xuc, Xuc, Xu, Xu, Xu, Xu, Xu, Xu, Xu, Xu
Xu, Xu, Xu, Xu, Xu, Xu, Xu, Xu, Xu, Xu, Xu, Xu, Wog, Wog, Xu, Wog, Wog, Wog, Wog, Wog, Wog, Wog, Xu, Xu, Xu, Xu, Xu, Xu, Xu, Xu, Xu, Xu, Xu, Xu, Xu, Xu, Uu, Uu^Tf, Uu^Vud, Uu, Rr, Cud, Uu, Uu, Xuc, Xu, Xu, Xu, Xu, Xu, Xu, Xu, Xu, Xu
Xu, Xu, Xu, Xu, Xu, Xu, Xu, Xu, Xu, Xu, Xu, Wog, Wog, Wog, Wog, Xu, Xu, Wog, Xu, Wog, Xu, Wog, Xu, Xu, Xu, Xu, Xu, Xu, Xu, Xu, Xu, Xu, Xu, Xu, Xu, Xuc, Xuc, Xuc, Uu^Tf, Uu^Em, Rr, Rr, Uu, Xuc, Xuc, Xu, Xu, Xu, Xu, Xu, Xu, Xu, Xu, Xu
Xu, Xu, Xu, Xu, Xu, Xu, Xu, Xu, Xu, Xu, Xu, Wog, Wog, Wog, Wog, Xu, Xu, Xu, Xu, Xu, Xu, Xu, Xu, Xu, Xu, Xu, Xu, Xu, Xu, Xu, Xu, Xu, Xu, Xu, Xu, Xu, Xu, Xuc, Uu, Uu^Tf, Rr, Uu^Vud, Re^Em, Uu, Xuc, Xuc, Xu, Xu, Xu, Xu, Xu, Xu, Xu, Xu
Xu, Xu, Xu, Xu, Xu, Xu, Xu, Xu, Xu, Xu, Xu, Xu, Xu, Wog, Wog, Wog, Wog, Xu, Xu, Xu, Xu, Xu, Xu, Xu, Xu, Xu, Xu, Xu, Xu, Xu, Xu, Xu, Xu, Xu, Xu, Xu, Xu, Xuc, Uh, Uu, Uu, Rr, Re, Uu, Xu, Xuc, Xu, Xu, Xu, Xu, Xu, Xu, Xu, Xu
Xu, Xu, Xu, Xu, Xu, Xu, Xu, Xu, Xu, Xu, Xu, Xu, Xu, Wog, Wog, Wog, Wog, Xu, Xu, Xu, Xu, Xu, Xu, Xu, Xu, Xu, Xu, Xu, Xu, Xu, Xu, Xu, Xu, Xu, Xu, Xu, Xu, Xu, Xu, Uh, Uu, Ur, Rr, Uu, Uu, Uh, Uu, Xu, Xu, Xu, Xu, Xu, Xu, Xu
Xu, Xu, Xu, Xu, Xu, Xu, Xu, Xu, Xu, Xu, Xu, Xu, Xu, Wog, Wog, Wog, Wog, Xu, Xu, Xu, Xu, Xu, Xu, Xu, Xu, Xu, Xu, Xu, Xu, Xu, Xu, Xu, Xu, Xu, Xu, Xu, Xu, Xu, Xu, Xu, Uu, Uu, Rr, Rr, Rr, Uu, Uh, Xu, Xu, Xu, Xu, Xu, Xu, Xu
