Ms^Xm, Ms^Xm, Ms^Xm, Ms^Xm, Ms^Xm, Ai, Ai, Ai, Ai, Ai, Ms, Ms, Ha, Ms, Ms, Ms, Ha, Ms, Ha, Aa, Aa, Aa, Aa, Aa, Ha, Ms, Ms, Ms, Ms, Ms, Ms^Xm, Ms^Xm, Ms^Xm, Ms^Xm, Ms^Xm, Ms^Xm, Ms^Xm, Ms^Xm, Ms^Xm, Ms^Xm
Ms^Xm, Ms^Xm, Ms^Xm, Ms^Xm, Ms^Xm, Ms^Xm, Ms^Xm, Ms^Xm, Ms^Xm, Ai, Ms, Ms, Ha, Ms, Ha, Aa^Fpa, Aa^Fpa, Ha, Hhd^Fmw, Gs^Fmw, Aa^Fma, Aa, Aa, Ha, Aa, Gll^Fmw, Aa^Fma, Ms, Ms, Ms, Mm^Xm, Mm^Xm, Ms^Xm, Ms^Xm, Ms^Xm, Ms^Xm, Ms^Xm, Ms^Xm, Ms^Xm, Ms^Xm
Ms^Xm, Ms^Xm, Ms^Xm, Ms^Xm, Ms^Xm, Ms^Xm, Ms, Ms^Xm, Ai, Ai, Ai, Ms, Ms, Ha, Ha, Ms^Xm, Ha, Hhd^Fmw, Aa^Fma, Gs^Fmw, Aa^Fpa, Gs, Gs, Aa, Gll^Fmw, Gll^Fp, Aa^Fma, Aa^Fpa, Ms, Ms, Ms^Xm, Ms^Xm, Mm^Xm, Ms^Xm, Ms^Xm, Ms^Xm, Ms^Xm, Ms^Xm, Ms^Xm, Ms^Xm
Ms^Xm, Ms^Xm, Ms^Xm, Ms^Xm, Ms^Xm, Ms, Ms, Ms^Xm, Ai, Ai, Ai, Ms^Xm, Ms, Ms, Ms, Ms^Xm, Hhd^Fmw, Gs^Fmw, Aa^Fma, Aa^Fma, Ha, Ha, Aa, Gs^Fmw, Gll^Fmw, Hhd^Fmw, Ms, Ms^Xm, Ms^Xm, Ms^Xm, Ms, Ms^Xm, Ms^Xm, Ms^Xm, Ms^Xm, Ms^Xm, Ms^Xm, Ms^Xm, Ms^Xm, Ms^Xm
Ms^Xm, Ms^Xm, Ms^Xm, Ms^Xm, Ms, Ms, Ms, Ha, Ha, Ai, Ai, Ha, Ms, Ms, Ha, Hhd, Aa^Fpa, Hhd, Gs^Fp, Aa^Fda, Aa^Fpa, Aa, Aa^Fma, Aa, Gd, Gll^Fp, Ha, Ms^Xm, Ms, Ms^Xm, Ms, Ms^Xm, Ms^Xm, Ms^Xm, Ms^Xm, Ms^Xm, Ms^Xm, Ms^Xm, Ms^Xm, Ms^Xm
Ms^Xm, Ms^Xm, Ha, Ha, Ms, Ms, Ha, Ha, Ai, Ai, Ms, Ms, Ms^Xm, Ms, Ms, Ms, Aa^Fda, Aa^Fma, Aa, Aa, Aa^Fma, Aa, Aa^Fda, Aa, Gd^Es, Aa^Fpa, Ha, Ha, Ms^Xm, Ms, Ms^Xm, Ms^Xm, Ms^Xm, Ms^Xm, Ms^Xm, Ms^Xm, Ms^Xm, Ms^Xm, Ms^Xm, Ms^Xm
Ms^Xm, Ms^Xm, Ms^Xm, Ms, Ms, Ms, Ha, Ha, Ha, Ai, Ms, Ms^Xm, Ms^Xm, Ms^Xm, Ha, Ha, Cfa, Aa^Fda, Gs, Aa, Aa, Aa^Fpa, Gs, Gd, Aa^Fma, Aa^Fpa, Ms, Ms^Xm, Ms^Xm, Ms, Ms^Xm, Ms, Ms^Xm, Ms^Xm, Ms^Xm, Ms^Xm, Ms^Xm, Ms^Xm, Ms^Xm, Ms^Xm
Ms^Xm, Ms^Xm, Ms^Xm, Ms^Xm, Ha, Ms, Ms, Ms, Ms, Ms, Ms, Ms, Ms^Xm, Ms^Xm, Ha, Ha, Ha^Fpa, Aa, Ha^Fpa, Aa, Aa^Fma, Aa^Fma, Aa^Fpa, Aa, Aa^Fpa, Ha, Ms, Ms^Xm, Ms^Xm, Ms, Ms, Ms^Xm, Ms^Xm, Ms^Xm, Ms^Xm, Ms^Xm, Ms^Xm, Ms^Xm, Ms^Xm, Ms^Xm
Ms^Xm, Ms^Xm, Ms^Xm, Ha, Ha, Ms, Ms, Ms, Ms, Ms, Ms, Ms, Ms, Ms^Xm, Ms, Ms, Ha, Ha, Ha, Aa^Fpa, Aa, Aa^Fpa, Aa^Fma, Ha^Fma, Ms, Ms, Ms, Ms, Ms, Ms, Ms^Xm, Ms^Xm, Ms, Ms^Xm, Ms^Xm, Mm^Xm, Ms^Xm, Ms^Xm, Ms^Xm, Ms^Xm
Ms^Xm, Ms^Xm, Ms^Xm, Ms^Xm, Ms^Xm, Ms^Xm, Ms^Xm, Ms^Xm, Ms^Xm, Ms^Xm, Ms^Xm, Ms^Xm, Ms^Xm, Ms^Xm, Ms, Ms, Ha, Ha, Aa^Fpa, Aa^Fma, Rb^Esa, Aa^Esa, Aa, Ha^Fma, Ha, Ms, Ms, Ms, Ms, Ms, Ms, Ms, Ms^Xm, Ms^Xm, Ms^Xm, Ms^Xm, Ms^Xm, Ms^Xm, Ms^Xm, Ms^Xm
Ms^Xm, Ms^Xm, Ms^Xm, Ms^Xm, Ms^Xm, Ms^Xm, Ms^Xm, Ms^Xm, Ms^Xm, Ms^Xm, Ms^Xm, Ms^Xm, Ms^Xm, Ms, Ms, Ms, Ha^Fpa, Ha, Aa^Fpa, Aa^Fma, Aa, Rb^Esa, Aa, Aa^Es, Cfa, Ha, Ms, Ms, Ms^Xm, Ms^Xm, Ms^Xm, Ms, Ms^Xm, Ms^Xm, Ms^Xm, Ms^Xm, Ms^Xm, Ms^Xm, Ms^Xm, Ms^Xm
Xue, Ms^Xm, Ms^Xm, Ms^Xm, Ms^Xm, Ms^Xm, Ha, Ms, Ms, Ms^Xm, Ms^Xm, Ms^Xm, Ms^Xm, Ms, Ha, Ha^Fma, Ai, Aa^Fpa, Aa^Es, Rb^Esa, Aa, Aa, Aa, Aa, Aa^Fpa, Ms, Ms, Ms, Ms^Xm, Ms^Xm, Ms^Xm, Ms^Xm, Ms^Xm, Ms^Xm, Ms^Xm, Ms^Xm, Ms^Xm, Ms^Xm, Ms^Xm, Ms^Xm
Xue, Xue, Ms^Xm, Ms^Xm, Ms^Xm, Ms^Xm, Ha, Ha, Ms, Ms, Ms^Xm, Ms^Xm, Ms^Xm, Ha^Fma, Ha, Ha^Fma, Ai, Aa^Fpa, Aa, Aa, Rb^Es, Aa, Aa^Fpa, Rb^Esa, Gll^Es, Ha^Fma, Ha^Fma, Ms, Ms, Ms^Xm, Ms^Xm, Ms^Xm, Ms^Xm, Ms, Ms^Xm, Ms^Xm, Ms^Xm, Ms^Xm, Xue, Xue
Xue, Xue, Ms^Xm, Ms^Xm, Ms^Xm, Ms^Xm, Ms^Xm, Ha, Ha, Ms, Ms^Xm, Ms^Xm, Ms^Xm, Ha, Ms, Cfa, Ha^Fpa, Ai, Aa, Rb^Esa, Aa, Aa, Aa^Fma, Rb^Esa, Rb, Aa^Fpa, Ha, Ms, Ms, Ms^Xm, Ms^Xm, Ms^Xm, Ms^Xm, Ms^Xm, Ms^Xm, Ms^Xm, Ms^Xm, Xue, Xue, Xue
Xue, Xue, Xue, Ms^Xm, Ms^Xm, Ms^Xm, Ms^Xm, Ms^Xm, Ms^Xm, Ms^Xm, Ms^Xm, Ms^Xm, Ms^Xm, Ms^Xm, Ha^Fma, Ha, Ha^Fpa, Aa^Fda, Rb^Esa, Aa^Fma, Rb, Aa, Aa^Fma, Aa^Fma, Aa^Fma, Aa^Fpa, Ms, Cfa, Ha, Ms^Xm, Ms^Xm, Ms^Xm, Ms^Xm, Mm^Xm, Ms^Xm, Ms^Xm, Xue, Xue, Xue, Xue
Xue, Xue, Xue, Xue, Xue, Ms^Xm, Ms^Xm, Ms^Xm, Ms^Xm, Ms^Xm, Ms^Xm, Ms^Xm, Ms, Ha, Ms, Ms, Ha, Aa^Fma, Aa^Fda, Aa, Gll^Esa, Rb, Aa^Fda, Aa^Fda, Ha, Ha, Ha, Ha, Ms, Ms^Xm, Ms^Xm, Ms^Xm, Ms^Xm, Mm^Xm, Ms^Xm, Ms^Xm, Xue, Xue, Xue, Xue
Xue, Xue, Xue, Xue, Xue, Ms^Xm, Ms^Xm, Ms^Xm, Ms^Xm, Ms^Xm, Ms^Xm, Ms^Xm, Ms^Xm, Ms, Ms, Ms, Ha, Ha, Ms, Aa, Aa, Rb, Aa^Fpa, Ha, Ms, Ha, Ms^Xm, Ms, Ms, Ms, Ms^Xm, Ms^Xm, Ms^Xm, Ms^Xm, Ms^Xm, Xue, Xue, Xue, Xue, Xue
Xue, Xue, Xue, Xue, Xue, Xue, Xue, Ms^Xm, Xue, Ms^Xm, Ms^Xm, Ms^Xm, Ms^Xm, Ms, Ms, Ms, Ms, Ms, Ms, Ha, Aa, Aa, Ms, Ms^Xm, Ms^Xm, Ms^Xm, Ms^Xm, Ms^Xm, Ms^Xm, Ms, Xue, Ms^Xm, Xue, Ms^Xm, Xue, Xue, Xue, Xue, Xue, Xue
Xue, Xue, Xue, Xue, Xue, Xue, Xue, Xue, Xue, Xue, Xue, Xue, Xue, Ms^Xm, Ms^Xm, Ms^Xm, Xue, Ms^Xm, Xue, Ms, Aa, Aa, Xue, Ms^Xm, Xue, Xue, Xue, Xue, Xue, Xue, Xue, Xue, Xue, Xue, Xue, Xue, Xue, Xue, Xue, Xue
Xue, Xue, Xue, Xue, Xue, Xue, Xue, Xue, Xue, Xue, Xue, Xue, Xue, Xue, Xue, Xue, Xue, Xue, Xue, Uue, Uue, Uue, Xue, Xue, Xue, Xue, Xue, Xue, Xue, Xue, Xue, Xue, Xue, Xue, Xue, Xue, Xue, Xue, Xue, Xue
Xue^Zok, Xue, Xue^Zok, Xue, Xue^Zok, Xue, Xue^Zok, Xue, Xue^Zok, Xue, Xue^Zok, Xue, Xue^Zok, Xue, Xue^Zok, Xue, Xue^Zok, Xue, Xue^Zok, Uue, 1 Uue, Uue, Uue^Zok, Xue, Xue^Zok, Xue, Xue^Zok, Xue, Xue^Zok, Xue, Xue^Zok, Xue, Xue^Zok, Xue, Xue^Zok, Xue, Xue^Zok, Xue, Xue^Zok, Xue
Xue^Zok, Xue^Zok, Xue^Zok, Xue^Zok, Xue^Zok, Xue^Zok, Xue^Zok, Xue^Zok, Xue^Zok, Xue^Zok, Xue^Zok, Xue^Zok, Xue^Zok, Xue^Zok, Xue^Zok, Xue^Zok, Xue^Zok, Xue^Zok, Xue^Zok, Uue^Zok, Uue^Zok, Uue^Zok, Uue^Zok, Xue^Zok, Xue^Zok, Xue^Zok, Xue^Zok, Xue^Zok, Xue^Zok, Xue^Zok, Xue^Zok, Xue^Zok, Xue^Zok, Xue^Zok, Xue^Zok, Xue^Zok, Xue^Zok, Xue^Zok, Xue^Zok, Xue^Zok
