border_size=1
usage=map

Qxu         , Qxu         , Qxu         , Qxu         , Uu^Ii       , Uu^Ii       , Rd          , Rd          , Re^Xp       , Rr          , Uu^Uf       , Uu^Uf       , Uu^Uf       , Uh          , Uzw          , Uzw          , Re          , Re          , Rd          , Uu^Ii       , Re^Uf       , Uu^Uf       , Uu^Uf       , Uh          , Xu          , Xu          , Xu          , Xu          , Xu          , Xu          , Xu          , Xu
Re          , Uu          , Yhr         , Uu          , Uu          , Uu^Ii       , Yhr         , Yhr         , Rr          , Rr          , Re          , Uh          , Uh^Ii       , Uh          , Uzw          , Uzw          , Uzw          , Re^Uf       , Re^Uf       , Rd^Dr       , Uu          , Uu^Uf       , Uh          , Re^Uf       , Xu          , Xu          , Xu          , Xu          , Xu          , Xu          , Xu          , Xu
Re^Xp       , Re          , Yhr^Xp      , Yhr         , Rr          , Uu^Xp       , Re          , Yhr^Xp      , Re          , Rd          , Yhr^Xp      , Re          , Uu^Ii       , Uu^Ii       , Uzw          , Rd          , Re^Uf       , Uzw          , Uu          , Uu          , Uu          , Uh          , Uh^Ii       , Uh^Ii       , Uu^Uf       , Re^Dr       , Xu          , Xu          , Xu          , Xu          , Xu          , Xu
Uu          , Uu^Uf       , Uu^Uf       , Uu^Uf       , Uu^Xp       , Rr          , Yhr^Xp      , Uu          , Uu^Uf       , Uu          , Yhr         , Re          , Rd          , Uzw          , Uzw          , Re^Uf       , Uzw          , Uzw          , Uu          , Uh          , Uu          , Uu^Uf       , Dd^Dr       , Uh^Ii       , Uu^Uf       , Re^Uf       , Uh          , Xu          , Xu          , Xu          , Xu          , Xu
Uu          , Uu^Uf       , Yhr         , Yhr         , Yhr^Xp      , Yhr^Xp      , Uu^Cd       , Yhr^Xp      , Yhr         , Uu          , Uu          , Re          , Uu          , Uu          , Uzw          , Uzw          , Uzw          , Uzw          , Uu          , Uu          , Uu          , Uu          , Uu          , Uh          , Uu          , Uh          , Uu          , Uh          , Xu          , Xu          , Uu          , Xu
Yhr^Xp      , Uu^Uf       , Yhr         , Yhr^Xp      , Yhr^Xp      , 4 Uu^Kd     , Uu^Cd       , Yhr^Xp      , Yhr         , Rr^Xp       , Uu          , Re^Xp       , Re          , Uu          , Rd          , Uzw          , Uu          , Uzw          , Uzw          , Uu^Uf       , Uu^Uf       , Uu          , Uu^Ii       , Rd          , Rd          , Uu          , Uu          , Uu          , Uu^Uf       , Uu^Uf       , Rd          , Uu
Yhr         , Yhr^Xp      , Yhr         , Yhr^Xp      , Yhr^Xp      , Uu^Cd       , Yhr^Xp      , Yhr^Xp      , Yhr         , Rr          , Rr          , Re^Uf       , Re          , Uu          , Re          , Uu          , Uu          , Uu          , Uu          , Uu          , Re          , Uh          , Rd          , Uu          , Rd          , Rd          , Uu          , Rd          , Uu          , Uu^Uf       , Uu          , Rd
Yhr^Xp      , Yhr         , Yhr^Xp      , Yhr         , Yhr         , Yhr^Xp      , Yhr         , Yhr         , Yhr^Xp      , Uu          , Uh^Xp       , Rr          , Rr          , Rd          , Re          , Re          , Uzw          , Uzw          , Re^Dr       , Re          , Re          , Uh          , Rd          , Uu^Uf       , Rd          , Rd          , Rd          , Rd          , Uu          , Uu          , Rd          , Rd
Uh          , Uh^Xp       , Re          , Uu          , Uu          , Uu^Xp       , Uu          , Rr          , Re          , Uu          , Uh          , Uh          , Re          , Rr          , Rr          , Re          , Uu          , Uzw          , Uu          , Uu          , Rd          , Re          , Re          , Uu^Uf       , Uu^Ii       , Uu          , Uu          , Rd          , Rd          , Uu          , Rd          , Uu
Uh          , Uh          , Xu          , Uu^Xp       , Uu          , Uu          , Rd          , Rd^Xp       , Re          , Rd          , Uu^Uf       , Re          , Re          , Rd          , Rr          , Rd          , Uzw          , Uzw          , Uzw          , Rd^Dr       , Uu^Uf       , Rd          , Re          , Re          , Uu^Ii       , Uu^Dr       , Uzw          , Uu          , Uu          , Uu^Uf       , Re          , Uu^Uf
Xu          , Xu          , Xu          , Xu          , Uh          , Uh          , Rr          , Re          , Re          , Re          , Rr          , Re          , Re          , Re          , Re          , Re          , Uzw          , Uzw          , Rd^Dr       , Uu          , Rd          , Rd          , Re^Dr       , Re^Ii       , Re^Ii       , Re^Ii       , Uzw          , Uh          , Re          , Re          , Rd          , Rr
Xu          , Xu          , Xu          , Xu          , Uh          , Uh          , Rr          , Uu^Uf       , Uu          , Re          , Uu^Uf       , Re          , Re          , Rr          , Re          , Re          , Rd          , Rd          , Uzw          , Uu          , Uu^Uf       , Uu          , Uu          , Uu^Ii       , Uu^Ii       , Re^Ii       , Uzw          , Re          , Rr          , Re          , Uu          , Rd
Uu          , Uu          , Uu          , Xu          , Uu^Ii       , Uh          , Rr          , Uu          , Uh          , Uzw          , Uzw          , Uu^Vu       , Uh          , Uh          , Rr          , Re          , Uu          , Uu          , Uzw          , Uu          , Uzw          , Uu          , Uu          , Uu^Ii       , Uzw          , Uzw          , Uzw          , Rr          , Uu          , Uu          , Uu          , Uu^Uf
Re          , Re          , Rr          , Rr          , Rr          , Rr          , Uu          , Uu          , Uzw          , Uzw          , Uzw          , Uu          , Uu          , Uu          , Rr          , Uu          , Uu          , Uu          , Uu          , Uzw          , Uzw          , Uu          , Rr          , Rr          , Uzw          , Uzw          , Uh          , Uzw^Dr       , Uu^Uf       , Uu^Uf       , Xu          , Uu
Uu          , Uu          , Re          , Uh          , Uh^Ii       , Re          , Uzw          , Uzw^Dr       , Uzw          , Uzw          , Uzw          , Uu          , Rd          , Rd          , Rr          , Rd          , Uu          , Re^Uf       , Uu          , Uzw          , Uu          , Uu          , Rr          , Uu          , Uu          , Uzw^Dr       , Uh          , Uu^Uf       , Xu          , Xu          , Xu          , Xu
Uu          , Rd          , Re          , Uh^Ii       , Uh^Ii       , Uu^Ii       , Uzw          , Uzw          , Uzw          , Uzw          , Uzw          , Uzw          , Cud         , Cud         , Rr          , Cud         , Cud         , Uu          , Re^Uf       , Uu          , Re^Uf       , Rr          , Uu^Vud      , Uu          , Uu          , Uh          , Uu^Uf       , Uu^Uf       , Xu          , Xu          , Xu          , Xu
Uu          , Uu          , Uu^Ii       , Rd          , Uu          , Uu          , Uzw          , Uzw          , Rr          , Uu          , Cud         , Cud         , Dd^Dr       , Rd          , Wo^Bw|      , Uu          , Uu^Vud      , Cud         , Cud         , Re^Uf       , Rr          , Rr          , Uu          , Uu          , Uh          , Uu          , Xu          , Xu          , Xu          , Xu          , Xu          , Xu
Uh          , Uu^Uf       , Uu^Ii       , Rd          , Qxu         , Uu          , Uu          , Uh          , Uh          , Rr          , Rr          , Uu          , Rd          , Rd          , Cud         , Rd          , Rd          , Uu          , Rr          , Rr          , Dd^Dr       , Uu          , Uu          , Uh          , Qxu         , Xu          , Xu          , Xu          , Xu          , Xu          , Xu          , Xu
Uu          , Uu          , Uu^Uf       , Uu          , Qxu         , Qxu         , Uu^Uf       , Uu^Uf       , Qxu         , Cud         , Rd^Dr       , Rd^Dr       , Dd^Dr       , Cud         , Uu^Cd       , Cud         , Uh          , Rd^Dr       , Rd          , Ds          , Ds          , Uzw          , Uh          , Uh          , Qxu         , Qxu         , Qxu         , Xu          , Xu          , Xu          , Qxu         , Xu
Uu          , Uh          , Uu^Uf       , Uu^Uf       , Uu          , Qxu         , Qxu         , Qxu         , Qxu         , Uu^Vud      , Rd^Dr       , Rd          , Cud         , Uu^Cd       , 1 Uu^Kd     , Uu^Cd       , Uu^Dr       , Rd          , Uu          , Rd^Dr       , Ds          , Uzw          , Uzw          , Qxu         , Qxu         , Qxu         , Qxu         , Qxu         , Qxu         , Qxu         , Qxu         , Qxu
Uh          , Uh          , Uh          , Uu^Uf       , Uh^Ii       , Uh^Ii       , Qxu         , Uu          , Qxu         , Uu^Uf       , Uh          , Rd          , Uh          , Uu^Cd       , Uu^Cd       , Uu^Cd       , Cud         , Rd          , Uu^Uf       , Uzw          , Ds          , Uzw          , Uzw          , Uh          , Uh          , Qxu         , Uu^Dr       , Uh          , Uh          , Uu^Uf       , Re          , Uu
Re          , Uu^Uf       , Re          , Uu          , Uu^Ii       , Uh^Ii       , Uu          , Uu          , Qxu         , Qxu         , Rr          , Uu^Dr       , Rd          , Cud         , Cud         , Uh          , Rd          , Uu^Dr       , Rr          , Ds          , Uu          , Uu^Dr       , Rr          , Uh          , Re          , Qxu         , Re          , Rr          , Rr          , Re          , Uu          , Uu
Uu          , Rd          , Qxu         , Rd          , Re          , Uu^Ii       , Rd          , Uu          , Rr          , Rr          , Cud         , Uu^Uf       , Ds          , Rd          , Wo^Bw|      , Rd          , Uu^Vud      , Uu          , Uh          , Rr          , Rr          , Rr          , Uu^Ii       , Uzw          , Rr          , Re          , Qxu         , Qxu         , Uu^Uf       , Uu^Uf       , Uh          , Uh
Qxu         , Qxu         , Uu          , Qxu         , Qxu         , Re          , Rr          , Rr          , Dd^Dr       , Ds          , Uh          , Uu^Dr       , Uu^Dr       , Ds          , Rr          , Uu          , Rd          , Uu^Dr       , Uzw          , Uu          , Rr          , Uu^Ii       , Uzw          , Uzw          , Uzw          , Uu          , Qxu         , Uu^Uf       , Uh          , Uh          , Qxu         , Uh
Uh          , Uh          , Uzw          , Uzw          , Rr          , Qxu         , Uu^Ii       , Ds          , Ds          , Qxu         , Uu          , Uu^Uf       , Uu^Dr       , Ds          , Rr          , Uh          , Uu^Dr       , Uh          , Uu          , Uzw          , Uzw          , Uzw^Dr       , Uzw          , Uzw          , Uzw          , Qxu         , Qxu         , Qxu         , Qxu         , Qxu         , Qxu         , Qxu
Uzw          , Uzw          , Uzw          , Uzw          , Uu^Dr       , Qxu         , Uu^Ii       , Uu^Uf       , Uu          , Uu          , Uu          , Uu          , Uu          , Uu          , Rr          , Uu^Uf       , Uu^Uf       , Uh          , Uu          , Ds          , Uzw          , Uzw          , Uu^Ii       , Uzw          , Qxu         , Qxu         , Qxu         , Qxu         , Qxu         , Qxu         , Qxu         , Qxu
Rr          , Uzw          , Uzw          , Uzw          , Uu^Ii       , Uu          , Qxu         , Uu          , Ds          , Uu          , Uu          , Uu          , Rr          , Rd          , Uzw          , Uu          , Uu          , Uu          , Ds          , Ds          , Rr          , Uu          , Uu^Ii       , Uu^Ii       , Uu^Ii       , Qxu         , Qxu         , Qxu         , Xu          , Xu          , Xu          , Xu
Re          , Re          , Uzw          , Uu          , Uu^Ii       , Uu          , Uu          , Qxu         , Ds          , Ds          , Qxu         , Rr          , Rr          , Qxu         , Uzw          , Uzw          , Uu          , Qxu         , Rd          , Rd          , Ds^Ii       , Ce^Ii       , Ce          , Ce^Ii       , Ce^Ii       , Qxu         , Qxu         , Qxu         , Qxu         , Xu          , Xu          , Xu
Re          , Re          , Uh          , Uu          , Uu^Ii       , Uu^Ii       , Uu          , Uu^Uf       , Ds          , Ds          , Uu          , Uu          , Rr          , Uu          , Qxu         , Uzw          , Uu          , Qxu         , Uu          , Qxu         , Ds^Ii       , Ds^Ii       , Ce          , 3 Ke        , Ce          , Qxu         , Qxu         , Qxu         , Qxu         , Xu          , Xu          , Xu
Re          , Re^Dr       , Uh          , Uu          , Uu          , Uu^Ii       , Uh          , Rd          , Ds          , Uu^Uf       , Uu          , Uh          , Rr          , Uu^Ii       , Uu^Ii       , Uu          , Rd          , Qxu         , Qxu         , Uu^Ii       , Uu^Ii       , Ce          , Rr          , Ce          , Uu          , Qxu         , Qxu         , Qxu         , Qxu         , Qxu         , Xu          , Xu
Uh          , Uu^Ii       , Uu          , Uu          , Uu          , Uu^Ii       , Uu^Uf       , Re          , Re          , Uu^Uf       , Uu^Uf       , Uu^Ii       , Uu          , Rr          , Uu^Ii       , Uu^Uf       , Rd^Ii       , Qxu         , Qxu^Ii      , Uu^Ii       , Uu          , Re          , Uu          , Rr          , Uu          , Qxu         , Uu          , Qxu         , Qxu         , Qxu         , Qxu         , Uu^Uf
Xu          , Xu          , Uu          , Uu          , Uu          , Uu          , Uu^Uf       , Re          , Re          , Uu          , Uu          , Uu          , Uu^Ii       , Rr          , Rr^Ii       , Uu^Ii       , Uu^Ii       , Qxu^Ii      , Qxu^Ii      , Qxu         , Qxu         , Qxu         , Qxu         , Uu          , Uu          , Uu          , Uu          , Uu          , Qxu         , Qxu         , Qxu         , Qxu
