border_size=1
usage=map

Qxu         , Qxu         , Qxu         , Qxu         , Uu^Ii       , Uu^Ii       , Rd          , Rd          , Re          , Rr          , Uu^Uf       , Uu^Uf       , Uu^Uf       , Uh          , Zw          , Zw          , Re          , Re          , Rd          , Uu^Ii       , Re^Uf       , Uu^Uf       , Uu^Uf       , Uh          , Xu          , Xu          , Xu          , Xu          , Xu          , Xu          , Xu          , Xu          
Re          , Uu          , Yhr          , Uu          , Uu          , Uu^Ii       , Yhr          , Yhr          , Rr          , Rr          , Re          , Uh          , Uh^Ii       , Uh          , Zw          , Zw          , Zw          , Re^Uf       , Re^Uf       , Dd^Dr       , Uu          , Uu^Uf       , Uh          , Re^Uf       , Xu          , Xu          , Xu          , Xu          , Xu          , Xu          , Xu          , Xu
Re          , Re          , Yhr^Xp         , Yhr          , Rr          , Uu          , Re          , Yhr^Xp         , Re          , Rd          , Yhr^Xp         , Re          , Uu^Ii       , Uu^Ii       , Zw          , Rd          , Re^Uf       , Zw          , Uu          , Uu          , Uu          , Uh          , Uh^Ii       , Uh^Ii       , Uu^Uf       , Dd^Dr       , Xu          , Xu          , Xu          , Xu          , Xu          , Xu
Uu          , Uu^Uf       , Uu^Uf       , Uu^Uf       , Uu          , Rr          , Yhr^Xp         , Uu          , Uu^Uf       , Uu          , Yhr          , Re          , Rd          , Zw          , Zw          , Re^Uf       , Zw          , Zw          , Uu          , Uh          , Uu          , Uu^Uf       , Dd^Dr       , Uh^Ii       , Uu^Uf       , Re^Uf       , Uh          , Xu          , Xu          , Xu          , Xu          , Xu
Uu          , Uu^Uf       , Yhr          , Yhr          , Yhr^Xp         , Yhr^Xp         , Uu^Cd       , Yhr^Xp         , Yhr          , Uu          , Uu          , Re          , Uu          , Uu          , Zw          , Zw          , Zw          , Zw          , Uu          , Uu          , Uu          , Uu          , Uu          , Uh          , Uu          , Uh          , Uu          , Uh          , Xu          , Xu          , Uu          , Xu
Yhr^Xp         , Uu^Uf       , Yhr          , Yhr^Xp         , Yhr^Xp         , 4 Uu^Kd     , Uu^Cd       , Yhr^Xp         , Yhr          , Rr          , Uu          , Re          , Re          , Uu          , Rd          , Zw          , Uu          , Zw          , Zw          , Uu^Uf       , Uu^Uf       , Uu          , Uu^Ii       , Rd          , Rd          , Uu          , Uu          , Uu          , Uu^Uf       , Uu^Uf       , Rd          , Uu
Yhr          , Yhr^Xp         , Yhr          , Yhr^Xp         , Yhr^Xp         , Uu^Cd       , Yhr^Xp         , Yhr^Xp         , Yhr          , Rr          , Rr          , Re^Uf       , Re          , Uu          , Re          , Uu          , Uu          , Uu          , Uu          , Uu          , Re          , Uh          , Rd          , Uu          , Rd          , Rd          , Uu          , Rd          , Uu          , Uu^Uf       , Uu          , Rd
Yhr^Xp         , Yhr          , Yhr^Xp         , Yhr          , Yhr          , Yhr^Xp         , Yhr          , Yhr          , Yhr^Xp         , Uu          , Uh          , Rr          , Rr          , Rd          , Re          , Re          , Zw          , Zw          , Dd^Dr       , Re          , Re          , Uh          , Rd          , Uu^Uf       , Rd          , Rd          , Rd          , Rd          , Uu          , Uu          , Rd          , Rd
Uh          , Uh          , Re          , Uu          , Uu          , Uu          , Uu          , Rr          , Re          , Uu          , Uh          , Uh          , Re          , Rr          , Rr          , Re          , Uu          , Zw          , Uu          , Uu          , Rd          , Re          , Re          , Uu^Uf       , Uu          , Uu          , Uu          , Rd          , Rd          , Uu          , Rd          , Uu          
Uh          , Uh          , Xu          , Uu          , Uu          , Uu          , Rd          , Rd          , Re          , Rd          , Uu^Uf       , Re          , Re          , Rd          , Rr          , Rd          , Zw          , Zw          , Zw          , Dd^Dr       , Uu^Uf       , Rd          , Re          , Re          , Uu          , Dd^Dr       , Zw          , Uu          , Uu          , Uu^Uf       , Re          , Uu^Uf       
Xu          , Xu          , Xu          , Xu          , Uh          , Uh          , Rr          , Re          , Re          , Re          , Rr          , Re          , Re          , Re          , Re          , Re          , Zw          , Zw          , Dd^Dr       , Uu          , Rd          , Rd          , Dd^Dr       , Re          , Re          , Re          , Zw          , Uh          , Re          , Re          , Rd          , Rr          
Xu          , Xu          , Xu          , Xu          , Uh          , Uh          , Rr          , Uu^Uf       , Uu          , Re          , Uu^Uf       , Re          , Re          , Rr          , Re          , Re          , Rd          , Rd          , Zw          , Uu          , Uu^Uf       , Uu          , Uu          , Uu^Ii       , Uu^Ii       , Re          , Zw          , Re          , Rr          , Re          , Uu          , Rd          
Uu          , Uu          , Uu          , Xu          , Uu^Ii       , Uh          , Rr          , Uu          , Uh          , Zw          , Zw          , Uu^Vu       , Uh          , Uh          , Rr          , Re          , Uu          , Uu          , Zw          , Uu          , Zw          , Uu          , Uu          , Uu^Ii       , Zw          , Zw          , Zw          , Rr          , Uu          , Uu          , Uu          , Uu^Uf       
Re          , Re          , Rr          , Rr          , Rr          , Rr          , Uu          , Uu          , Zw          , Zw          , Zw          , Uu          , Uu          , Uu          , Rr          , Uu          , Uu          , Uu          , Uu          , Zw          , Zw          , Uu          , Rr          , Rr          , Zw          , Zw          , Uh          , Dd^Dr       , Uu^Uf       , Uu^Uf       , Xu          , Uu          
Uu          , Uu          , Re          , Uh          , Uh^Ii       , Re          , Zw          , Dd^Dr       , Zw          , Zw          , Zw          , Uu          , Rd          , Rd          , Rr          , Rd          , Uu          , Re^Uf       , Uu          , Zw          , Uu          , Uu          , Rr          , Uu          , Uu          , Dd^Dr       , Uh          , Uu^Uf       , Xu          , Xu          , Xu          , Xu          
Uu          , Rd          , Re          , Uh^Ii       , Uh^Ii       , Uu^Ii       , Zw          , Zw          , Zw          , Zw          , Zw          , Zw          , Cud         , Cud         , Rr          , Cud         , Cud         , Uu          , Re^Uf       , Uu          , Re^Uf       , Rr          , Uu^Vud      , Uu          , Uu          , Uh          , Uu^Uf       , Uu^Uf       , Xu          , Xu          , Xu          , Xu          
Uu          , Uu          , Uu^Ii       , Rd          , Uu          , Uu          , Zw          , Zw          , Rr          , Uu          , Cud         , Cud         , Dd^Dr       , Rd          , Wo^Bw|      , Uu          , Uu^Vud      , Cud         , Cud         , Re^Uf       , Rr          , Rr          , Uu          , Uu          , Uh          , Uu          , Xu          , Xu          , Xu          , Xu          , Xu          , Xu          
Uh          , Uu^Uf       , Uu^Ii       , Rd          , Qxu         , Uu          , Uu          , Uh          , Uh          , Rr          , Rr          , Uu          , Rd          , Rd          , Cud         , Rd          , Rd          , Uu          , Rr          , Rr          , Dd^Dr       , Uu          , Uu          , Uh          , Qxu         , Xu          , Xu          , Xu          , Xu          , Xu          , Xu          , Xu          
Uu          , Uu          , Uu^Uf       , Uu          , Qxu         , Qxu         , Uu^Uf       , Uu^Uf       , Qxu         , Cud         , Dd^Dr       , Dd^Dr       , Dd^Dr       , Cud         , Uu^Cd       , Cud         , Uh          , Dd^Dr       , Rd          , Ds          , Ds          , Zw          , Uh          , Uh          , Qxu         , Qxu         , Qxu         , Xu          , Xu          , Xu          , Qxu         , Xu          
Uu          , Uh          , Uu^Uf       , Uu^Uf       , Uu          , Qxu         , Qxu         , Qxu         , Qxu         , Uu^Vud      , Dd^Dr       , Rd          , Cud         , Uu^Cd       , 1 Uu^Kd     , Uu^Cd       , Dd^Dr       , Rd          , Uu          , Dd^Dr       , Ds          , Zw          , Zw          , Qxu         , Qxu         , Qxu         , Qxu         , Qxu         , Qxu         , Qxu         , Qxu         , Qxu         
Uh          , Uh          , Uh          , Uu^Uf       , Uh^Ii       , Uh^Ii       , Qxu         , Uu          , Qxu         , Uu^Uf       , Uh          , Rd          , Uh          , Uu^Cd       , Uu^Cd       , Uu^Cd       , Cud         , Rd          , Uu^Uf       , Zw          , Ds          , Zw          , Zw          , Uh          , Uh          , Qxu         , Dd^Dr       , Uh          , Uh          , Uu^Uf       , Re          , Uu          
Re          , Uu^Uf       , Re          , Uu          , Uu^Ii       , Uh^Ii       , Uu          , Uu          , Qxu         , Qxu         , Rr          , Dd^Dr       , Rd          , Cud         , Cud         , Uh          , Rd          , Dd^Dr       , Rr          , Ds          , Uu          , Dd^Dr       , Rr          , Uh          , Re          , Qxu         , Re          , Rr          , Rr          , Re          , Uu          , Uu          
Uu          , Rd          , Qxu         , Rd          , Re          , Uu^Ii       , Rd          , Uu          , Rr          , Rr          , Cud         , Uu^Uf       , Ds          , Rd          , Wo^Bw|      , Rd          , Uu^Vud      , Uu          , Uh          , Rr          , Rr          , Rr          , Uu^Ii       , Zw          , Rr          , Re          , Qxu         , Qxu         , Uu^Uf       , Uu^Uf       , Uh          , Uh          
Qxu         , Qxu         , Uu          , Qxu         , Qxu         , Re          , Rr          , Rr          , Dd^Dr       , Ds          , Uh          , Dd^Dr       , Dd^Dr       , Ds          , Rr          , Uu          , Rd          , Dd^Dr       , Zw          , Uu          , Rr          , Uu^Ii       , Zw          , Zw          , Zw          , Uu          , Qxu         , Uu^Uf       , Uh          , Uh          , Qxu         , Uh          
Uh          , Uh          , Zw          , Zw          , Rr          , Qxu         , Uu^Ii       , Ds          , Ds          , Qxu         , Uu          , Uu^Uf       , Dd^Dr       , Ds          , Rr          , Uh          , Dd^Dr       , Uh          , Uu          , Zw          , Zw          , Dd^Dr       , Zw          , Zw          , Zw          , Qxu         , Qxu         , Qxu         , Qxu         , Qxu         , Qxu         , Qxu         
Zw          , Zw          , Zw          , Zw          , Dd^Dr       , Qxu         , Uu^Ii       , Uu^Uf       , Uu          , Uu          , Uu          , Uu          , Uu          , Uu          , Rr          , Uu^Uf       , Uu^Uf       , Uh          , Uu          , Ds          , Zw          , Zw          , Uu^Ii       , Zw          , Qxu         , Qxu         , Qxu         , Qxu         , Qxu         , Qxu         , Qxu         , Qxu         
Rr          , Zw          , Zw          , Zw          , Uu^Ii       , Uu          , Qxu         , Uu          , Ds          , Uu          , Uu          , Uu          , Rr          , Rd          , Zw          , Uu          , Uu          , Uu          , Ds          , Ds          , Rr          , Uu          , Uu^Ii       , Uu          , Uu          , Qxu         , Qxu         , Qxu         , Xu          , Xu          , Xu          , Xu          
Re          , Re          , Zw          , Uu          , Uu^Ii       , Uu          , Uu          , Qxu         , Ds          , Ds          , Qxu         , Rr          , Rr          , Qxu         , Zw          , Zw          , Uu          , Qxu         , Rd          , Rd          , Ds          , Ce          , Ce          , Ce          , Ce          , Qxu         , Qxu         , Qxu         , Qxu         , Xu          , Xu          , Xu          
Re          , Re          , Uh          , Uu          , Uu^Ii       , Uu^Ii       , Uu          , Uu^Uf       , Ds          , Ds          , Uu          , Uu          , Rr          , Uu          , Qxu         , Zw          , Uu          , Qxu         , Uu          , Qxu         , Ds          , Ds          , Ce          , 3 Ke        , Ce          , Qxu         , Qxu         , Qxu         , Qxu         , Xu          , Xu          , Xu          
Re          , Dd^Dr       , Uh          , Uu          , Uu          , Uu^Ii       , Uh          , Rd          , Ds          , Uu^Uf       , Uu          , Uh          , Rr          , Uu^Ii       , Uu^Ii       , Uu          , Rd          , Qxu         , Qxu         , Uu          , Uu          , Ce          , Rr          , Ce          , Uu          , Qxu         , Qxu         , Qxu         , Qxu         , Qxu         , Xu          , Xu          
Uh          , Uu^Ii       , Uu          , Uu          , Uu          , Uu^Ii       , Uu^Uf       , Re          , Re          , Uu^Uf       , Uu^Uf       , Uu^Ii       , Uu          , Rr          , Uu^Ii       , Uu^Uf       , Rd          , Qxu         , Qxu         , Uu          , Uu          , Re          , Uu          , Rr          , Uu          , Qxu         , Uu          , Qxu         , Qxu         , Qxu         , Qxu         , Uu^Uf       
Xu          , Xu          , Uu          , Uu          , Uu          , Uu          , Uu^Uf       , Re          , Re          , Uu          , Uu          , Uu          , Uu^Ii       , Rr          , Rr          , Uu          , Uu          , Qxu         , Qxu         , Qxu         , Qxu         , Qxu         , Qxu         , Uu          , Uu          , Uu          , Uu          , Uu          , Qxu         , Qxu         , Qxu         , Qxu         
