Xu, Xu, Xu, Xu, Xu, Xu, Xu, Xu, Wog, Wog, Wog, Xu, Xu, Xu, Xu, Xu, Xu, Xu, Xu, Uu, Uh, Qxu, Qxu, Qxu, Uhe, Uhe, Xu, Xu, Xu, Uhe, Uhe, Uue, Uhe, Rr, Rr, Re^Edb, Re^Em, Qxu, Qxu, Qxu, Uu^Uf, Re, Re, Uh, Rd, Uu, Uu, Uu^Uf, Uu^Uf, Uh, Uu, Uue^Edt
Xu, Xu, Xu, Xu, Xu, Xu, Xu, Xu, Wog, Wog, Wog^Es, Xu, Xu, Xu, Xu, Xu, Xu, Xu, Xu, Xu, Xu, Uh, Uh, Uh, Uhe, Uhe, Uhe, Xu, Xu, Uhe, Uue^Dr, Uue, Uhe, Uhe, Uu^Uf, Rr, Rr, Re^Uf, Uu, Uu^Em, Uu^Uf, Uu, Rd, Re, Qxu, Uu^Uf, Uu, Uu, Uu, Uu, Uu, Uue^Edt
Xu, Xu, Xu^Zok, Xu, Xu, Xu, Xu, Xu, Xu, Wog^Es, Wog^Es, Xu, Xu, Xu, Xu, Xu, Xu, Xu, Xu, Xu, Xu, Uh, Uh, Uh, Xu, Uhe, Uh, Xu, Qxu, Uhe, Re^Uf, Re, Uu^Uf, Uhe, Uu^Vud, Re, Rr^Edt, Re, Uu^Dr, Uu, Uu, Uu^Em, Uu^Uf, Rd, Qxu, Qxu, Qxu, Uu^Dr, Uu, Uu, Xu, Xu
Xu^Zok, Xu^Zok, Xu^Zok, Xu^Zok, Xu^Zok, Xu, Xuc, Xu, Xu, Xu, Sm^Es, Wog^Es, Xuc, Xu, Xu, Xu, Xu, Xu, Xu, Xu, Xu, Xu, Xu, Xu, Xu, Xu, Uh, Qxu, Rr^Edb, Re^Edb, Re^Em, Re^Uf, Rr^Emf, Uu^Uf, Re^Em, Re^Edt, Re, Rr, Re^Edb, Uu, Uu, Uu^Edb, Rd^Edb, Rd, Uu^Dr, Qxu, Qxu, Re, Uu^Dr, Uh, Xu, Xu
Xu, Xu^Zok, Xu^Zok, Ur^Zok, Ur^Br\, Xuc, Uu, Xuc, Wwf^Es, Sm, Wog^Es, Wog^Es, Sm, Xuc, Uu^Uf, Xu, Xu, Xu, Uh, Xuc, Xuc, Xu, Xuc, Xuc, Xuc, Xu, Uh, Qxu, Qxu, Uu^Uf, Uu, Re^Edb, Uu^Ufi, Re^Uf, Re^Edt, Re^Es, Re, Rr, Re, Qxu, Qxu, Uu^Edb, Uu^Uf, Uu, Uu, Qxu, Uh, Uh, Xu, Uu, Uh, Uh
Xu, Xu, Xu, Xu, Xuc, Ur^Br\, Ur^Br\, Uu, Wwf^Edt, Sm, Wwg, Wwg, Wwg, Wwf^Edt, Sm, Uu^Uf, Xuc, Xuc, Uh, Uh, Cud, Cud, Uu, Uu, Uu, Xuc, Uu^Ii, Uh, Qxu, Uu, Uh, Uu^Ii, Uu^Ii, Uu^Dr, Re, Re, Rr^Edt, Rr^Edt, Uu, Qxu, Qxu, Uu, Qxu, Uu, Uu, Uh, Uh, Uh, Uh, Uu^Dr, Uh, Xu
Xu, Xu, Xu, Xu, Xuc, Uh, Uu, Sm, Sm, Wwg, Cud, Cud, Cud, Wwg, Wwf^Vud, Uu, Xu, Xu, Uu^Uf, Uu, Re^Edt, Cud, Re^Edt, Re, Rr^Edb, Rr^Edb, Xu, Rr, Uu, Qxu, Uu^Uf, Uu, Uu, Uu, Uu, Re, Rr, Uu^Vud, Uu, Uu, Uu, Qxu, Qxu, Qxu, Rr, Uh, Xu, Xu, Xu, Xu, Xu, Xu
Xu, Xu, Xu, Xu, Xu, Xuc, Cud, Wwf, Wwf^Edt, Wwf, Cud, 4 Kud, Cud, Wwf, Sm, Wwf, Uu, Uh, Uu^Uf, Uu^Uf, Rr, Rr^Edt, Cud, Uu, Re, Ur^Edb, Ur, Ur^Edb, Re^Edb, Qxu, Uu^Uf, Uh^Ii, Uu^Ufi, Uu, Rd^Ii, Rd, Rr^Edt, Rd, Uu, Re^Uf, Uu, Qxu, Qxu, Qxu, Rr, Uu, Uh, Xu, Xu, Xu, Xu, Xu
Uh, Xu, Xu, Xu, Xu, Xu, Wwf, Sm, Sm, Wwf^Edt, Sm, Cud, Wwf^Edt, Sm, Uu^Dr, Uu^Ii, Uu, Uu, Uu, Rr, Uu, Uu, Uu, Rd^Edt, Ur, Ur, Ur^Edt, Ur^Edb, Re^Edb, Uu, Uu^Uf, Uu^Uf, Uu^Uf, Uu^Uf, Cud, Cud, Rr, Cud, Cud, Uu, Re^Uf, Uu, Re^Uf, Qxu, Qxu, Uu, Xu, Xu, Xu, Xu, Xu, Xu
Uu, Uh, Xu, Xuc, Xuc, Xu, Cud, Wwf, Uu, Sm^Vud, Sm, Sm, Wwf, Wwf, Uu^Edb, Uu, Rr, Rr, Uu^Uf, Uu, Xu, Xu, Uu, Ur, Ur^Edt, Xu, Uu^Edt, Ur^Edt, Uu, Rr, Rr, Uu, Cud, Cud, Uu^Vud, Rb^Edt, Rb^Dr, Rb, Uu^Vud, Cud, Cud, Re^Uf, Rr, Rr, Qxu, Uu, Uh, Uh, Xu, Xu, Xu, Xu
Rr, Uu, Uu, Uh, Uh, Xu, Cud, Uu, Wwf, Uu^Ii, Uu^Vud, Wwf, Uu^Ii, Uu^Edb, Re^Edb, Re, Cud, Uu, Uh, Uh^Emf, Xu, Xuc, Uh, Uu^Edt, Uh, Uh, Uu^Vu, Uu, Uu, Uh, Uh, Rr, Rr, Rb, Rb^Edb, Rb^Edb, Cud, Rb^Edt, Rb^Edt, Rb, Rr, Rr, Uu^Vud, Uu, Uu, Uh, Qxu, Xu, Xu, Xu, Xu, Xu
Uu, Rr, Uu, Uu^Vu, Uh, Uh, Uu^Uf, Cud, Cud, Uu^Ii, Uu, Re, Rr, Uu, Uu^Dr, Wwf, Cud, Cud, Uu, Uu^Emf, Uh, Uu^Emf, Uu, Uu, Xu, Uh, Uu, Uu, Uu^Uf, Uu^Uf, Cud, Cud, Rb^Edb, Rb, Cud, Cud, Rrc^Cov, Cud, Cud, Rb^Dr, Rb, Cud, Cud, Uu, Uh, Uh, Qxu, Xu, Xu, Xu, Xu, Xu
Uu, Re, Rr, Uu, Uu, Uu, Uu^Em, Uh, Uu, Uu, Re, Re, Uu^Uf, Uu^Ii, Uu, Uu, Uh, Uh, Uh, Uu^Em, Xuc, Uu^Emf, Uu^Emf, Uh, Xu, Xu, Uu, Uu, Uh, Uu^Vu, Cud, Uu^Vud, Rb^Edb, Rb^Edb, Cud, Rrc^Cov, 1 Urb^Kov, Rrc^Cov, Cud, Rb^Edt, Rb^Edt, Uu^Vud, Cud, Uu, Uh, Qxu, Xu, Xu, Xu, Xu, Xu, Xu
Xu, Uu^Ii, Uu, Rr, Re^Edb, Uu^Vu, Uu, Uu, Rr^Edb, Uu, Uu, Uu, Uu^Ufi, Uh^Ii, Uh, Uu, Xuc, Xu, Xu, Uu, Uh, Uh, Uh, Uh, Uh, Uh, Xu, Uh^Ii, Uh, Uu, Cud, Uu^Uf, Rb^Edb, Rb^Edb, Cud, Rrc^Cov, Rrc^Cov, Rrc^Cov, Cud, Rb^Edt, Rb^Edt, Uu, Cud, Uu, Uh, Xu, Xu, Xu, Xu, Xu, Xu, Xu
Xu, Uu, Uh^Ii, Uu, Uu^Edb, Rr^Edb, Re, Rr, Re^Edb, Uu^Edb, Uu^Edb, Cud, Uu, Uu^Vu, Uh, Uu, Xuc, Xu, Xu, Uh, Re, Re, Re^Em, Uu^Uf, Re^Em, Uh, Xu, Xu, Uh, Uu, Uh, Cud, Rr, Rb^Dr, Rb, Cud, Cud, Cud, Rb, Rb^Dr, Rr, Cud, Uu, Uu^Dr, Qxu, Xu, Qxu, Xu, Xu, Xu, Xu, Xu
Xu, Xuc, Uh, Uu^Ii, Uu, Rr^Edb, Uu, Uu^Edb, Uu^Edb, Uu^Dr, Uu^Em, Cud, Cud, Uu, Uu^Uf, Uh, Xu, Xu, Xu, Uh, Uh, Re, Uu, Rd, Uu^Uf, Uh, Uh, Uh, Rd, Uu, Rr, Rr, Qxu, Rb, Uh, Rb, Rb^Edt, Rb^Edt, Uu^Vud, Rb, Uh, Rr, Rr, Rr, Uh, Qxu, Xu, Xu, Xu, Xu, Xu, Xu
Xu, Xuc, Xuc, Uh, Xu, Uu, Uh, Uu, Xuc, Uu^Uf, Xu, Xuc, Xuc, Xuc, Xu, Xu, Xu, Xu, Xu, Xu, Xu, Uh, Xu, Xu, Uu, Uu, Uu^Vud, Re, Rr, Rr, Uu^Vu, Qxu, Qxu, Qxu, Uh, Rb, Rr^Edt, Rb^Edt, Uh, Uh, Uu, Uu, Rr, Uh, Qxu, Uh, Xu, Xu, Xu, Xu, Xu, Xu
Xu, Xu, Xu, Xu, Xu, Xu, Xu, Xuc, Xu, Xu, Xu, Xu, Xu, Xu, Xu, Xu, Xu, Xu, Xuc, Xuc, Uh, Uh, Uh, Uh, Re, Rd^Edt, Rr, Re, Uu, Uu, Uu^Uf, Qxu, Qxu, Qxu, Qxu, Uh, Rr, Uh, Uh, Uh, Qxu, Uu, Rr, Uu^Dr, Xu, Qxu, Xu, Xu, Xu, Xu, Xu, Xu
Xu, Xu, Xu, Xu, Xu, Xu, Xu, Xu, Uu^Uf, Xu, Uu, Xu, Xu, Xu, Xu, Xu, Xu, Xuc, Xuc, Uh, Uh, Uh, Uh, Uh, Re, Rr, Uu^Dr, Xu, Uu^Ii, Uu^Uf, Uu, Uh, Uh, Qxu, Uh, Uh, Rr, Uh, Uu^Uf, Qxu, Qxu, Re, Rr^Ii, Uu, Qxu, Xu, Xu, Xu, Xu, Xu, Xu, Xu
Xu, Xu, Xu, Xu, Xu, Xu, Xuc, Uh, Uu, Qxv, Uu, Uh, Xu, Xuc, Xuc, Xu, Uh, Uh, Uu, Uu^Uf, Uu, Uu, Rr, Re^Edt, Rd, Uu, Uu, Uu, Xu, Uu, Uu, Uh, Uh, Uh, Rr, Rd, Uu, Uu, Uu, Qxu, Qxu, Qxu, Rr^Edb, Qxu, Qxu, Uu, Uu, Xu, Xu, Xu, Xu, Xu
Xu, Xu, Xu, Xu, Xu, Xuc, Uh, Uh, Uu^Vud, Uu^Em, Ur, Uu, Uu^Uf, Uh, Uh, Xu, Uh, Uh, Uu^Uf, Uu, Rr, Rr, Re^Edt, Re^Em, Uu, Uu, Xu, Uu, Xu, Xu, Uu^Uf, Uu, Re, Rr, Rr, Qxu, Uu^Uf, Uu, Uh, Uu^Dr, Rd, Rd^Edb, Re^Edb, Uu, Uu^Vu, Uu, Qxu, Qxu, Qxu, Qxu, Qxu, Xu
Xu, Xu, Xu, Xu, Uu, Uu, Uh, Uu^Em, Uu, Ur^Em, Uu, Ur, Uu, Uu, Uu, Xu, Uh, Uu^Uf, Uu^Uf, Uh, Rd, Rd^Edt, Re, Re^Em, Uh, Xu, Xu, Uu, Uu, Uu^Uf, Rd, Re, Uu, Uu, Rr, Uu, Uu^Vud, Uu, Uh, Uh, Uu, Uu, Uh, Re, Rr, Uu, Uu, Qxu, Qxu, Qxu, Qxu, Xu
Xu, Xu, Xu, Xu, Uu, Uu, Uu^Uf, Uu, Uu, Xu, Uu, Uu, 2 Uu, Ur, Ur, Xu, Uh, Uh, Uh, Uu^Uf, Uu, Uu^Edt, Re, Uu^Vud, Uh, Uu, Uu, Uu, Uh, Rd, Uu^Edt, Uu^Edt, Uu, Uh, Rr, Uu^Ii, Uu, Uu, Xu, Xu, Uu^Vud, Uu, Uu, Uh, Rr, Uu^Ii, Uu, Qxu, Uu^Uf, Qxu, Qxu, Qxu
Xu, Xu, Xu, Xu, Xuc, Uu^Uf, Uu^Uf, Uu, Uu, Uu, Ur, Uu, Ur, Ur, Uu, Xu, Xu, Uh, Xu, Uu^Uf, Uh, Uh, Uh, Uu, Uu, Uu^Uf, Uu^Uf, Uu^Ii, Uu^Edt, Re^Edt, Re^Edt, Uu^Edt, Uu^Uf, Uu^Ii, Uu, Rr, Uu^Ii, Uu^Uf, Xuc, Xu, Uu, Uu, Qxu, Re, Re, Rr, Qxu, Uu^Uf, Uu^Ii, Qxu, Qxu, Qxu
Xu, Xu, Xu, Xu, Xu, Xuc, Uu, Ur, Uu, Ur, Uu, Uu, Ur, Uu, Xu, Xu, Xu, Xu, Xu, Xu, Xu, Xu, Xuc, Xu, Uu, Uu, Uu^Edb, Uu, Uu^Edt, Re^Edt, Re^Edt, Uu, Uu, Uu, Uu, Rr, Rr, Uu, Uu, Xuc, Uu^Uf, Uu, Qxu, Qxu, Qxu, Qxu, Qxu, Uu, Uu, Qxu, Qxu, Qxu
Xu, Xu, Xu, Xu, Xuc, Uu^Uf, Ur, Ur, Uu, Qxv, Uu, Xu, Uu, Uu, Xu, Xu, Xu, Xu, Xu, Xu, Xuc, Xuc, Uh, Uu^Dr, Uu^Edb, Uu^Uf, Uu^Edb, Uu^Edb, Re, Re^Edt, Uu, Uu, Uu, Qxu, Uu^Ii, Uh, Uu, Rr, Rr, Uu^Emf, Uu^Uf, Rd, Re, Qxu, Qxu, Qxu, Rr^Ii, Qxu, Qxu, Qxu, Qxu, Qxu
Qxv, Xu, Xu, Xu, Uu, Uu, Uu, Uu, Qxv, Qxv, Xu, Uu, Xu, Xu, Xu, Xu, Xu, Xu, Xu, Xu, Xuc, Uh, Uh, Uu^Edb, Cer^Edb, Re^Uf, Uu^Edb, Uu^Vu, Re^Edb, Uu, Xuc, Uu, Xu, Uu, Uu^Uf, Uu^Uf, Uu^Ii, Uu^Ii, Rr, Uu^Dr, Uu^Emf, Uu, Qxu, Qxu, Qxu, Qxu, Rr, Qxu, Rd, Uu, Uu^Ii, Uu^Edt
Qxv, Qxv, Xuc, Xu, Qxv, Qxv, Qxv^Bcx|, Qxv, Qxv, Xu, Xu, Xu, Xu, Xu, Xu, Xu, Xu, Xu, Xu, Xu, Xu, Uh, Uu^Edb, Cer^Edb, 3 Ker, Cer^Edb, Uu^Uf, Re^Edb, Uu, Uu, Xuc, Xu, Xu, Xu, Xu, Uu^Uf, Qxu, Qxu, Qxu, Rr, Rr, Uu^Uf, Qxu, Re, Rr^Ii, Qxu, Qxu, Qxu, Rr^Edt, Uu^Vud, Rr^Edt, Rr^Edt
Uu^Uf, Qxv, Qxv, Qxv, Qxv, Qxv, Ur, Qxv, Xu, Xu, Xu, Xu, Xu, Xu, Xuc, Xu, Xu, Xu, Xu, Xuc, Uh, Uu^Vu, Uu^Edb, Cer^Edb, Cer^Edb, Cer^Edb, Uu, Uu^Dr, Uu, Uu^Ii, Xu, Xu, Xu, Xu, Xu, Qxu, Qxu, Qxu, Qxu, Qxu, Qxu, Rr, Qxu, Rr^Ii, Qxu, Qxu, Qxu, Qxu, Qxu, Rr, Rr^Edt, Rr^Edt
Uu, Qxv, Qxv, Qxv, Uu^Vu, Uu, Ur, Uu, Xuc, Xu, Xuc, Xuc, Xuc, Xu, Uu^Uf, Xuc, Xuc, Xu, Xu, Xuc, Xu, Uh, Uu^Uf, Uu^Uf, Rd^Edb, Rd^Edb, Re^Edb, Re^Edb, Uu^Uf, Uu^Ii, Xu, Xu, Xu, Xu, Xu, Qxu, Qxu, Qxu, Qxu, Qxu, Qxu, Qxu, Rr, Re^Ii, Qxu, Qxu, Xu, Qxu, Qxu, Uh, Rr^Edt, Rr
Ur, Uu, Uu, Uu, Uu, Ur, Uu, Uu, Xu, Xu, Uu^Uf, Uu^Uf, Uu, Uu^Uf, Uu^Emf, Uu^Emf, Xuc, Xu, Xu, Xu, Xu, Uu^Emf, Uu^Uf, Uh, Uu, Re, Uu^Ii, Uu, Uh, Xu, Xu, Xu, Xu, Xu, Xu, Xu, Uh, Uh, Uu^Ii, Uu, Re^Edt, Qxu, Qxu, Qxu, Qxu, Qxu, Xu, Xu, Qxu, Qxu, Uu, Rr
Uu^Uf, Ur, Uu, Ur, Uu, Uu, Uu^Uf, Uu^Uf, Xu, Xuc, Uu^Emf, Uu^Vu, Ur^Ii, Uu^Vu, Uu, Uu^Uf, Uu^Uf, Xuc, Xu, Xu, Xu, Xu, Uu, Uu, Re^Ii, Re^Ii, Uu, Uh, Xu, Xu, Xu, Xu, Xu, Xu, Xu, Xu, Xuc, Uu, Uue^Uf, Re, Re, Uu^Ii, Uu^Ii, Qxu, Qxu, Xu, Xuc, Xuc, Xu, Qxu, Qxu, Uh
Xu, Uu, Xu, Uu, Xuc, Xuc, Xu, Xu, Xu, Xuc, Xuc, Uu^Vu, Uu^Em, Ur, Ur, Uu^Emf, Uu^Vud, Uu^Emf, Cud, Xu, Uu^Uf, Uu^Uf, Uu, Re, Rr^Ii, Re^Ii, Uu, Uu, Cud, Xu, Xu, Xu, Qxu, Qxu, Qxu, Qxu, Uue, Uue^Uf, Uue^Uf, Rr^Edt, Uu^Edt, Uu, Qxu, Qxu, Qxu, Qxu, Uh, Uh, Uu, Qxu, Uh, Uu
Xu, Xu, Xu, Xuc, Xu, Xu, Xu, Xu, Xuc, Xuc, Uu, Uu^Uf, Ur, Uu^Uf, Uu^Uf, Ur^Em, Ur, Uu, Cud, Uu, Re^Ii, Re, Rr, Rr^Edb, Uu^Dr, Uu, Cud, Cud, Xu, Xu, Xu, Xu, Xu, Qxu, Qxu, Qxe, Qxe, Uue^Uf, Re^Em, Rr^Edt, Uu, Qxu, Qxu, Qxu, Qxe, Qxe, Uue^Uf, Uu^Uf, Uu, Uh, Ur, Uu
Xu, Xu, Xu, Xu, Xu, Xu, Xu^Zok, Xu, Xu, Uu, Ur^Br/, Ur^Br/, Uu^Emf, Uu^Uf, Xuc, Uu^Emf, Cud, Kud, Uu^Edb, Uu^Edb, Re^Edb, Re, Rr^Edb, Rr^Edb, Rr, Uu, Uu, Xu, Xu, Xu, Uh, Xu, Xu, Qxu, Qxu, Qxu, Qxe, Uue, Re^Edb, Rr^Edb, Uu^Edb, Qxu, Qxu, Qxu, Qxe, Uue, Uue^Emf, Uu^Uf, Ur, Ur, Uu, Uu
Xu, Xu, Xu, Xu, Xu, Xu^Zok, Xu^Zok, Xu^Zok, Xu^Zok, Ur^Br|, Uu, Uu, Xuc, Xuc, Xu, Cud, Uh, Uu, Re^Edb, Re^Edb, Rr^Edb, Rr, Re^Edb, Re^Edb, Uu^Uf, Rr^Edb, Re^Edb, Uu^Ii, Uu, Uu, Uu, Uh, Uu, Uu, Qxu, Qxu, Qxu, Qxe, Uu, Rr^Edb, Rr, Cud, Uu, Qxu, Qxe, Uue, Uue, Uu, Ur, Uu^Vu, Uu^Uf, Xu
Xu, Xu, Xu, Xu, Xu, Xu, Xu, Xu^Zok, Xu^Zok, Ur^Zok, Xu^Zok, Xu, Xu, Xu, Xu, Uu, Uu, Uu^Uf, Uu^Uf, Re^Dr, Rr^Edb, Rr^Edb, Re^Dr, Re^Uf, Cud, Uu^Edb, Uu, Re, Rr^Edt, Ur^Edt, Ur, Uu^Vud, Uue, Cud, Cud, Qxu, Qxu, Qxu, Cud, Ur, Rr, Uu, Uu, Uu, Uu, Uhe, Uu^Vu, Ur, Uu, Uu, Xu, Xu
Xu, Xu, Xu, Xu, Xu, Xu, Xu, Xu, Xu, Xu^Zok, Xu, Xu, Xu, Xu, Xu, Uh, Uh, Re^Edb, Uu^Uf, Rr, Uu^Ii, Re^Edb, Uu^Em, Cud, Xu, Xu, Xu, Uu, Uu^Edt, Ur^Edt, Uu, Rr^Edt, Rr, Uue, Uue, Qxu, Qxu, Qxu, Uu^Edb, Uu, Rr, Rr, Ur, Ur, Ur, Uu, Ur, Ur, Uu^Uf, Xu, Xu, Xu
Xu, Xu, Xu, Xu, Xu, Xu, Xu, Xu, Xu, Xu, Xu, Xu, Xu, Xu, Xu, Xu, Uu, Uu, Re^Edb, Rr^Edb, Uu^Ii, Uh, Uu, Cud, Xu, Xu, Xu, Uu, Qxu, Uu, Cud, Uu, Uue, Re^Edt, Rr, Uu, Ur, Uu^Edb, Rr^Edb, Rr, Uu^Vud, Uu, Uu^Emf, Uu, Uu, Ur, Uu^Uf, Uu, Uu, Xu, Xu, Xu
Xu, Xu, Xu, Xu, Xu, Xu, Xu, Xu, Xu, Xu, Xu, Xu, Xu, Xu, Uh, Uh, Xu, Uu, Rr^Edb, Rr^Ii, Uu^Ufi, Uu, Uh, Xu, Xu, Xu, Xu, Xu, Qxu, Qxu, Qxe, Cud, Qxe, Uue, Uue, Rr, Uu, Rr, Rr, Rr^Edt, Re^Edt, Uue^Uf, Qxe, Qxu, Qxu, Uh, Uu^Uf, Xu, Xu, Xu, Xu, Xu
Xu, Xu, Xu, Xu, Xu, Xu, Xu, Xu, Xu, Xu, Xu, Xu, Xu, Uu, Uu, Uu, Uh, Uu, Rr, Re^Ii, Uu, Xu, Uu, Xu, Xu, Xu, Xu, Xu, Xu, Qxu, Qxu, Qxe, Qxu, Qxe, Qxe, Uu, Qxu, Uu, Uu, Rr^Edt, Rr, Uue^Em, Uue^Emf, Qxe, Qxu, Qxu, Qxu, Xu, Xu, Xu, Xu, Xu
Xu, Xu, Xu, Xu, Xu, Xu, Xu, Xu, Xu, Xu, Xu, Xu, Uu, Uu, Uu, Uu, Uu, Rr, Uu, Uu, Uu, Uu, Uu, Xu, Xu, Xu, Xu, Xu, Xu, Qxu, Qxu, Qxe, Qxu, Qxe, Qxu, Qxu, Qxu, Qxu, Qxu, Uu, Rr, Rr, Uu, Qxe, Qxu, Qxu, Qxu, Xu, Xu, Xu, Xu, Xu
