Xu, Xu, Xu, Xu, Xu, Xu, Xu, Xu, Wog, Wog, Wog, Xu, Xu, Xu, Xu, Xu, Xu, Xu, Xu, Uu, Uh, Qxu, Qxu, Qxu, Uhe, Uhe, Xu, Xu, Xu, Uhe, Uhe, Uue, Uhe, Rr, Rr, Re^Edb, Re^Em, Qxu, Qxu, Qxu, Tb^Tf, Re, Re, Uh, Rd, Uu, Uu, Uu^Tf, Tb^Tf, Uh, Uu, Uue^Edt
Xu, Xu, Xu, Xu, Xu, Xu, Xu, Xu, Wog, Wog, Wog^Es, Xu, Xu, Xu, Xu, Xu, Xu, Xu, Xu, Xu, Xu, Uh, Uh, Uh, Uhe, Uhe, Uhe, Xu, Xu, Uhe, Uue^Dr, Uue, Uhe, Uhe, Uu^Tf, Rr, Rr, Re^Tf, Uu, Uu^Em, Uu^Tf, Uu, Rd, Re, Qxu, Uu^Tf, Uu, Uu, Uu, Uu, Uu, Uue^Edt
Xu, Xu, Xu^Zok, Xu, Xu, Xu, Xu, Xu, Xu, Wog^Es, Wog^Es, Xu, Xu, Xu, Xu, Xu, Xu, Xu, Xu, Xu, Xu, Uh, Uh, Uh, Xu, Uhe, Uh, Xu, Qxu, Uhe, Re^Tf, Re, Uu^Tf, Uhe, Uu^Vud, Re, Rr^Edt, Re, Uu^Dr, Uu, Uu, Uu^Em, Tb^Tf, Rd, Qxu, Qxu, Qxu, Uu^Dr, Uu, Uu, Xu, Xu
Xu^Zok, Xu^Zok, Xu^Zok, Xu^Zok, Xu^Zok, Xu, Xuc, Xu, Xu, Xu, Sm^Es, Wog^Es, Xuc, Xu, Xu, Xu, Xu, Xu, Xu, Xu, Xu, Xu, Xu, Xu, Xu, Xu, Uh, Qxu, Rr^Edb, Re^Edb, Re^Em, Re^Tf, Rr^Emf, Tb^Tf, Re^Em, Re^Edt, Re, Rr, Re^Edb, Uu, Uu, Uu^Edb, Rd^Edb, Rd, Uu^Dr, Qxu, Qxu, Re, Uu^Dr, Uh, Xu, Xu
Xu, Xu^Zok, Xu^Zok, Ur^Zok, Ur^Br\, Xuc, Uu, Xuc, Wwf^Es, Sm, Wog^Es, Wog^Es, Sm, Xuc, Tb^Tf, Xu, Xu, Xu, Uh, Xuc, Xuc, Xu, Xuc, Xuc, Xuc, Xu, Uh, Qxu, Qxu, Uu^Tf, Uu, Re^Edb, Tb^Tfi, Re^Tf, Re^Edt, Re^Es, Re, Rr, Re, Qxu, Qxu, Uu^Edb, Uu^Tf, Uu, Uu, Qxu, Uh, Uh, Xu, Uu, Uh, Uh
Xu, Xu, Xu, Xu, Xuc, Ur^Br\, Ur^Br\, Uu, Wwf^Edt, Sm, Wwg, Wwg, Wwg, Wwf^Edt, Sm^Em, Tb^Tf, Xuc, Xuc, Uh, Uh, Cud, Cud, Uu, Uu, Uu, Xuc, Uu^Ii, Uh, Qxu, Uu, Uh, Uu^Ii, Uu^Ii, Uu^Dr, Re, Re, Rr^Edt, Rr^Edt, Uu, Qxu, Qxu, Uu, Qxu, Uu, Uu, Uh, Uh, Uh, Uh, Uu^Dr, Uh, Xu
Xu, Xu, Xu, Xu, Xuc, Uh, Uu, Sm, Sm, Wwg, Cud, Cud, Cud, Wwg, Wwf^Vud, Uu^Em, Xu, Xu, Uu^Tf, Uu, Re^Edt, Cud, Re^Edt, Re, Rr^Edb, Rr^Edb, Xu, Rr, Uu, Qxu, Uu^Tf, Uu, Uu, Uu, Uu, Re, Rr, Uu^Vud, Uu, Uu, Uu, Qxu, Qxu, Qxu, Rr, Uh, Xu, Xu, Xu, Xu, Xu, Xu
Xu, Xu, Xu, Xu, Xu, Xuc, Cud, Wwf, Wwf^Edt, Wwf, Cud, 4 Kud, Cud, Wwf, Sm, Wwf, Uu, Uh, Tb^Tf, Tb^Tf, Rr, Rr^Edt, Cud, Uu, Re, Ur^Edb, Ur, Ur^Edb, Re^Edb, Qxu, Tb^Tf, Uh^Ii, Uu^Tfi, Uu, Rd^Ii, Rd, Rr^Edt, Rd, Uu, Re^Tf, Uu, Qxu, Qxu, Qxu, Rr, Uu, Uh, Xu, Xu, Xu, Xu, Xu
Uh, Xu, Xu, Xu, Xu, Xu, Wwf, Sm, Sm, Wwf^Edt, Sm, Cud, Wwf^Edt, Sm, Uu^Dr, Uu^Ii, Uu, Uu, Uu, Rr, Uu, Uu, Uu, Rd^Edt, Ur, Ur, Ur^Edt, Ur^Edb, Re^Edb, Uu, Tb^Tf, Tb^Tf, Uu^Tf, Uu^Tf, Cud, Cud, Rr, Cud, Cud, Uu, Re^Tf, Uu, Re^Tf, Qxu, Qxu, Uu, Xu, Xu, Xu, Xu, Xu, Xu
Uu, Uh, Xu, Xuc, Xuc, Xu, Cud, Wwf, Uu, Sm^Vud, Sm, Sm, Wwf, Wwf, Uu^Edb, Uu, Rr, Rr, Tb^Tf, Uu, Xu, Xu, Uu, Ur, Ur^Edt, Xu, Uu^Edt, Ur^Edt, Uu, Rr, Rr, Uu, Cud, Cud, Uu^Vud, Rb^Edt, Rb^Dr, Rb, Uu^Vud, Cud, Cud, Re^Tf, Rr, Rr, Qxu, Uu, Uh, Uh, Xu, Xu, Xu, Xu
Rr, Uu, Uu, Uh, Uh, Xu, Cud, Uu, Wwf, Uu^Ii, Uu^Vud, Wwf, Uu^Ii, Uu^Edb, Re^Edb, Re, Cud, Uu, Uh, Tb^Emf, Xu, Xuc, Uh, Uu^Edt, Uh, Uh, Uu^Vu, Uu, Uu, Uh, Uh, Rr, Rr, Rb, Rb^Edb, Rb^Edb, Cud, Rb^Edt, Rb^Edt, Rb, Rr, Rr, Uu^Vud, Uu, Uu, Uh, Qxu, Xu, Xu, Xu, Xu, Xu
Uu, Rr, Uu, Uu^Vu, Uh, Uh, Uu^Tf, Cud, Cud, Uu^Ii, Uu, Re, Rr, Uu, Uu^Dr, Wwf, Cud, Cud, Uu, Uu^Emf, Uh, Tb^Emf, Uu, Uu, Xu, Uh, Uu, Uu, Uu^Tf, Tb^Tf, Cud, Cud, Rb^Edb, Rb, Cud, Cud, Rrc^Cov, Cud, Cud, Rb^Dr, Rb, Cud, Cud, Uu, Uh, Uh, Qxu, Xu, Xu, Xu, Xu, Xu
Uu, Re, Rr, Uu, Uu, Uu, Uu^Em, Uh, Uu, Uu, Re, Re, Tb^Tf, Uu^Ii, Uu, Uu, Uh, Uh, Uh, Uu^Em, Xuc, Tb^Emf, Uu^Emf, Uh, Xu, Xu, Uu, Uu, Uh, Uu^Vu, Cud, Uu^Vud, Rb^Edb, Rb^Edb, Cud, Rrc^Cov, 1 Urb^Kov, Rrc^Cov, Cud, Rb^Edt, Rb^Edt, Uu^Vud, Cud, Uu, Uh, Qxu, Xu, Xu, Xu, Xu, Xu, Xu
Xu, Uu^Ii, Uu, Rr, Re^Edb, Uu^Vu, Uu, Uu, Rr^Edb, Uu, Uu, Uu, Tb^Tfi, Uh^Ii, Uh, Uu, Xuc, Xu, Xu, Uu, Uh, Uh, Uh, Uh, Uh, Uh, Xu, Uh^Ii, Uh, Uu, Cud, Uu^Tf, Rb^Edb, Rb^Edb, Cud, Rrc^Cov, Rrc^Cov, Rrc^Cov, Cud, Rb^Edt, Rb^Edt, Uu, Cud, Uu, Uh, Xu, Xu, Xu, Xu, Xu, Xu, Xu
Xu, Uu, Uh^Ii, Uu, Uu^Edb, Rr^Edb, Re, Rr, Re^Edb, Uu^Edb, Uu^Edb, Cud, Uu, Uu^Vu, Uh, Uu, Xuc, Xu, Xu, Uh, Re, Re, Re^Em, Uu^Tf, Re^Em, Uh, Xu, Xu, Uh, Uu, Uh, Cud, Rr, Rb^Dr, Rb, Cud, Cud, Cud, Rb, Rb^Dr, Rr, Cud, Uu, Uu^Dr, Qxu, Xu, Qxu, Xu, Xu, Xu, Xu, Xu
Xu, Xuc, Uh, Uu^Ii, Uu, Rr^Edb, Uu, Uu^Edb, Uu^Edb, Uu^Dr, Uu^Em, Cud, Cud, Uu, Uu^Tf, Uh, Xu, Xu, Xu, Uh, Uh, Re, Uu, Rd, Uu^Tf, Uh, Uh, Uh, Rd, Uu, Rr, Rr, Qxu, Rb, Uh, Rb, Rb^Edt, Rb^Edt, Uu^Vud, Rb, Uh, Rr, Rr, Rr, Uh, Qxu, Xu, Xu, Xu, Xu, Xu, Xu
Xu, Xuc, Xuc, Uh, Xu, Uu, Uh, Uu, Xuc, Uu^Tf, Xu, Xuc, Xuc, Xuc, Xu, Xu, Xu, Xu, Xu, Xu, Xu, Uh, Xu, Xu, Uu, Uu, Uu^Vud, Re, Rr, Rr, Uu^Vu, Qxu, Qxu, Qxu, Uh, Rb, Rr^Edt, Rb^Edt, Uh, Uh, Uu, Uu, Rr, Uh, Qxu, Uh, Xu, Xu, Xu, Xu, Xu, Xu
Xu, Xu, Xu, Xu, Xu, Xu, Xu, Xuc, Xu, Xu, Xu, Xu, Xu, Xu, Xu, Xu, Xu, Xu, Xuc, Xuc, Uh, Uh, Uh, Uh, Re, Rd^Edt, Rr, Re, Uu, Uu, Uu^Tf, Qxu, Qxu, Qxu, Qxu, Uh, Rr, Uh, Uh, Uh, Qxu, Uu, Rr, Uu^Dr, Xu, Qxu, Xu, Xu, Xu, Xu, Xu, Xu
Xu, Xu, Xu, Xu, Xu, Xu, Xu, Xu, Uu^Tf, Xu, Uu, Xu, Xu, Xu, Xu, Xu, Xu, Xuc, Xuc, Uh, Uh, Uh, Uh, Uh, Re, Rr, Uu^Dr, Xu, Uu^Ii, Tb^Tf, Uu, Uh, Uh, Qxu, Uh, Uh, Rr, Uh, Uu^Tf, Qxu, Qxu, Re, Rr^Ii, Uu, Qxu, Xu, Xu, Xu, Xu, Xu, Xu, Xu
Xu, Xu, Xu, Xu, Xu, Xu, Xuc, Uh, Uu, Qxv, Uu, Uh, Xu, Xuc, Xuc, Xu, Uh, Uh, Uu, Uu^Tf, Uu, Uu, Rr, Re^Edt, Rd, Uu, Uu, Uu, Xu, Uu, Uu, Uh, Uh, Uh, Rr, Rd, Uu, Uu, Uu, Qxu, Qxu, Qxu, Rr^Edb, Qxu, Qxu, Uu, Uu, Xu, Xu, Xu, Xu, Xu
Xu, Xu, Xu, Xu, Xu, Xuc, Uh, Uh, Uu^Vud, Uu^Em, Ur, Uu, Uu^Tf, Uh, Uh, Xu, Uh, Uh, Tb^Tf, Uu, Rr, Rr, Re^Edt, Re^Em, Uu, Uu, Xu, Uu, Xu, Xu, Uu^Tf, Uu, Re, Rr, Rr, Qxu, Uu^Tf, Uu, Uh, Uu^Dr, Rd, Rd^Edb, Re^Edb, Uu, Uu^Vu, Uu, Qxu, Qxu, Qxu, Qxu, Qxu, Xu
Xu, Xu, Xu, Xu, Uu, Uu, Uh, Uu^Em, Uu, Ur^Em, Uu, Ur, Uu, Uu, Uu, Xu, Uh, Uu^Tf, Tb^Tf, Uh, Rd, Rd^Edt, Re, Re^Em, Uh, Xu, Xu, Uu, Uu, Uu^Tf, Rd, Re, Uu, Uu, Rr, Uu, Uu^Vud, Uu, Uh, Uh, Uu, Uu, Uh, Re, Rr, Uu, Uu, Qxu, Qxu, Qxu, Qxu, Xu
Xu, Xu, Xu, Xu, Uu, Uu, Uu^Tf, Uu, Uu, Xu, Uu, Uu, 2 Uu, Ur, Ur, Xu, Uh, Uh, Uh, Uu^Tf, Uu, Uu^Edt, Re, Uu^Vud, Uh, Uu, Uu, Uu, Uh, Rd, Uu^Edt, Uu^Edt, Uu, Uh, Rr, Uu^Ii, Uu, Uu, Xu, Xu, Uu^Vud, Uu, Uu, Uh, Rr, Uu^Ii, Uu, Qxu, Uu^Tf, Qxu, Qxu, Qxu
Xu, Xu, Xu, Xu, Xuc, Uu^Tf, Uu^Tf, Uu, Uu, Uu, Ur, Uu, Ur, Ur, Uu, Xu, Xu, Uh, Xu, Uu^Tf, Uh, Uh, Uh, Uu, Uu, Uu^Tf, Tb^Tf, Uu^Ii, Uu^Edt, Re^Edt, Re^Edt, Uu^Edt, Tb^Tf, Uu^Ii, Uu, Rr, Uu^Ii, Uu^Tf, Xuc, Xu, Uu, Uu, Qxu, Re, Re, Rr, Qxu, Uu^Tf, Uu^Ii, Qxu, Qxu, Qxu
Xu, Xu, Xu, Xu, Xu, Xuc, Uu, Ur, Uu, Ur, Uu, Uu, Ur, Uu, Xu, Xu, Xu, Xu, Xu, Xu, Xu, Xu, Xuc, Xu, Uu, Uu, Uu^Edb, Uu, Uu^Edt, Re^Edt, Re^Edt, Uu, Uu, Uu, Uu, Rr, Rr, Uu, Uu, Xuc, Tb^Tf, Uu, Qxu, Qxu, Qxu, Qxu, Qxu, Uu, Uu, Qxu, Qxu, Qxu
Xu, Xu, Xu, Xu, Xuc, Uu^Tf, Ur, Ur, Uu, Qxv, Uu, Xu, Uu, Uu, Xu, Xu, Xu, Xu, Xu, Xu, Xuc, Xuc, Uh, Uu^Dr, Uu^Edb, Tb^Tf, Uu^Edb, Uu^Edb, Re, Re^Edt, Uu, Uu, Uu, Qxu, Uu^Ii, Uh, Uu, Rr, Rr, Tb^Emf, Tb^Tf, Rd, Re, Qxu, Qxu, Qxu, Rr^Ii, Qxu, Qxu, Qxu, Qxu, Qxu
Qxv, Xu, Xu, Xu, Uu, Uu, Uu, Uu, Qxv, Qxv, Xu, Uu, Xu, Xu, Xu, Xu, Xu, Xu, Xu, Xu, Xuc, Uh, Uh, Uu^Edb, Cer^Edb, Re^Tf, Uu^Edb, Uu^Vu, Re^Edb, Uu, Xuc, Uu, Xu, Uu, Uu^Tf, Tb^Tf, Uu^Ii, Uu^Ii, Rr, Uu^Dr, Uu^Emf, Uu, Qxu, Qxu, Qxu, Qxu, Rr, Qxu, Rd, Uu, Uu^Ii, Uu^Edt
Qxv, Qxv, Xuc, Xu, Qxv, Qxv, Qxv^Bcx|, Qxv, Qxv, Xu, Xu, Xu, Xu, Xu, Xu, Xu, Xu, Xu, Xu, Xu, Xu, Uh, Uu^Edb, Cer^Edb, 3 Ker, Cer^Edb, Uu^Tf, Re^Edb, Uu, Uu, Xuc, Xu, Xu, Xu, Xu, Uu^Tf, Qxu, Qxu, Qxu, Rr, Rr, Uu^Tf, Qxu, Re, Rr^Ii, Qxu, Qxu, Qxu, Rr^Edt, Uu^Vud, Rr^Edt, Rr^Edt
Uu^Tf, Qxv, Qxv, Qxv, Qxv, Qxv, Ur, Qxv, Xu, Xu, Xu, Xu, Xu, Xu, Xuc, Xu, Xu, Xu, Xu, Xuc, Uh, Uu^Vu, Uu^Edb, Cer^Edb, Cer^Edb, Cer^Edb, Uu, Uu^Dr, Uu, Uu^Ii, Xu, Xu, Xu, Xu, Xu, Qxu, Qxu, Qxu, Qxu, Qxu, Qxu, Rr, Qxu, Rr^Ii, Qxu, Qxu, Qxu, Qxu, Qxu, Rr, Rr^Edt, Rr^Edt
Uu, Qxv, Qxv, Qxv, Uu^Vu, Uu, Ur, Uu, Xuc, Xu, Xuc, Xuc, Xuc, Xu, Tb^Tf, Xuc, Xuc, Xu, Xu, Xuc, Xu, Uh, Tb^Tf, Tb^Tf, Rd^Edb, Rd^Edb, Re^Edb, Re^Edb, Uu^Tf, Uu^Ii, Xu, Xu, Xu, Xu, Xu, Qxu, Qxu, Qxu, Qxu, Qxu, Qxu, Qxu, Rr, Re^Ii, Qxu, Qxu, Xu, Qxu, Qxu, Uh, Rr^Edt, Rr
Ur, Uu, Uu, Uu, Uu, Ur, Uu, Uu, Xu, Xu, Tb^Tf, Tb^Tf, Uu, Tb^Tf, Uu^Emf, Tb^Emf, Xuc, Xu, Xu, Xu, Xu, Uu^Emf, Uu^Tf, Uh, Uu, Re, Uu^Ii, Uu, Uh, Xu, Xu, Xu, Xu, Xu, Xu, Xu, Uh, Uh, Uu^Ii, Uu, Re^Edt, Qxu, Qxu, Qxu, Qxu, Qxu, Xu, Xu, Qxu, Qxu, Uu, Rr
Uu^Tf, Ur, Uu, Ur, Uu, Uu, Uu^Tf, Uu^Tf, Xu, Xuc, Tb^Emf, Tb^Vu, Ur^Ii, Uu^Vu, Uu, Tb^Tf, Tb^Tf, Xuc, Xu, Xu, Xu, Xu, Uu, Uu, Re^Ii, Re^Ii, Uu, Uh, Xu, Xu, Xu, Xu, Xu, Xu, Xu, Xu, Xuc, Uu, Uue^Tf, Re, Re, Uu^Ii, Uu^Ii, Qxu, Qxu, Xu, Xuc, Xuc, Xu, Qxu, Qxu, Uh
Xu, Uu, Xu, Uu, Xuc, Xuc, Xu, Xu, Xu, Xuc, Xuc, Uu^Vu, Uu^Em, Ur, Ur, Uu^Emf, Uu^Vud, Tb^Emf, Cud, Xu, Tb^Tf, Uu^Tf, Uu, Re, Rr^Ii, Re^Ii, Uu, Uu, Cud, Xu, Xu, Xu, Qxu, Qxu, Qxu, Qxu, Uue, Tb^Tf, Tb^Tf, Rr^Edt, Uu^Edt, Uu, Qxu, Qxu, Qxu, Qxu, Uh, Uh, Uu, Qxu, Uh, Uu
Xu, Xu, Xu, Xuc, Xu, Xu, Xu, Xu, Xuc, Xuc, Uu, Tb^Tf, Ur, Tb^Tf, Tb^Tf, Ur^Em, Ur, Uu, Cud, Uu, Re^Ii, Re, Rr, Rr^Edb, Uu^Dr, Uu, Cud, Cud, Xu, Xu, Xu, Xu, Xu, Qxu, Qxu, Qxe, Qxe, Uue^Tf, Re^Em, Rr^Edt, Uu, Qxu, Qxu, Qxu, Qxe, Qxe, Tb^Tf, Tb^Tf, Uu, Uh, Ur, Uu
Xu, Xu, Xu, Xu, Xu, Xu, Xu^Zok, Xu, Xu, Uu, Ur^Br/, Ur^Br/, Uu^Emf, Tb^Tf, Xuc, Uu^Emf, Cud, Kud, Uu^Edb, Uu^Edb, Re^Edb, Re, Rr^Edb, Rr^Edb, Rr, Uu, Uu, Xu, Xu, Xu, Uh, Xu, Xu, Qxu, Qxu, Qxu, Qxe, Uue, Re^Edb, Rr^Edb, Uu^Edb, Qxu, Qxu, Qxu, Qxe, Uue, Uue^Emf, Tb^Tf, Ur, Ur, Uu, Uu
Xu, Xu, Xu, Xu, Xu, Xu^Zok, Xu^Zok, Xu^Zok, Xu^Zok, Ur^Br|, Uu, Uu, Xuc, Xuc, Xu, Cud, Uh, Uu, Re^Edb, Re^Edb, Rr^Edb, Rr, Re^Edb, Re^Edb, Tb^Tf, Rr^Edb, Re^Edb, Uu^Ii, Uu, Uu, Uu, Uh, Uu, Uu, Qxu, Qxu, Qxu, Qxe, Uu, Rr^Edb, Rr, Cud, Uu, Qxu, Qxe, Uue, Uue, Uu, Ur, Uu^Vu, Tb^Tf, Xu
Xu, Xu, Xu, Xu, Xu, Xu, Xu, Xu^Zok, Xu^Zok, Ur^Zok, Xu^Zok, Xu, Xu, Xu, Xu, Uu, Uu, Tb^Tf, Tb^Tf, Re^Dr, Rr^Edb, Rr^Edb, Re^Dr, Re^Tf, Cud, Uu^Edb, Uu, Re, Rr^Edt, Ur^Edt, Ur, Uu^Vud, Uue, Cud, Cud, Qxu, Qxu, Qxu, Cud, Ur, Rr, Uu, Uu, Uu, Uu, Uhe, Uu^Vu, Ur, Uu, Uu, Xu, Xu
Xu, Xu, Xu, Xu, Xu, Xu, Xu, Xu, Xu, Xu^Zok, Xu, Xu, Xu, Xu, Xu, Uh, Uh, Re^Edb, Uu^Tf, Rr, Uu^Ii, Re^Edb, Uu^Em, Cud, Xu, Xu, Xu, Uu, Uu^Edt, Ur^Edt, Uu, Rr^Edt, Rr, Uue, Uue, Qxu, Qxu, Qxu, Uu^Edb, Uu, Rr, Rr, Ur, Ur, Ur, Uu, Ur, Ur, Tb^Tf, Xu, Xu, Xu
Xu, Xu, Xu, Xu, Xu, Xu, Xu, Xu, Xu, Xu, Xu, Xu, Xu, Xu, Xu, Xu, Uu, Uu, Re^Edb, Rr^Edb, Uu^Ii, Uh, Uu, Cud, Xu, Xu, Xu, Uu, Qxu, Uu, Cud, Uu, Uue, Re^Edt, Rr, Uu, Ur, Uu^Edb, Rr^Edb, Rr, Uu^Vud, Uu, Uu^Emf, Uu, Uu, Ur, Tb^Tf, Uu, Uu, Xu, Xu, Xu
Xu, Xu, Xu, Xu, Xu, Xu, Xu, Xu, Xu, Xu, Xu, Xu, Xu, Xu, Uh, Uh, Xu, Uu, Rr^Edb, Rr^Ii, Tb^Tfi, Uu, Uh, Xu, Xu, Xu, Xu, Xu, Qxu, Qxu, Qxe, Cud, Qxe, Uue, Uue, Rr, Uu, Rr, Rr, Rr^Edt, Re^Edt, Tb^Tf, Qxe, Qxu, Qxu, Uh, Tb^Tf, Xu, Xu, Xu, Xu, Xu
Xu, Xu, Xu, Xu, Xu, Xu, Xu, Xu, Xu, Xu, Xu, Xu, Xu, Uu, Uu, Uu, Uh, Uu, Rr, Re^Ii, Uu, Xu, Uu, Xu, Xu, Xu, Xu, Xu, Xu, Qxu, Qxu, Qxe, Qxu, Qxe, Qxe, Uu, Qxu, Uu, Uu, Rr^Edt, Rr, Uue^Em, Uue^Emf, Qxe, Qxu, Qxu, Qxu, Xu, Xu, Xu, Xu, Xu
Xu, Xu, Xu, Xu, Xu, Xu, Xu, Xu, Xu, Xu, Xu, Xu, Uu, Uu, Uu, Uu, Uu, Rr, Uu, Uu, Uu, Uu, Uu, Xu, Xu, Xu, Xu, Xu, Xu, Qxu, Qxu, Qxe, Qxu, Qxe, Qxu, Qxu, Qxu, Qxu, Qxu, Uu, Rr, Rr, Uu, Qxe, Qxu, Qxu, Qxu, Xu, Xu, Xu, Xu, Xu
