border_size=1
usage=map

Ww          , Ww          , Wo          , Wo          , Wo          , Wo          , Wo          , Ww          , Ww          , Gg          , Gs^Fp       , Gg          , Gs^Fms      , Gs^Fms      , Gs^Fms      , Gs^Fms      , Gs^Fms      , Gg          , Rr          , Gs^Fms      , Gs^Fp       , Gg          , Gs^Fms      , Gs^Fms      , Gs^Fms      , Gs^Fms      , Gs^Fms      , Gs^Fms      , Gs^Fds      , Gs^Fp       , Hh          , Hh          , Gs^Fp       , Rp          , Re^Gvs      , Gg^Wm       , Re^Gvs      , Re^Gvs      , Re^Gvs      , Re^Gvs      , Re^Gvs      , Re^Gvs      
Ww          , Ww          , Wwr         , Wo          , Wo          , Wo          , Wo          , Wo          , Wo          , Ww          , Ww          , Gg          , Ce          , Gg          , Gg          , Gs^Fms      , Gs^Fms      , Gs^Fp       , Rp          , Gs^Fms      , Gg          , Gs^Fms      , Gg          , Gg^Vh       , Gg          , Ggf         , Gs^Fp       , Gs^Fds      , Gs^Fds      , Gs^Fp       , Re^Gvs      , Re^Gvs      , Re^Gvs      , Rp          , Gg          , Re^Gvs      , Re^Gvs      , Re^Gvs      , Gg^Wm       , Re^Gvs      , Hh          , Hh          
Ss          , Ww          , Ww          , Ww          , Ww          , Ww          , Ww          , Wo          , Wo          , Wo          , Wwr         , Ww          , Ww          , Ce          , Ggf         , Gg          , Rr          , Rp          , Gg          , Rp          , Rp          , Gs^Fp       , Gs^Fp       , Gg          , Gs^Fp       , Gg          , Ggf         , Gs^Fds      , Gg          , Hh          , Gg^Vh       , Re^Gvs      , Rp          , Rp          , Rp          , Rp          , Rp          , Re^Gvs      , Gs^Fds      , Hh          , Hh          , Gs^Fds      
Ss          , Ss          , Gs^Fp       , Wwr         , Gs^Fp       , Ww          , Ww          , Wo          , Wo          , Wo          , Wo          , Ww          , Ww          , Ce          , Gg          , Rr          , Gg          , Gg          , Ggf         , Gg          , Gg          , Rp          , Rp          , Gg          , Rp          , Rp          , Rp          , Gg          , Rp          , Gg          , Gs^Fds      , Rp          , Re^Gvs      , Gg^Wm       , Re^Gvs      , Gs^Fds      , Rp          , Hh          , Hh          , Hh          , Rp          , Rp          
Gs^Fp       , Gs^Fp       , Gg          , Gg          , Ggf         , Ggf         , Ss          , Ww          , Ww          , Wo          , Wo          , Ww          , Ww          , Gg          , Rr          , Rp          , Ce          , Gg          , Gg          , Ce          , Ce          , Ggf         , Gg          , Rp          , Gg          , Gg          , Gg          , Rp          , Gg          , Rp          , Rp          , Rp          , Ggf         , Re^Gvs      , Hh          , Hh^Fds      , Gs^Fds      , Rp          , Rp          , Rp          , Ggf         , Gs^Fds      
Gg          , Gs^Fp       , Gg          , Ss          , Ss          , Ss          , Ss          , Ww          , Ww          , Wo          , Ww          , Wo          , Wo^Bw/      , Ww^Bw/      , Ww          , Ce          , Ww          , Gg          , Wwr         , Gg          , Ce          , Ggf         , Gg          , Gg          , Gs^Fds      , Gs^Fds      , Hh          , Gs^Fds      , Gs^Fds      , Gg          , Gg          , Rd          , Rd          , Hh          , Gg          , Hh          , Gg          , Gg          , Gg          , Gg          , Ss          , Gg          
Gs^Fp       , Gg          , Ss          , Gs^Fp       , Gs^Fp       , Gs^Fp       , Ggf         , Wwr         , Ww          , Gs^Fp       , Rp          , Wo^Bw/      , Wo          , Wo          , Wo          , Ww          , Ww          , Wwr         , Wwf         , Wwf         , Ww          , Ce          , Gg          , Gs^Fds      , Gs^Fds      , Ggf         , Gs          , Gs          , Hh          , Hh          , Hh          , Gg          , Gg          , Rd          , Rd          , Gg          , Ss          , Ss          , Gg          , Gg          , Ss          , Gg          
Ss          , Ss          , Ss          , Gs^Fp       , Ss          , Gg^Vc       , Gg          , Gg          , Ww          , Gs^Fp       , Rp          , Gs^Fp       , Ww          , Wo          , Wo          , Wwr         , Ww          , Ww          , Ww          , Ww          , Ww          , Ww          , Ww          , Gg          , Ai          , Gs          , Gs          , Gs          , Gg          , Hh          , Gg          , Gg          , Ss          , Ss          , Rd          , Ss          , Gg          , Gg          , Ce          , Gg^Vc       , Ss          , Ss          
Ss          , Ss          , Gs^Fp       , Ss          , Gs^Fp       , Gs^Fp       , Gg          , Ss          , Ss          , Ww          , Ww^Bw|      , Ww          , Ww          , Ww          , Ww          , Ww          , Wwr         , Ww          , Wwr         , Ww          , Wo          , Ww          , Wo          , Ww          , Ww          , Ai          , Ww          , Gg          , Gg          , Hh          , Gg          , Ss          , Ss          , Gg          , Rr          , Gg^Vc       , Rp          , Ce          , Rr          , Gg          , Gg          , Gg          
Gg          , Ss          , Ggf         , Gs^Fp       , Ce          , Ce          , Ce          , Gg          , Rd          , Ss^Bw/      , Ss          , Ww          , Gg          , Ww          , Hh          , Wwr         , Wwf         , Ww          , Ww          , Wo          , Ww          , Wo          , Wo          , Wo          , Wo          , Wo          , Wo          , Ww          , Ww          , Gg          , Gg          , Gg          , Gg          , Gg          , Ggf         , Rr          , Rp          , Rr          , Rp          , Rp          , Rp          , Ce          
Gg          , Gg^Vc       , Ss          , Gg          , Ce          , 4 Ke        , Ce          , Rd          , Gs          , Gs          , Aa^Fpa      , Gs^Fp       , Gs^Fp       , Hh          , Rd          , Gg          , Rd          , Wwr         , Gs^Fp       , Ai          , Ai          , Ww          , Ww          , Ww          , Ww          , Ww          , Wo          , Wo          , Wo          , Ww          , Ai          , Gg          , Gg          , Gg          , Ce          , Rr          , Rr          , Ce          , 2 Ke        , Ce          , Rp          , Rr          
Gg          , Ss          , Ss          , Gg          , Gg          , Gs          , Rp          , Rd          , Aa          , Aa          , Aa^Fpa      , Ai          , Hh          , Hh          , Ggf         , Gg          , Gs^Fp       , Rd          , Gg          , Gs^Fp       , Ggf         , Gg          , Gs^Fp       , Gs^Fp       , Aa^Fpa      , Ai          , Ww          , Wo          , Ai          , Wo          , Ww          , Ww          , Ai          , Gg          , Ce          , Gg^Vc       , Rr          , Ce          , Ce          , Ce          , Rr          , Rr          
Ss          , Gs^Fp       , Gs^Fp       , Gg^Vc       , Gg          , Gg          , Rp          , Aa^Vca      , Aa          , Gs^Fp       , Gg          , Ai          , Ggf         , Hh^Fp       , Rd          , Hh          , Hh^Fp       , Hh          , Ggf         , Gs^Fp       , Gs^Fp       , Gs^Fp       , Gs          , Gs          , Aa^Fpa      , Aa          , Aa          , Ww          , Ww          , Ai          , Wo          , Ww          , Wo          , Ai          , Ai          , Gg          , Ggf         , Rp          , Rr          , Rp          , Gg^Vc       , Ggf         
Hh          , Ss          , Gs^Fp       , Ggf         , Gs^Fp       , Ss          , Gs^Fp       , Aa          , Ai^Bw\      , Gg          , Ai          , Gg          , Rd          , Rd          , Hh          , Gg          , Ggf         , Hh          , Gs^Fms      , Gg          , Gs          , Gs^Fp       , Gs          , Aa^Fpa      , Aa^Fpa      , Aa          , Aa^Fpa      , Aa^Fpa      , Aa^Fpa      , Ww          , Ai          , Wo          , Ai          , Wo          , Ai          , Gg          , Gg          , Ce          , Ce          , Rr          , Gg          , Ce          
Ha          , Ss          , Gs          , Gs          , Gs^Fp       , Gs^Fp       , Ai          , Ss          , Ai          , Ai^Bw|      , Ai          , Ai          , Gs^Fp       , Hh          , Hh^Fp       , Rd          , Gs^Fp       , Gs^Fp       , Gs^Fms      , Gs^Fp       , Gs          , Gs^Fp       , Gs^Fms      , Aa^Fpa      , Aa          , Aa          , Aa^Fpa      , Aa^Fpa      , Aa^Fpa      , Ww          , Ai          , Wo          , Wo          , Wo          , Wo          , Ai          , Ww          , Gg          , Rr          , Rr          , Ss          , Gg          
Aa^Fpa      , Ha          , Aa^Fpa      , Gs          , Aa          , Aa^Fpa      , Aa^Fpa      , Ai          , Aa^Fpa      , Aa          , Aa          , Ai          , Gs          , Gs          , Gg          , Hh          , Hh          , Gs^Fms      , Gs          , Gs          , Gs          , Gs          , Gs^Fp       , Gs^Fp       , Gs          , Gg          , Aa^Fpa      , Aa^Fpa      , Ai          , Ha          , Aa          , Ww          , Chs         , Ss          , Wo          , Wo          , Wo          , Ww^Bw/      , Ww          , Ggf         , Ss          , Ss          
Aa^Fpa      , Aa^Fpa      , Ha          , Aa          , Ha          , Ha          , Ha^Fpa      , Ha^Fpa      , Ha^Fpa      , Aa^Fpa      , Aa          , Gs          , Gg          , Hh          , Gg          , Hh          , Gs^Fp       , Gs^Fp       , Gs^Fp       , Gs^Fp       , Gs^Fp       , Gs          , Gs^Fp       , Gs          , Gs          , Gg          , Aa^Fpa      , Ai          , Ai          , Ha          , Aa^Fpa      , Ss          , Ss          , Ss          , Ss^Bw/      , Wo^Bw/      , Wo          , Wo          , Wo          , Ww          , Ss          , Ss          
Ha          , Ha          , Ha          , Aa          , Aa^Fpa      , Gg          , Hh^Fp       , Ggf         , Gg          , Rp          , Aa^Fpa      , Aa          , Ha          , Ha          , Gg          , Gg          , Gs^Fp       , Ggf         , Gs^Fp       , Chr         , Gs^Fms      , Gs^Fms      , Gg          , Gs          , Chr         , Gs^Fp       , Ha          , Ha          , Ai          , Ai          , Ai          , Ai          , Rr          , Rd          , Aa          , Ss          , Wo          , Wo          , Ai          , Ww          , Ww          , Gg          
Gs          , Hh          , Gs          , Aa^Fpa      , Gg          , Gg          , Hh^Fp       , Hh          , Hh          , Rp          , Aa^Fpa      , Aa^Fpa      , Aa          , Ha          , Gs^Fp       , Gg          , Ss          , Gs^Fp       , Gs^Fp       , Gs^Fp       , Gs^Fms      , Gs^Fms      , Gs^Fp       , Gg          , Gs^Fp       , Gs^Fp       , Ha          , Ha          , Aa          , Aa          , Ai          , Ai          , Rr          , Aa          , Ai          , Ai          , Ai          , Ai          , Wo          , Wo          , Wo          , Ww          
Gs^Fp       , Gs^Fp       , Gs^Fp       , Gs          , Gg          , Gs^Fp       , Gs^Fp       , Hh^Fp       , Rp          , Rp          , Gs^Fp       , Aa^Fpa      , Aa          , Aa^Fpa      , Gg          , Ss          , Ss          , Ggf         , Gg          , Gs^Fms      , Gs^Fp       , Gs^Fp       , Chr         , Gg          , Gg          , Gs^Fp       , Hh          , Hh          , Aa          , Aa          , Aa          , Rr          , Rd          , Aa          , Ai          , Ai          , Ai          , Ai          , Wo          , Wo          , Wo          , Wo          
Gs          , Gs^Fp       , Gs          , Gs^Fp       , Gg^Vh       , Gs^Fp       , Gs^Fp       , Gs^Fp       , Gg          , Rp          , Gg          , Gg          , Gg          , Gg          , Ss          , Ss^Vhs      , Ggf         , Gg          , Gs^Fp       , Ss          , Gs^Fp       , Gs^Fp       , Khr         , Chr         , Gg          , Gg          , Hh          , Hh^Vhh      , Hh          , Hh          , Aa^Fpa      , Re          , Ha          , Ha          , Ha          , Aa          , Aa          , Ai          , Ww          , Chw         , Wo          , Wo          
Hh          , Hh          , Hh          , Gs          , Gs^Fp       , Gs^Fp       , Ggf         , Ggf         , Gg          , Ggf         , Gs^Fp       , Gs^Fp       , Gs^Fp       , Gg          , Ggf         , Ss          , Gg          , Chr         , Ss          , Ss          , Ss          , Chr         , Chr         , Gs^Fdw      , Ha          , Ha          , Gs^Fdw      , Hh          , Gs          , Aa^Fpa      , Aa^Fpa      , Rr          , Hh          , Ha          , Hh          , Aa          , Aa^Fpa      , Aa          , Aa          , Ww          , Ai          , Wo          
Aa          , Hh          , Hh          , Hh          , Gs^Fp       , Gs^Fp       , Gg          , Gs^Fp       , Gs^Fp       , Gs^Fp       , Gs^Fp       , Gs^Fp       , Gs^Fp       , Gg          , Gg          , Gg          , Gg          , Ss          , Aa          , Ss          , Gs^Fdw      , Gs^Fdw      , Gs^Fdw      , Gs^Fdw      , Ha          , Aa          , Gs^Fdw      , Hh          , Hh          , Hh          , Gs          , Rr          , Gg          , Hh          , Hh          , Aa          , Ha^Vhha     , Aa          , Aa^Fpa      , Ai          , Aa          , Ai          
Aa^Fpa      , Aa^Fpa      , Gs^Fp       , Gs^Fp       , Aa^Fpa      , Gs          , Gg          , Gs^Fp       , Aa          , Aa^Fpa      , Gs^Fp       , Gs^Fp       , Ggf         , Gg          , Gs^Fp       , Gs^Fp       , Aa^Fpa      , Aa          , Aa^Fma      , Gs^Fdw      , Aa^Fma      , Aa^Fma      , Aa^Fpa      , Ha          , Aa          , Aa          , Aa^Fpa      , Gs          , Gs          , Hh          , Rd          , Rr          , Hh          , Ha          , Aa^Fpa      , Ha          , Gs          , Hh          , Aa^Fpa      , Ai          , Aa^Fpa      , Aa          
Aa          , Aa^Fpa      , Gs^Fp       , Gs^Fp       , Gs^Fp       , Aa          , Gs          , Aa          , Gs          , Aa^Fpa      , Gs^Fp       , Gs^Fp       , Gg          , Gg          , Gg          , Aa^Fpa      , Aa^Fpa      , Aa^Vea      , Aa^Fpa      , Aa^Fma      , Aa^Fma      , Aa^Fma      , Aa^Fpa      , Aa          , Aa          , Aa^Fpa      , Aa^Fpa      , Gs          , Re          , Rd          , Rd          , Re          , Hh          , Ha          , Aa^Fmw      , Aa^Fpa      , Gs          , Gs          , Gg^Fmw      , Aa^Fpa      , Ai          , Ai          
Aa          , Aa^Fpa      , Aa^Fpa      , Gs^Fp       , Gs^Fp       , Gs^Fp       , Gs          , Gs          , Gs          , Aa^Fpa      , Aa^Fda      , Aa^Fpa      , Aa          , Gg          , Aa^Fpa      , Aa^Fpa      , Aa          , Aa^Fpa      , Aa^Fpa      , Aa^Fma      , Aa^Fpa      , Aa^Fpa      , Gs^Fdw      , Aa          , Gg          , Ha          , Aa^Fpa      , Gs          , Rp          , Rp          , Hh          , Gs          , Aa^Fpa      , Aa^Fmw      , Gs^Fmw      , Gs          , Hh          , Hh          , Gs^Fp       , Aa^Fmw      , Ai          , Aa          
Aa          , Aa          , Aa          , Aa^Fpa      , Gg          , Gs^Fp       , Gg          , Gg          , Gs^Fdw      , Chr         , Aa^Fda      , Aa          , Aa          , Aa          , Aa^Fda      , Aa^Fpa      , Aa          , Aa^Fpa      , Aa          , Aa          , Aa          , Aa          , Gs^Fdw      , Gg          , Gs          , Ha          , Hh          , Rp          , Gg          , Gg          , Hh          , Hh          , Aa^Fpa      , Gg^Fmw      , Ss          , Gg          , Ss          , Hh          , Ggf         , Aa^Fmw      , Aa          , Aa          
Aa          , Aa          , Gs^Fp       , Aa          , Gs^Fp       , Gg          , Gg          , Gs^Fdw      , Gs^Fdw      , Gs^Fdw      , Gs^Fdw      , Gg^Ve       , Gg          , Aa          , Gs^Fdw      , Aa^Fda      , Aa^Fda      , Aa          , Aa          , Gs          , Gs          , Gs^Fdw      , Gs^Fdw      , Gg          , Gs          , Hh          , Rp          , Rp          , Ha          , Ggf         , Gs^Fp       , Gs          , Gs^Fmw      , Ss          , Ss          , Ss          , Ss          , Ss          , Gg          , Ggf         , Gg          , Gs^Fp       
Aa^Fpa      , Aa^Fpa      , Aa^Fpa      , Gs^Fp       , Gs^Fp       , Gs^Fp       , Hh          , Gs^Fdw      , Gs^Fdw      , Gs          , Gs          , Gg          , Aa          , Gg          , Gs^Fdw      , Aa^Fda      , Gs^Fdw      , Gs          , Aa          , Gs          , Gs          , Gg          , Gs^Fdw      , Gs^Fdw      , Gs          , Gs          , Gs          , Gg          , Ha          , Ha          , Hh          , Gs^Fmw      , Gs^Fmw      , Gg          , Gs^Fdw      , Gg          , Gs^Fdw      , Gg          , Hh          , Gg          , Hh          , Gs^Fmw      
Aa^Fpa      , Aa^Fpa      , Gs^Fp       , Gs^Fp       , Aa^Fpa      , Aa^Fpa      , Hh^Fp       , Hh          , Gs^Fdw      , Gs^Fdw      , Gs          , Gg          , Gg          , Gg          , Gs          , Gs^Fdw      , Gg          , Gs          , Gs          , Gs          , Gs^Fdw      , Gg          , Gg          , Gg          , Hh          , Gg          , Gg          , Gs^Fp       , Aa^Fpa      , Ha          , Hh          , Aa^Fpa      , Gs^Fdw      , Ggf         , Aa^Fpa      , Aa^Fmw      , Gs^Fmw      , Hh^Fdw      , Ha          , Hh          , Gs^Fmw      , Gs^Fmw      
Aa^Fpa      , Aa^Fpa      , Aa^Fpa      , Gs^Fp       , Aa          , Aa          , Ha^Fpa      , Hh          , Gs          , Gs          , Gs^Fdw      , Gs          , Gg          , Gg          , Ww          , Gs          , Ww          , Gg          , Gs^Fdw      , Gs^Fdw      , Gs^Fdw      , Chr         , Hh          , Hh          , Hh          , Hh          , Gs^Fp       , Ggf         , Aa^Fda      , Aa^Fpa      , Gg          , Aa^Fpa      , Ha          , Gs^Fdw      , Aa^Fpa      , Aa^Fmw      , Aa^Fdw      , Gs^Fdw      , Gs^Fdw      , Gs^Fmw      , Gs^Fdw      , Gs^Fdw      
Aa          , Aa          , Aa          , Aa          , Aa          , Aa          , Ha          , Ha          , Aa^Vha      , Gs          , Gs^Fdw      , Aa^Fda      , Ww          , Ww          , Wo          , Ww          , Ww          , Ww          , Ww          , Gs^Fdw      , Aa^Fda      , Gs^Fdw      , Ha          , Ha          , Ha          , Ha          , Aa          , Gs^Fp       , Gs^Fda      , Gs^Fda      , Gg          , Aa          , Ha          , Ha          , Aa^Fpa      , Aa^Fpa      , Aa^Fpa      , Gs^Fdw      , Ha          , Gs^Fdw      , Aa^Fpa      , Aa^Fdw      
Ha          , Ha^Fpa      , Aa          , Aa          , Aa^Fpa      , Aa^Fpa      , Aa          , Ha          , Aa^Fpa      , Gs          , Gs          , Aa^Fda      , Aa          , Ai          , Ai          , Ai          , Wo          , Ww          , Aa^Fpa      , Gs^Fdw      , Aa^Fda      , Aa^Fpa      , Aa          , Ha          , Ha          , Aa          , Ha          , Aa          , Aa          , Gs^Fda      , Gs^Fda      , Aa          , Ha^Fda      , Ha^Vhha     , Ha          , Aa^Fpa      , Ha          , Ha          , Ha          , Ha          , Ha          , Ha          
Ha          , Ms          , Ha^Fpa      , Aa          , Aa          , Aa^Fpa      , Aa^Fpa      , Aa          , Aa^Fpa      , Aa^Fpa      , Gs          , Gs          , Aa          , Ai          , Ww^Bw/      , Ai          , Aa          , Ww          , Aa^Fda      , Aa^Fda      , Aa          , Aa^Fpa      , Aa^Fda      , Aa          , Ha          , Ha          , Ms          , Ha          , Ha          , Aa          , Aa^Fda      , Aa^Fda      , Aa          , Aa          , Ms          , Ms          , Ms          , Mm^Xm       , Mm^Xm       , Ms          , Ms          , Ha          
Ha          , Ms          , Ha^Fpa      , Aa          , Aa          , Aa^Fpa      , Aa          , Aa          , Aa          , Aa^Fpa      , Aa          , Gs          , Gs          , Aa          , Aa          , Aa          , Aa^Vea      , Aa^Fpa      , Aa          , Aa          , Ha^Fpa      , Aa          , Ha^Fda      , Ha^Fpa      , Ha          , Ms          , Ms          , Ms          , Aa^Fpa      , Aa          , Aa^Fda      , Aa^Fda      , Aa^Fda      , Ha          , Mm          , Ms          , Mm          , Mm^Xm       , Mm^Xm       , Ms          , Ms          , Ms          
Ms          , Ha          , Ha          , Aa          , Ha^Fpa      , Aa          , Ha          , Aa          , Ha^Vhha     , Aa^Fpa      , Aa          , Gs          , Aa          , Aa          , Ha          , Aa^Fpa      , Ha^Fpa      , Aa          , Mm^Vhh      , Ha          , Ha          , Ha          , Aa          , Ha^Fda      , Aa          , Ha          , Ha          , Ha          , Aa^Fpa      , Aa^Fpa      , Aa          , Aa          , Ha^Fpa      , Mm          , Mm          , Mm^Xm       , Mm^Xm       , Mm          , Mm          , Ms          , Ms          , Ms          
Ms          , Ms          , Ha          , Ms          , Ha          , Ha^Fpa      , Aa^Fpa      , Ms          , Gs^Fp       , Gs^Fp       , Aa^Fpa      , Aa          , Aa          , Ha          , Aa          , Gs^Fp       , Ha^Fpa      , Mm          , Mm          , Mm^Xm       , Ha          , Aa          , Ha          , Ha^Fda      , Aa^Fpa      , Aa          , Aa          , Aa          , Ha          , Aa          , Ha^Fpa      , Aa          , Ha          , Ms          , Ms          , Mm          , Mm          , Mm          , Ai          , Ai          , Ms          , Ms          
Mm          , Mm^Xm       , Mm^Xm       , Ha          , Ha          , Ms          , Ms          , Gs^Fp       , Aa^Fpa      , Gs^Fp       , Aa^Fpa      , Gs          , Gs          , Aa          , Gs^Fp       , Gs^Fp       , Aa^Fpa      , Ha^Fpa      , Ms          , Mm^Xm       , Mm^Xm       , Mm          , Ha          , Ha          , Ha^Fpa      , Aa          , Aa          , Ha          , Ms          , Ha          , Ms          , Ha          , Ms          , Ms          , Ms          , Ms          , Ms          , Ai          , Ai          , Ai          , Ai          , Ms          
Mm          , Mm^Xm       , Mm^Xm       , Ms          , Ms          , Ms          , Gs^Fp       , Gs^Fp       , Ce          , Ce          , Ce          , Ha          , Aa          , Gs          , Gs^Fp       , Aa^Fpa      , Ha          , Ms          , Ms          , Ms          , Mm^Xm       , Mm          , Mm          , Ha          , Ha          , Ha          , Ha          , Ha          , Mm^Xm       , Mm          , Mm          , Ms          , Ms          , Ms          , Ms          , Ms          , Ai          , Ai          , Ai          , Ai          , Ai          , Ms          
Mm          , Mm^Xm       , Mm^Xm       , Ms          , Ha          , Hh          , Aa^Fpa      , Hh          , Ce          , 1 Ke        , Ce          , Aa          , Aa^Fpa      , Aa          , Gs          , Gs^Fp       , Ha          , Ha          , Ms          , Ms          , Mm^Xm       , Mm^Xm       , Mm          , Mm          , Ha          , Mm          , Mm^Xm       , Mm          , Ms          , Mm^Xm       , Mm          , Mm          , Mm^Xm       , Mm^Xm       , Mm^Xm       , Ms          , Ms          , Ai          , Ai          , Ai          , Ms          , Ms          
Mm          , Mm          , Mm^Xm       , Mm          , Mm          , Ms          , Aa^Fpa      , Aa^Fpa      , Aa          , Ce          , Aa^Fpa      , Aa          , Aa^Fpa      , Aa          , Gs          , Aa^Fpa      , Gg          , Ms          , Ms          , Mm^Xm       , Mm^Xm       , Mm^Xm       , Mm          , Mm          , Mm          , Mm          , Mm^Xm       , Mm          , Mm^Xm       , Mm^Xm       , Mm          , Mm          , Mm^Xm       , Mm^Xm       , Mm^Xm       , Ms          , Ms          , Ai          , Mm^Xm       , Ms          , Ms          , Ms          
Mm          , Mm^Xm       , Mm^Xm       , Mm^Xm       , Ha          , Ha          , Aa^Fpa      , Aa          , Gs          , Aa          , Aa          , Aa^Fpa      , Gs          , Gs          , Aa^Fpa      , Aa^Fpa      , Ms          , Ms          , Ms          , Mm^Xm       , Mm^Xm       , Mm^Xm       , Mm^Xm       , Mm^Xm       , Mm^Xm       , Mm^Xm       , Mm^Xm       , Mm^Xm       , Mm^Xm       , Mm^Xm       , Mm^Xm       , Mm          , Mm          , Mm          , Mm          , Mm          , Mm^Xm       , Mm          , Ms          , Ms          , Ms          , Ms          
