Ww, Ww, Wo, Wo, Wo, Wo, Wo, Ww, Ww, Gg, Gs^Fp, Gg, Gs^Fms, Gs^Fms, Gll^Fms, Gll^Fms, Gll^Fms, Gll, Rr, Gs^Fms, Gll^Fp, Gll^Fp, Gll^Fms, Gll^Fms, Gll^Fms, Gll^Fms, Gll^Fms, Gs^Fms, Gs^Fds, Gs^Fp, Hh, Hh, Gs^Fp, Rp, Re^Gvs, Rb^Gvs, Rb^Gvs, Re^Gvs, Rb^Gvs, Re^Gvs, Re^Gvs, Re^Gvs, Gs^Fds, Gs^Fds
Ww, Ww, Wwf, Wo, Wo, Wo, Wo, Wo, Wo, Ww, Ww, Gg, Ce, Gg, Gg, Gll^Fms, Gs^Fms, Gs^Fp, Rp, Gs^Fms, Gg, Gll^Fms, Gll^Eff, Gg^Vl, Gg^Eff, Gg^Em, Gll^Fp, Gll^Fds, Gs^Fds, Gs^Fp, Re^Gvs, Rb^Gvs, Re^Gvs, Rp, Rb^Gvs, Rb^Gvs, Rb^Gvs, Rb^Gvs, Gg^Wm, Rb^Gvs, Hh, Hh, Gs^Fds, Gs^Fds
Ss, Ww, Ww, Ww, Ww, Ww, Ww, Wo, Wo, Wo, Wwf, Ww, Ww, Ce, Gg^Efm, Gg, Re, Rp, Gg, Rp, Rp, Gs^Fp, Gs^Fp, Gg^Eff, Gs^Fp, Gg, Gg^Efm, Gs^Fds, Gg, Hh, Rr^Vhc, Rb^Gvs, Rp, Rp, Rp, Rp, Rp, Re^Gvs, Gs^Fds, Hh, Hh, Gs^Fds, Gg, Gs
Ss, Ss, Gll^Fp, Wwf^Ewl, Gll^Fp, Wwr, Wwr, Wo, Wo, Wo, Wo, Ww, Ww, Ce, Gg, Rp, Gg, Gg, Gg^Efm, Gg, Gg, Rr, Rr, Gg, Rp, Rp, Rp, Gg, Rp, Gg^Eff, Gs^Eff, Rp, Rb^Gvs, Rb^Gvs, Re^Gvs, Gs^Fds, Rp, Hh, Hh, Hh, Rr, Rp, Rp, Rp
Gll^Fp, Gll^Fp, Gll^Em, Gll, Gg, Gg^Efm, Ss, Ww, Ww, Wo, Wo, Ww, Ww, Gg, Rr, Rp, Ce, Gg, Gg, Ce^Qhh, Ce, Gg^Efm, Gg, Rp, Gg, Gg, Gg, Rr, Gg, Rp, Re, Rp, Gg^Efm, Re^Gvs, Hh, Hh^Fds, Gs^Fds, Rp, Rp, Rp, Gg^Efm, Gs^Fds, Gs^Fds, Gs^Fds
Gll^Em, Gll^Fp, Gll, Ss, Ss, Ss, Ss, Wwr, Ww, Wo, Wwr, Wo, Wo^Bw/, Ww^Bw/, Ww, Ce, Ww, Gg, Ww, Gg^Qhh, Ce, Gg^Efm, Gs, Gg, Gs^Fds, Gs^Fds, Hh, Gs^Fds, Gs^Fds, Gg, Gg, Re, Re, Hh, Gg, Hh, Gg, Gg, Gg, Gg, Ss, Gg, Gs^Fds, Gs^Fds
Gs^Fp, Gs, Ss, Gll^Fp, Gll^Fp, Gll^Fp, Gll, Wwf^Ewl, Ww, Gll^Fmw, Rp, Wo^Bw/r, Wo, Wo, Wo, Ww, Wwr, Wwr, Wwf, Wwf, Ww, Ce, Gg, Gs^Fds, Gs^Fds, Gg^Efm, Gs^Qhh, Gs^Fet, Hh, Hh, Hh, Gg, Gg, Re, Re, Gg, Ss, Ss, Gg, Gg, Ss, Gg, Gg, Gs^Fds
Ss, Ss, Ss^Emf, Gll^Tf, Ss^Tf, Gll^Vc, Gll^Edt, Gll, Ww^Ewl, Gll^Fetd, Rp, Gll^Fdw, Ww, Wo, Wo, Wwf, Wwr, Ww, Ww, Ww, Ww, Ww, Ww, Gg, Ai, Gs, Gs, Gs^Qhh, Gg^Qhh, Hh, Gg, Gg, Ss, Ss, Rb, Ss, Gg, Gg, Ce, Gg^Vc, Ss, Ss, Re^Gvs, Re^Gvs
Ss, Ss, Gs^Fp, Ss^Tf, Gll^Fp, Gs^Fp, Gll, Ss, Ss, Ww, Ww^Bw|r, Ww, Ww, Ww, Ww, Ww, Ww, Ww, Ww, Ww, Wo, Ww, Wo, Ww, Ww, Ai, Ww, Gs, Gg^Qhh, Hh, Gg, Ss, Ss, Gg, Rr, Gg^Vc, Rp, Ce^Edt, Rr, Gg, Gg^_mh, Gg, Gg, Re^Gvs
Gll, Ss, Gll^Em, Gll^Fp, Ce, Ce, Ce, Gll, Rb, Ss^Bw/, Ss, Ww, Gll, Wwr, Hh, Ww, Wwf, Wwr, Ww, Wo, Wwr, Wo, Wo, Wo, Wo, Wo, Wo, Ww, Ww, Gg^Qhh, Gs^Qhh, Gg, Gs^Fds, Gs^Fds, Gg^Efm, Rr, Rp, Rr, Rp, Rp, Rp, Ce, Ce^Edt, Gg^Efm
Gll^Edt, Gll^Vc, Ss, Gll^Em, Ce, 2 Ket, Ce, Rb, Gll, Gll, Gs, Gs^Fp, Gll^Fp, Hh, Re, Gs, Re, Ww, Gs^Fp, Ai, Ai, Ww, Ww, Ww, Ww, Ww, Wo, Wo, Wo, Ww, Ai, Gs^Qhh, Gs^Qhhf, Gs^Fds, Ce, Rr, Rr, Ce, 4 Ket, Ce, Rp, Rr, Rp, Gg
Gll, Ss, Ss, Gll, Gll, Gll, Rp, Rb, Gs^Edt, Gll, Gs, Gs, Gll, Gll, Gs^Es, Gg, Gs^Fp, Re, Gll, Gs^Fp, Gll, Gg, Gs^Fp, Gs^Fp, Aa^Fpa, Ai, Wwr, Wo, Ai, Wo, Wo, Ww, Ai, Gg^Qhh, Ce^Qhh, Gg^Vc, Rr, Ce, Ce^Edt, Ce, Rr, Rr, Rr, Rp
Ai, Gll, Gll^Fp, Gll^Vc, Gll^Edt, Gll, Rp, Gll^Vc, Gs, Gs, Gll, Gll, Gg, Re, Gs, Gll, Hh^Fp, Hh, Gll, Gll^Fp, Gll^Fp, Gll^Fp, Gs, Gs, Aa^Fpa, Aa, Aa, Wwr, Ww, Ai, Wo, Ww, Wo, Ai, Ai, Gg^Qhh, Gs^Fds, Rp, Rr, Rp, Gg^Vc, Gg^Efm, Ce, Rp
Ha, Ai, Aa^Fpa, Gll, Aa^Fpa, Ai, Ai, Gll, Ss^Bw\r, Gg, Ss, Gg, Re, Re^Es, Gs, Gll, Gll, Hh, Gll^Fms, Gg, Gs^Em, Gll^Fp, Gs, Aa^Fpa, Aa^Fpa, Aa, Aa^Fpa, Aa^Fpa, Aa^Fpa, Ww, Ai, Wo, Ai, Wo, Ai, Gg^Qhhf, Gg^Qhhf, Ce^Edt, Ce^Qhh, Rr^Qhh, Gg^Qhh, Ce^Edt, Gg, Gg
Ha, Ai, Aa, Aa, Aa^Fpa, Aa^Fma, Ai, Ss, Ss, Ss^Bw|r, Ss, Ss, Gg, Gg^Es, Gg, Re, Gll^Fp, Gll^Fp, Gll^Fms, Gs^Fp, Gs, Gg, Gll^Fms, Aa^Fpa, Aa, Aa, Aa^Fpa, Aa^Fpa, Aa^Fpa, Wwr, Ai, Wo, Wo, Wo, Wo, Ai, Ww, Gg^Qhh, Rr, Rr, Ss, Gg^Qhh, Gs^Qhh, Re^Gvs
Aa^Fpa, Ha, Aa^Fpa, Aa, Aa, Aa^Fpa, Ai, Ss, Aa^Fpa, Gs, Gs, Ss, Gg, Gs, Gs, Hh, Hh, Gll^Fms, Gs^Em, Gs^Em, Gs, Gg, Gll^Fp, Gll^Fp, Gs, Gg^Esa, Aa^Fpa, Aa^Fpa, Ai, Ha, Aa, Ww, Chs, Ss, Wo, Wo, Wo, Ww^Bw/r, Ww, Gg^Efm, Ss, Ss, Gg^Qhh, Gs
Aa^Fpa, Aa^Fpa, Ha, Aa, Ha, Ha, Ha^Fma, Ai, Aa, Aa, Gs^Esa, Gs, Gs, Gg, Gs, Hh, Gs^Fp, Gll^Fp, Gll^Fp, Gs^Fp, Gll^Fp, Gs, Gs^Fp, Gs, Gs, Gg, Aa^Fpa, Ai, Ai, Ha, Aa^Fpa, Ss, Ss, Ss, Ss^Bw/r, Wo^Bw/r, Wo, Wo, Wo, Ww, Ss, Ss, Gg^Qhh, Gll^Fp
Ha, Ha, Ha, Aa, Aa^Fpa, Gg, Ha^Fda, Ai, Ai, Rp, Aa^Fpa, Aa, Ha, Ha, Gs, Gs, Gs^Fp, Gs^Em, Gll^Fp, Chr, Gll^Fms, Gll^Fms, Gg, Gs, Chr, Gll^Fp, Ha, Ha, Ai, Ai, Ai, Ai, Rr, Re, Aa, Ss, Wo, Wo, Wo, Ww, Ww, Gg, Gs, Gg^Qhh
Gs, Gs, Gs^Esa, Aa^Fpa, Gg, Gg^Esa, Hh^Fp, Ha, Hh, Rp, Aa^Fpa, Aa^Fma, Aa, Ha^Fda, Gs^Fp, Gs, Ss, Gll^Fp, Gll^Fp, Gll^Fp, Gll^Fms, Gs^Fms, Gs^Fp, Gg, Gll^Fp, Gll^Fp, Ha, Ha, Aa, Aa, Ai, Ai, Rr^Esa, Aa, Ai, Ai, Ai, Wo, Wo, Wo, Wo, Ww, Ww, Ww
Gll^Fp, Gll^Fp, Gll^Fp, Gs, Gg, Gll^Fp, Gll^Fp, Hh^Fp, Rp, Rp, Aa, Aa^Fpa, Aa, Aa^Fpa, Gg, Ss, Ss, Gg^Em, Gs^Em, Gll^Fms, Gll^Fp, Gll^Fp, Chr, Gg, Gg, Gll^Fp, Hh, Gs, Gs^Esa, Aa, Gs, Rr, Rb, Aa, Ai, Ai, Ai, Wo, Wo, Wo, Wo, Wo, Wo, Ww
Gs, Gll^Fp, Gs^Em, Gs^Fp, Gg^Vh, Gs^Fp, Gll^Fp, Gll^Fp, Gg, Rp, Gg, Gs^Esa, Gs, Gs, Ss, Ss^Vhs, Gg, Gs^Em, Gs^Fp, Ss^Emf, Gs^Fp, Gs^Fp, Khr, Chr, Gs, Gg, Gg, Hh^Vhh, Hh, Gs, Gs, Re, Gs, Gs^Esa, Aa^Fpa, Aa, Aa, Ai, Wwr, Chw, Wo, Wo, Wo, Wo
Hh, Hh, Hh, Gs, Gs^Fp, Gs^Fp, Gs, Gs, Re, Re, Gll^Fp, Gll^Fp, Gs^Fp, Gg, Gll, Ss, Gd, Chr, Ss, Ss, Ss, Chr, Cha, Aa^Fda, Aa, Gg, Gg, Hh, Gs, Gs^Es, Gs, Rr, Gs, Gs, Ha^Fpa, Aa, Aa^Fpa, Aa, Aa, Wwr, Ai, Wo, Wo, Wo
Aa, Hh, Hh, Hh, Gll^Fp, Gll^Fp, Gg, Re, Gll^Fp, Gll^Fp, Gll^Fp, Gll^Fp, Gs^Fp, Gll, Aa, Gd, Aa^Qhu, Ss, Aa^Qhu, Ss, Aa^Fda, Aa^Fda, Aa^Fda, Aa^Fda, Ha, Gs^Esa, Gs, Gs, Gg, Gs, Gs^Es, Rr, Gs, Ha, Ha, Aa, Ha^Vhha, Aa, Aa^Fpa, Ai, Aa, Ai, Ai, Ai
Aa^Fpa, Aa^Fpa, Gs^Fp, Gll^Fp, Aa^Fpa, Gs, Gg, Re, Aa, Aa^Fpa, Gll^Fp, Gll^Fp, Gll, Gd, Aa^Qhu, Aa^Qhu, Aa^Fpa, Aa^Qhu, Aa^Fma, Aa^Fda, Aa^Feta, Aa^Fma, Aa^Fpa, Ha, Aa, Aa, Aa^Fpa, Gs, Aa, Gs, Re, Rr, Gs, Ha, Aa^Fpa, Ha, Gs^Esa, Hh, Aa^Fpa, Ai, Aa^Fpa, Aa, Ai, Aa
Aa, Aa^Fpa, Aa^Fpa, Gll^Fp, Gll^Fp, Aa, Gs, Aa, Gs, Aa^Fpa, Gs^Fp, Gs^Fp, Gd, Aa^Qhu, Aa, Aa, Aa^Fpa, Aa^Vla, Aa, Aa^Fma, Aa^Fma, Aa^Fma, Aa^Fpa, Aa, Aa, Aa^Fma, Aa^Fpa, Gd^Esa, Rb, Re, Re^Es, Re, Hh, Ha, Aa^Fda, Aa^Fpa, Gs, Gs, Gll^Fma, Aa^Fpa, Ai, Ai, Aa, Aa
Aa, Aa^Fpa, Aa^Fpa, Gll^Fp, Gll^Fp, Gs^Fp, Gd, Re, Re, Aa^Fpa, Aa^Fda, Aa^Fpa, Aa^Qhu, Aa^Qhu, Aa^Fpa, Aa^Fpa, Aa, Aa^Fpa, Aa^Fpa, Aa^Fma, Aa^Fpa, Aa^Fpa, Aa^Fma, Aa, Gg, Ha, Gs, Gs, Rp, Rp, Gs, Gs, Aa^Fpa, Aa^Fma, Aa^Fma, Gs^Esa, Hh, Hh, Gll^Fp, Aa^Fmw, Ai, Aa, Aa^Fpa, Aa
Aa, Aa, Aa, Aa^Fpa, Gs, Aa, Gd^Qhuf, Gs^Qhu, Rp, Cha, Aa^Fda, Aa, Aa, Aa, Aa^Fda, Aa^Fpa, Aa, Aa^Fpa, Aa, Aa, Aa, Aa, Aa^Fma, Aa, Gs, Gs, Gg, Gg, Rb, Gg, Gs, Ha, Aa^Fpa, Aa^Fma, Ss, Gg, Ss, Hh, Gg, Aa^Fmw, Aa, Aa, Aa^Fmw, Aa^Fpa
Aa, Aa, Gll^Fp, Aa, Gll^Fp, Gll, Gll^Qhuf, Gs^Fdw, Re, Gs^Fdw, Gs^Fdw, Aa^Vea, Gll, Aa, Gd^Fdw, Aa^Fda, Aa^Fda, Aa, Aa, Gs^Esa, Gs^Esa, Aa^Fda, Aa^Fda, Gg^Esa, Gs, Gg, Rp, Rb, Gs, Gs, Aa, Aa, Aa^Fma, Ss, Ss, Ss, Ss, Ss, Gg, Gg, Gg^Esa, Gs^Fp, Gs^Fmw, Aa^Fpa
Aa^Fpa, Aa^Fpa, Aa^Fpa, Gll^Fp, Gll^Fp, Gll^Fp, Hhd, Gll^Fdw, Gd^Fdw, Re, Gs, Gll, Aa, Gll, Gd^Fdw, Aa^Fda, Gll^Fdw, Gll^Esa, Aa, Gs, Gs, Aa, Aa^Fda, Aa^Fda, Gs, Gs, Gs, Gg^Esa, Ha, Ha, Ha, Aa^Fma, Aa^Fdw, Gg, Gs^Fdw, Gg, Gll^Fdw, Gg, Hh, Gg, Hh, Gll^Fmw, Gll^Fmw, Gs^Fdw
Aa^Fpa, Aa^Fpa, Aa^Fpa, Gll^Fp, Aa^Fpa, Aa^Fpa, Hhd, Hhd, Gd^Fdw, Re, Gs, Gll^Es, Gll, Gll, Gs, Gs^Fdw, Gd, Gs, Gll, Gs, Gll^Fdw, Gg, Gg, Gg, Hhd, Gg, Gg^Esa, Aa, Aa^Fpa, Ha, Ha, Aa^Fpa, Aa^Fdw, Gg^Esa, Aa^Fma, Aa^Fmw, Gll^Fmw, Hh^Fdw, Ha, Hh, Gll^Fmw, Gll^Fmw, Gll^Fdw, Gg
Aa^Fpa, Aa^Fpa, Aa^Fpa, Aa^Fpa, Aa, Aa, Ha^Fpa, Hhd, Gs, Rp, Gll^Fdw, Gll, Gll^Esa, Gs^Es, Ww, Gs, Wwr, Gll, Gll^Fdw, Gll^Fdw, Gll^Fmw, Chr, Hhd, Hhd, Hhd, Hhd, Aa^Fpa, Aa, Aa^Fma, Aa^Fpa, Aa, Aa^Fma, Ha, Aa^Fdw, Aa^Fpa, Aa^Fma, Aa^Fdw, Gll^Fdw, Gll^Fdw, Gll^Fmw, Gll^Fdw, Gs^Fdw, Gll, Gs^Fdw
Aa, Aa, Aa, Aa, Aa, Aa, Ha, Ha, Aa^Vha, Re, Gll^Fdw, Aa^Fda, Ww, Ww, Wo, Ww, Ww, Wwr, Ww, Gll^Fmw, Aa^Fda, Gll^Fmw, Ha^Fma, Ha, Ha, Ha, Aa, Aa^Fpa, Aa^Fda, Aa^Fda, Aa, Aa, Ha, Ha, Aa^Fpa, Aa^Fma, Aa^Fma, Gll^Fdw, Ha^Fma, Gll^Fdw, Aa^Fpa, Aa^Fdw, Gs, Gll
Ha, Ha^Fpa, Aa, Aa, Aa^Fpa, Aa^Fpa, Aa, Ha, Aa^Qhuf, Gs^Qhu, Re, Aa^Fda, Aa, Ai, Ai, Ai, Wo, Ww, Aa^Fpa, Aa^Fda, Aa^Fda, Aa^Fpa, Aa, Ha, Ha, Aa, Ha, Aa, Aa^Feta, Aa^Fma, Aa^Fda, Aa, Ha^Fda, Ha^Vhha, Ha, Aa^Fpa, Ha, Ha, Ha, Ha, Ha, Ha^Fma, Aa^Fpa, Ha
Ha, Ms, Ha^Fpa, Aa, Aa, Aa^Fpa, Aa^Fpa, Aa, Aa^Fpa, Aa^Qhu, Gll^Qhu, Re^Esa, Aa, Ai, Ai^Bw/, Ai, Aa, Ww, Aa^Fda, Aa^Fma, Aa, Aa^Fpa, Aa^Fda, Aa, Ha, Ha, Ms, Ha, Ha, Aa^Fma, Aa^Fda, Aa^Fda, Aa, Aa, Ms, Ms, Ms, Ms, Ms, Ms, Ms, Ha, Ha^Fpa, Ms
Ha, Ms, Ha^Fpa, Aa, Aa, Aa^Fpa, Aa, Aa, Aa, Aa^Fpa, Gll^Qhu, Rb, Rb^Esa, Aa, Aa, Aa, Rrc^Vhca, Aa^Fpa, Aa, Aa, Ha^Fpa, Aa, Ha^Fda, Ha^Fpa, Ha, Ms, Ms, Ms, Aa^Fpa, Aa, Aa^Fma, Aa^Fda, Aa^Fda, Ha, Ms, Ms, Ms, Ms, Ms, Ms, Ms, Ms, Ha^Fpa, Ha^Fpa
Ms, Ha, Ha, Aa, Ha^Fpa, Aa, Ha, Aa, Ha^Vhha, Aa^Fpa, Rb^Qhu, Rb, Aa, Aa, Ha, Aa^Fpa, Ha^Fpa, Aa, Ms^Vhha, Ha, Ha, Ha, Aa, Ha^Fda, Aa, Ha, Ha, Ha, Aa^Fpa, Aa^Fpa, Aa, Aa^_ml, Ha^Fpa, Ms, Ms, Ms, Ms, Ms, Ms, Ms, Ms, Ms, Ha, Ha
Ms, Ms, Ha, Ms, Ha, Ha, Aa^Fpa, Ms, Aa^Fpa, Aa^Qhu, Aa^Fpa, Rb, Rb, Ha, Aa, Aa^Fpa, Ha^Fpa, Ms, Ms, Ms, Ha, Aa, Ha, Ha^Fda, Aa^Fpa, Aa, Aa, Aa, Ha, Aa, Ha^Fpa, Aa, Ha, Ms, Ms, Ms, Ms, Ms, Ai, Ai, Ha, Ms, Ms, Ms
Ms, Ms^Xm, Ms^Xm, Ha, Ha, Ms, Ms, Ha, Aa^Qhuf, Aa^Qhu, Aa, Rb, Rb^Esa, Aa, Aa^Fpa, Aa^Fpa, Aa^Fpa, Ha^Fpa, Ms, Ms, Ms, Ms, Ha, Ha, Ha^Fpa, Aa, Aa, Ha, Ms, Ha, Ms, Ha, Ms, Ms, Ms, Ms, Ms, Ai, Ai, Ai, Ai, Ha, Ms, Ms
Ms^Xm, Ms^Xm, Ms^Xm, Ms, Ms, Ms, Aa^Fpa, Aa^Fpa, Cea, Cea, Cea, Aa, Aa, Rb^Esa, Aa^Fpa, Ha^Fpa, Ha, Ms, Ms, Ms, Ms, Ms, Ms, Ha, Ha, Ha, Ha, Ha, Ms, Ms, Ms, Ms, Ms, Ms, Ha, Ha, Ai, Ai, Ai, Ai, Ai, Ha, Ms, Ms^Xm
Ms^Xm, Ms^Xm, Ms^Xm, Ms, Ha, Ha, Ha^Fpa, Ha, Cea, 1 Kea, Cea, Aa, Aa^Fpa, Aa, Rb, Aa^Fpa, Ha, Ha, Ms, Ms, Ms, Ms, Ms, Ms, Ha, Ms, Ms, Ms, Ms, Ms^Xm, Ms, Ha, Ms, Ms, Ha, Ha, Ha, Ai, Ai, Ai, Ms^Xm, Ms, Ms, Ms^Xm
Ms^Xm, Ms^Xm, Ms^Xm, Ms, Ms, Ms, Aa^Fpa, Aa^Fpa, Gll^Esa, Cea, Aa^Fpa, Aa, Aa^Fpa, Aa, Rb, Aa^Fpa, Aa, Ms, Ms, Ms, Ms, Ms, Ms, Ms, Ha, Ms, Ms, Ms, Ms, Ms^Xm, Ms^Xm, Ms, Ha, Ms, Ha, Ha, Ha, Ai, Ms, Ms, Ms, Ms, Ha, Ms^Xm
Ms^Xm, Ms^Xm, Ms^Xm, Ms^Xm, Ha, Ha, Aa^Fpa, Aa, Rb, Rb^Esa, Aa, Aa^Fpa, Aa, Rb^Esa, Aa^Fpa, Aa^Fpa, Ms, Ms, Ms, Ms, Ms, Ms, Ms, Ha, Ha, Ms, Ms, Ms, Ms, Ms^Xm, Ms^Xm, Ha, Ha, Ms, Ha, Ms, Ms, Ha, Ms, Ms, Ha, Ha, Ms, Ms
Ms^Xm, Ms^Xm, Ms^Xm, Ms, Ms, Aa^Fpa, Aa^Fpa, Aa, Rb, Aa, Rb, Rb, Aa, Aa, Aa, Ms, Ms, Ms^Xm, Ms^Xm, Ms^Xm, Ms^Xm, Ms^Xm, Ms, Ms, Ms, Ms, Ms, Ms, Ms, Ms, Ms^Xm, Ha, Ms, Ha, Ms, Ms, Ms, Ms, Ms, Ms, Ms, Ha, Ms, Ms
Ms^Xm, Ms^Xm, Ms^Xm, Ms^Xm, Ms^Xm, Ms, Aa^Fpa, Aa^Fpa, Aa, Aa, Rb, Aa, Aa^Fpa, Aa^Fpa, Ha, Ha, Ms, Ms, Ms^Xm, Ms^Xm, Ms^Xm, Ms^Xm, Ms, Ms, Ms, Ms, Ms, Ms, Ms^Xm, Ms^Xm, Ms^Xm, Ms^Xm, Gg, Ms, Ms^Xm, Ms^Xm, Ms^Xm, Ms, Ms^Xm, Ms, Ms, Ms, Ms, Ms
