Gg, Gg, Gg, Gs, Gs, Gd, Gs, Rr, Gs, Gg, Gg, Gg, Rr, Gg, Gg, Gg, Gg, Gg, Gg, Gg, Gg, Gg, Gd, Gd, Gll^Fp, Gll^Fp, Gd, Gs
Gg, Gg, Gg, Gs, Gg, Gs, Gs, Rr, Ce, Gg, Gs^Fdw, Gg, Rr, Gg, Gg, Gg, Gs^Fdw, Gs^Fdw, Gs^Fdw, Gg, Gg, Gs, Gs, Gs, Gll^Fp, Gd^Fmw, Gg^Em, Ch
Gg, Gg, Ket, Gg, Ce, Gg, Rr, Rr, Gs, Gs^Fdw, Gs^Fdw, Gg^Em, Rr, Gg, Ce, Gs, Ce, Gs^Fdw, Ce, Gg, Gg, Gg, Gs, Gs^Fdw, Gg, Gs, Rr, Rr
Gg, Ce, Gg, Ce, Gg^Fet, Ce, Rrc, Rr, Ce, Ket, Ce, Ce, Rr, Gg, Gg^Ve, Ce, Gs, Ket, Gs^Fdw, Ce, Gs^Fdw, Gg, Ce, Gg, Rr, Rr, Gg, Gg
Ww, Gg, Gs^Fmw, Gs^Fmw, Gs^Fmw, Gs^Fdw, Rrc, Rrc, Gs^Fms, Wwf^Ewl, Wwf, Wwf^Ewl, Rrc, Gs, Gs, Gs^Fp, Gs^Fdw, Gg, Gs^Fdw, Ket, Ce, Ce, Rrc, Rrc, Ce, Ce, Ce, Gg
Ww, Ww, Ww, Gs^Fdw, Gs, Gs, Rrc, Gs^Fdw, Wwf, Wwf, Gs^Fmw, Wwf^Ewl, Gs^Fmw, Rrc, Rrc, Gs, Gs^Fmw, Gs^Fmw, Rrc, Gs^Fp, Rrc, Rrc, Gs, Gs, Gs, Gg, Ce, Gg
Ww, Ww, Wo, Ww, Ww, Gg^Ve, Ww^Bsb|, Gs^Fdw, Wwf, Gs^Fmw, Gs^Fmw, Rrc^Vhc, Gs^Fmw, Gs^Fmw, Rrc, Gg^Wm, Rrc, Rrc, Gs^Fmw, Rrc, Rrc, Gs, Rr^Vhc, Ch, Gg, Gg, Gg, Ce
Gg, Ww^Ewl, Ss, Wo, Wo, Ww, Ww^Bsb|, Ww, Ss, Ss, Gg, Rrc, Rrc, Gg^Eza, Rrc, Rrc, Rrc, Gg^Vh, Gs^Fmw, Gs^Fmw, Gs, Rrc, Rrc, Gs^Vh, Gs, Gg, Gg, Ket
Gg, Gg, Chs, Ss, Ww, Wo, Rrc, Ww, Ww, Ss, Gg, Rrc, Rrc^Vhc, Rrc, Rrc, Rrc^Vhc, Rrc, Gg, Gg, Gs^Fmw, Gs^Fmw, Gs, Gg, Rrc, Gg, Ww^Ewl, Ww, Ww
Gg, Gg, Gg, Wwr, Ww, Gg, Rrc, Ss, Ww, Wwr, Gg^Vh, Rrc, Rp^Vhc, Rrc, Rrc, Rrc^Vhc, Ss, Ss, Ss, Gs^Fmw, Ww, Ww^Es, Ww, Ww^Bsb|, Ww, Ww, Ww, Wo
Gg^Efm, Ket, Ce, Gg^Ve, Ww^Ewl, Gg^Wm, Rrc, Ss, Ww^Ewl, Ww, Ww, Gs^Fmw, Gs^Fmw, Rrc, Rrc, Gg, Ww, Ww, Wo, Wo, Ww, Ww, Ww, Ww^Bsb|, Ww, Ww, Gg, Ww
Rr, Gg, Rr, Gg, Rr, Rrc, Rp^Vhc, Gg^Fet, Gg^Vh, Ww, Wo, Ww, Ww, Gg^Ve, Ww^Bsb|, Ww, Wo, Wo, Ww, Ss, Ss, Wwr, Rrc, Rrc, Gll^Fp, Gg, Gg, Gg^Ve
Gg, Rr, Ce, Rr, Gg^Vh, Rrc, Rrc, Gs^Fmw, Gs^Fmw, Ch, Ww, Wo, Ch, Ww, Ww^Bsb|, Ww, Ch, Kh, Gs^Fmw, Gs^Fmw, Rrc, Rrc, Gll^Fp, Rrc, Gll^Fp, Gll^Fp, Gg, Rrc
Gg, Gg, Ce, Gs^Fmw, Ww, Gs^Fmw, Rrc, Rrc, Rrc, Gg, Ww, Wo, Gg^Fet, Gs^Fmw, Rrc, Gg, Rp^Vhc, Gs^Fmw, Rrc, Rrc, Gg, Gg, Gll^Fp, Rrc, Rrc, Gll^Fp, Gs^Vh, Rrc
Gg, Gg, Gg, Gs^Fdw, Rrc, Rrc, Ch, Gs^Fmw, Ww, Ww^Bsb\, Ww^Bsb\, Ww, Gg^Ve, Gg, Ch, Rrc, Rrc, Rrc, Gg^Ve, Ch, Ss, Ss, Gg, Gll^Fp, Gg^Ve, Rrc, Rrc, Rrc
Rr, Rr, Rr, Rrc, Gs^Fmw, Rp^Vhc, Wwr, Ww, Ww, Ww, Ss, Gg, Ch, Ch, Ch, Rrc, Rrc, Gg^Fet, Gs^Fp, Kh, Ss, Ss, Gg, Gg^Em, Gg, Rrc, Gs^Vh, Gg
Gg, Ce, Ww, Gg^Wm, Ww, Gs^Fmw, Ww, Ww, Gs^Fmw, Gs^Fmw, Ss, Gg^Ve, Ch, 2 Kh, Ch, Gg^Fet, Gs^Fdw, Rrc, Gg, Ch, Gs^Fmw, Ss, Gll^Fp, Gll^Fp, Gg, Rrc, Rrc, Gg
Ww, Ww, 4 Ket, Ww, Gs^Fdw, Ww, Ww, Ch, Gs, Gs^Fdw, Rrc, Ss, Rrc, Ch, Gs^Fdw, Ch, Rrc, Rrc, Gg, Ch, Gs^Fdw, Gs^Fmw, Gd^Fmw, Gd^Fmw, Gll^Fp, Gg, Gs^Vh, Rrc
Gg, Gg, Ce, Gs^Vht, Rrc, Rrc, Rrc, Ww, Ww^Bsb/, Rrc, Gs^Fdw, Rrc, Rp^Vhc, Rrc, Rrc, Gs^Fdw, Rrc, Rrc, Rrc, Gs^Fdw, Gg^Ve, Gs^Fmw, Gs^Fdw, Gd^Fmw, Gg^Em, Gg, Rrc, Rrc
Gg, Gs, Rr, Rrc, Ce, Gs^Fmw, Gg, Rrc, Ss, Ww, Ww, Ch, Gs^Fdw, Gg, Rrc, Rrc, Kh, Ch, Gg, Rrc, Rrc, Gs^Fdw, Gg^Fet, Gg, Rrc, Rrc, Gd^Fmw, Gg
Rr, 1 Rr, Gs, Gs, Ce, Gs^Fmw, Gs^Fmw, Gg^Em, Ss, Ss, Ww, Gg, Gs^Fdw, Gs^Fmw, Rrc, Rp^Vhc, Gs^Fdw, Gs^Fdw, Gs^Fdw, Gg, Gg, Rrc, Rrc, Rrc, Gg^Fet, Gs^Fdw, Gd^Fmw, Gd^Fmw
Gg, Gs, Gd, Gs, Ce, Gs^Fmw, Gs^Fmw, Gs^Fdw, Wwf^Ewl, Ww^Ewl, Ww, Gs^Fdw, Gs^Fmw, Gs^Fdw, Rrc, Gs^Fmw, Gs^Fdw, Gs^Fmw, Gs^Fdw, Gg, Gg, Gg, Rrc, Gg, Gg, Gll^Fp, Gll^Fp, Gll^Fp
Gg, Gd, Gd, Gg, Ce, Gll^Fp, Gll^Fp, Gll^Fp, Wwf^Es, Ww, Wwr, Gll^Fp, Gg^Fet, Rrc, Gg^Fet, Gll^Fp, Gll^Fp, Gd^Fmw, Gd^Fmw, Gs^Fdw, Gs^Fdw, Gg^Fet, Rrc, Gg, Gg, Gg, Ket, Ce
Gg, Gs, Ket, Ce, Gll^Fp, Gd^Fmw, Gd^Fmw, Wwf, Ww, Ww, Ss, Ss, Gg, Rrc, Ww, Gll^Fp, Gll^Fp, Gll^Fp, Gd^Fmw, Gd^Fmw, Gs^Fdw, Gd^Fmw, Gd^Fmw, Rrc, Rr, Ce, Gll^Fp, Gll^Fp
Gll^Fp, Gll^Fp, Ce, Gll^Fp, Gd^Fmw, Gll^Fp, Gs, Wwf^Es, Wwf^Ewl, Ww, Ww, Ss, Ww, Ww^Bsb|, Ww, Ww, Ww, Wwf, Ww, Wwr, Wwf^Ewl, Gd^Fmw, Ket, Ce, Gg, Rr, Gll^Fp, Gll^Fp
Gs, Gll^Fp, Ce, Gll^Fp, Gg, Rr, Rr, Gs^Vh, Gg, Ww, Wwr, Ww, Ww, Ww^Bsb|, Ww, Ww, Wo, Ww, Ww, Ww^Ewl, Ww^Ewl, Ce, Gll^Fp, Gll^Fp, Gg, Rr, Gg, Gg
Gs, Gg, Gll^Fp, Ce, Ket, Gg, Gll^Fp, Rr, Rr, Gs^Vh, Gg, Gg, Gs^Vh, Rrc, Wwf, Ww, Wo, Wo, Wo, Wo^Ewl, Wo^Ewf, Ce, Gll^Fp, Gll^Fp, Gll^Fp, Rr, Gll^Fp, Ch
Gg, Gs, Gll^Fp, Gll^Fp, Ce, Gs, Gll^Fp, Gd^Fmw, Gll^Fp, Rr, Rr, Gs^Vh, Rrc, Rrc, Gg, Wwr, Wo^Ewf, Wo^Ewl, Wo, Wo, Ce, Ce, Gll^Fp, Gll^Fp, Gll^Fp, Rr, Rr, Ch
Gll^Fp, Gs, Gll^Fp, Gll^Fp, Ce, Gll^Fp, Gll^Fp, Gd^Fmw, Gll^Fp, Gll^Fp, Gg, Rrc, Gs, Gg, Gg, Wwr, Wwr, Wo^Ewf, Wo, Ket, Gll^Fp, Gll^Fp, Gll^Fp, Gll^Fp, Gd^Fmw, Gd^Fmw, Gs, Rr
Gll^Fp, Gll^Fp, Gg, Gs, Ket, Gll^Fp, Ce, Ce, Ce, Ce, Gg, Rr, Ce, Ce, Ket, Ce, Ce, Ww^Ewl, Ce, Ce, Gll^Fp, Gll^Fp, Gll, Gll^Fp, Gd, Gd^Fmw, Gs, Gg
Gll^Fp, Gd^Fmw, Gll^Fp, Gs, Gs, Ce, Gg, Gg, Gs, Gd^Fmw, Rr, Rr, Gs, Gg, Gll^Fp, Gg, Gg, Ce, Gg, Gll^Fp, Gd^Fmw, Gll^Fp, Gll, Gd, Gll^Fp, Gd, Gs, Gs
Gll^Fp, Gll^Fp, Gd^Fmw, Gs, Gll^Fp, Gg, Gs, Gll^Fp, Gll^Fp, Rr, Gs, Gll^Fp, Gll^Fp, Gll^Fp, Gll^Fp, Gg, Gll^Fp, Gg, Gll^Fp, Gg, Gd^Fmw, Gll^Fp, Gd^Fmw, Gll, Gll^Fp, Gll^Fp, Gll^Fp, Gll
Gll^Fp, Gll^Fp, Gd^Fmw, Gll^Fp, Gs, Gll^Fp, Gs, Gll^Fp, Gll^Fp, Rr, Gs, Gs, Gg, Gll^Fp, Gd^Fmw, Gll^Fp, Gll^Fp, Gs, Gll^Fp, Gd^Fmw, Gll^Fp, Gll^Fp, Gll^Fp, Gll^Em, Gd^Fmw, Gll^Fp, Gll^Fp, Gll^Fp
Gll^Fp, Gll^Fp, Gll^Fp, Gll^Fp, Gll^Fp, Gll^Fp, Gll^Fp, Gg, Gll^Fp, Rr, Rr, Gg^Ve, Gll^Fp, Gll^Fp, Gd^Fmw, Gd^Fmw, Gll^Fp, Gs, Gs, Gll^Fp, Gll^Fp, Gll^Fp, Gll^Fp, Gll^Fp, Gll^Fp, Gll^Fp, Gd^Fmw, Gd^Fmw
Gll^Fp, Gd^Fmw, Gd^Fmw, Hh, Hh, Gll^Fp, Hh, Gll^Fp, Gll^Fp, Gll^Fp, Rr, Gll^Fp, Gd^Fmw, Gll^Fp, Gd^Fmw, Gd^Fmw, Gll^Fp, Gs, Gll^Fp, Gll^Fp, Gd^Fmw, Gll^Fp, Gll^Fp, Gll^Fp, Gs^Em, Re^Vl, Re, Gll^Fp
Gll^Fp, Gll^Fp, Gll^Fp, Hh, Hh, Hh, Hh, Gll^Fp, Gll^Fp, Gll^Fp, Rr, Gll^Fp, Gll^Fp, Gll^Fp, Gll^Fp, Gll^Fp, Gg, Gll^Fp, Gll^Fp, Gll^Fp, Gll^Fp, Gll^Fp, Gll^Fp, Gd^Fmw, Re, Re, Gs, Re
