Xoc, Xoc, Xoc, Xoc, Xoc, Xoc, Cv, Cv, Wwt, Wwt, Wwrt, Wwrt, Wwrt, Wwrt, Wwrt, Wwt, Wwt, Cv, Cv, Xoc, Xoc, Xoc, Xoc, Xoc, Xoc
Xoc, Xoc, Xoc, Xoc, Cv, Cv, Wwt, Wwt, Isr, Isr, Isr, Isr, Gg^Fet, Isr, Isr, Isr, Isr, Wwt, Wwt, Cv, Cv, Xoc, Xoc, Xoc, Xoc
Xoc, Xoc, Cv, Cv, Wwt, Wwt, Isr, Isr, Gs^Fds, Isr, Xoc, Isr, Isr, Isr, Xoc, Isr, Gs^Fms, Isr, Isr, Wwt, Wwt, Cv, Cv, Xoc, Xoc
Xoc, Cv, Wwt, Wwt, Isr, Isr, Isr, Gs^Fms, Gg^Fet, Isr, 2 Isc, Isr, Isr, Isr, 6 Isc, Isr, Gg^Fet, Gs^Fds, Isr, Isr, Isr, Wwt, Wwt, Cv, Xoc
Xoc, Cv, Wwt, Wwrt, Wwrt, Isr, Isr, Gs^Fds, Isr, Isr, Isr, Isr, 5 Isc^Ii, Isr, Isr, Isr, Isr, Gs^Fds, Isr, Isr, Wwrt, Wwrt, Wwt, Cv, Xoc
Xoc, Cv, Wwt, Isr, Isr, Gg^Fet, Isr, Isr, Isc, Isr, Gg^Fet, Isr, Isr, Isr, Gg^Fet, Isr, Isc, Isr, Isr, Gg^Fet, Isr, Isr, Wwt, Cv, Xoc
Xoc, Cv, Wwt, Isr, Isr, Isr, Gs^Fds, Isr, Isr, Isr, Isr, Isr, Wwt, Isr, Isr, Isr, Isr, Isr, Gs^Fds, Isr, Isr, Isr, Wwt, Cv, Xoc
Xoc, Cv, Wwt, Isr, Isr, Xoc, Gs^Fds, Isr, Isr, 1 Isc^Ii, Isr, Wwt, Wwt, Wwt, Isr, 8 Isc^Ii, Isr, Isr, Gs^Fms, Xoc, Isr, Isr, Wwt, Cv, Xoc
Xoc, Cv, Wwt, Isr, Isr, Isr, Isr, Isr, Isc, Isr, Gg^Fet, Isr, Isr, Isr, Gg^Fet, Isr, Isc, Isr, Isr, Isr, Isr, Isr, Wwt, Cv, Xoc
Xoc, Cv, Wwt, Isr, Wwrt, Gg^Fet, Isr, Isr, Isr, Isr, Isr, Isr, 4 Isc^Ii, Isr, Isr, Isr, Isr, Isr, Isr, Gg^Fet, Wwrt, Isr, Wwt, Cv, Xoc
Xoc, Cv, Wwt, Wwrt, Isr, Isr, Isr, Gs^Fms, Gg^Fet, Isr, 3 Isc, Isr, Isr, Isr, 7 Isc, Isr, Gg^Fet, Gs^Fds, Isr, Isr, Isr, Wwrt, Wwt, Cv, Xoc
Xoc, Cv, Cv, Wwt, Wwt, Isr, Isr, Gs^Fds, Gs^Fms, Isr, Xoc, Isr, Isr, Isr, Xoc, Isr, Gs^Fms, Gs^Fds, Isr, Isr, Wwt, Wwt, Cv, Cv, Xoc
Xoc, Xoc, Xoc, Cv, Cv, Wwt, Wwt, Isr, Isr, Isr, Isr, Isr, Gg^Fet, Isr, Isr, Isr, Isr, Isr, Wwt, Wwt, Cv, Cv, Xoc, Xoc, Xoc
Xoc, Xoc, Xoc, Xoc, Xoc, Cv, Cv, Wwt, Wwt, Isr, Isr, Isr, Wwrt, Isr, Isr, Isr, Wwt, Wwt, Cv, Cv, Xoc, Xoc, Xoc, Xoc, Xoc
Xoc, Xoc, Xoc, Xoc, Xoc, Xoc, Xoc, Cv, Cv, Wwt, Wwt, Isr, Wwrt, Isr, Wwt, Wwt, Cv, Cv, Xoc, Xoc, Xoc, Xoc, Xoc, Xoc, Xoc
