border_size=1
usage=map

Xos, Xos, Xos, Xos, Xos, Xos, Xos, Xos, Cv, Rrc, Rrc, Rrc, Rrc, Rrc, Rrc, Rrc, Cv, Xos, Xos, Xos, Xos, Xos, Xos, Xos, Xos
Xos, Xos, Xos, Xos, Xos, Xos, Xos, Xos, Cv, Rrc, Rrc, Rrc, Rrc, Rrc, Rrc, Rrc, Cv, Xos, Xos, Xos, Xos, Xos, Xos, Xos, Xos
Xos, Xos, Xos, Xos, Xos, Xos, Xol, Xol, Cv, Rrc, Rrc, Rrc, Gg^Fet, Rrc, Rrc, Rrc, Cv, Xol, Xol, Xos, Xos, Xos, Xos, Xos, Xos
Cv, Cv, Cv, Cv, Cv, Cv, Cv, Cv, Rrc, Rrc, Rrc, Rrc, Rrc, Rrc, Rrc, Rrc, Rrc, Cv, Cv, Cv, Cv, Cv, Cv, Cv, Cv
Rrc, Rrc, Rrc, Rrc, Rrc, Rrc, Rrc, Rrc, Gg^Fet, Gg^Fet, Rrc, Ch, 5 Kh, Ch, Rrc, Gg^Fet, Gg^Fet, Rrc, Rrc, Rrc, Rrc, Rrc, Rrc, Rrc, Rrc
Wwf, Rrc, Wwf, Rrc, Wwf, Gg^Fet, Wwf, Rrc, Rrc, Rrc, 2 Ch, Ch, Wwf, Ch, 6 Ch, Rrc, Rrc, Rrc, Wwf, Gg^Fet, Wwf, Rrc, Rrc, Rrc, Rrc
Rrc, Wwf, Rrc, Wwf, Rrc, Wwf, Rrc, Rrc, Ch, Ch, Gg, Wwf, Wwg, Wwf, Gg, Ch, Ch, Rrc, Rrc, Wwf, Rrc, Wwf, Wwf, Wwf, Wwf
Rrc, Rrc, Rrc, Rrc, Rrc, Rrc, Rrc, Rrc, Ch, 1 Kh, Gg, Wwf, Wwg, Wwf, Gg, 8 Kh, Ch, Rrc, Rrc, Rrc, Rrc, Rrc, Rrc, Rrc, Rrc
Wwf, Wwf, Wwf, Wwf, Wwf, Wwf, Wwf, Rrc, Rrc, Ch, 3 Ch, Wwf, Wwf, Wwf, 7 Ch, Ch, Rrc, Rrc, Wwf, Wwf, Wwf, Wwf, Wwf, Wwf, Wwf
Rrc, Rrc, Rrc, Rrc, Rrc, Gg^Fet, Rrc, Rrc, Gg^Fet, Rrc, Rrc, Ch, 4 Kh, Ch, Rrc, Rrc, Gg^Fet, Rrc, Rrc, Gg^Fet, Rrc, Rrc, Rrc, Rrc, Rrc
Rrc, Rrc, Rrc, Rrc, Rrc, Rrc, Rrc, Rrc, Rrc, Gg^Fet, Rrc, Ch, Rrc, Ch, Rrc, Gg^Fet, Rrc, Rrc, Rrc, Rrc, Rrc, Rrc, Rrc, Rrc, Rrc
Cv, Cv, Cv, Cv, Cv, Cv, Cv, Cv, Cv, Rrc, Rrc, Rrc, Gg^Fet, Rrc, Rrc, Rrc, Cv, Cv, Cv, Cv, Cv, Cv, Cv, Cv, Cv
Xos, Xos, Xos, Xos, Xos, Xos, Xos, Xos, Xos, Cv, Rrc, Rrc, Rrc, Rrc, Rrc, Cv, Xos, Xos, Xos, Xos, Xos, Xos, Xos, Xos, Xos
Xos, Xos, Xos, Xos, Xos, Xos, Xos, Xos, Xos, Cv, Rrc, Rrc, Rrc, Rrc, Rrc, Cv, Xos, Xos, Xos, Xos, Xos, Xos, Xos, Xos, Xos
