Gg, Gg, Gg, Gs, Gg, Gll^Fp, Gll^Fp, Gll, Gll^Fp, Gg, Gll^Fp, Gll^Fp, Gll^Fp, Gg, Gll^Fp, Hh, Hh, Hh, Hh, Hh, Hh^Fms, Hh, Gs^Fms, Gs^Fms, Gll^Fp, Gg, Gll^Fp, Gll^Fp, Gll^Fp, Gll^Fp, Gll^Fp, Gg, Ss, Ss, Ss, Gg, Ss, Ss, Ss, Gs, Gs, Gg, Gll^Fp, Gll^Fp, Gs^Fp, Gs^Fms, Gll^Fp, Gll^Fp, Gll^Fp, Gll^Fp, Gll^Fp, Gll^Fp
Gg, Gg, Gs, Gs, Gs, Gll, Gg^Efm, Gll, Gll^Fp, Gll^Fp, Gg, Gg^Efm, Gg, Gll^Fp, Gs^Fms, Gll^Fp, Hh^Fp, Hh^Fms, Hh^Fds, Hh, Hh, Hh, Gg, Gs, Gs, Gll^Fp, Gll, Gs^Fms, Gll^Fp, Gs^Fms, Ss, Ss, Ss, Ss, Ss, Ss, Ss, Ss, Gs, Gs, Gll^Fp, Gll^Fp, Gs^Fms, Gll^Fp, Gs, Gs^Fp, Gs^Fms, Gll^Fp, Gll^Fp, Gs^Fms, Gs^Fds, Gll^Fp
Gg, Gs, Gs, Gs, Gg, Gs, Gg, Gg, Gg, Gg, Gg, Gg^Efm, Gll^Fp, Gll^Fp, Gs^Fds, Gs^Fds, Gll^Fp, Hh, Gg, Gg, Gg, Gg, Gg, Gs, Gs, Gll, Gll, Gll^Fp, Tb^Tf, Ss^Tf, Ss, Ss, Ss, Ss, Ss^Emf, Ss, Ss, Ss, Ss, Gs, Gs, Gs, Gg, Gs, Gs, Gs^Fp, Gll^Fp, Gs^Fds, Gll^Fms, Gs^Fds, Gs^Fms, Gs^Fms
Gg, Gg, Gs, Gg, Re, Gs, Gs, Re, Gs, Re, Re, Re, Gll^Fp, Gll^Fp, Re, Gll^Fp, Re, Gs, Ds, Re, Re, Gg^Efm, Gg^Efm, Gs^Fp, Gs^Fp, Gs^Fp, Gs^Fms, Gs^Fp, Gs^Fp, Ss^Emf, Ss, Ss, Ss, Gs^Fp, Gs^Fp, Ss, Ss, Ss, Ss, Ss, Gs^Fp, Gs^Fp, Gs^Fms, Gs^Fp, Gs^Fp, Gll^Fp, Gs^Fds, Gs^Fds, Gs^Fms, Gll^Fms, Gs^Fms, Gs^Fms
Re, Gg, Gg, Gg, Re, Re, Ds^Esd, Gs, Re, Gs, Gs, Gs, Gs, Re, Re, Gs^Fms, Re, Gs^Fms, Ds^Esd, Gll^Fp, Gll^Fp, Gg^Efm, Gs, Gs, Gs, Gs^Fp, Gs^Fp, Gs^Fms, Ss, Ss^Tf, Gs^Fp, Ss, Ss, Ss^Vhs, Ss, Ss, Chs, Chs, Chs, Ss^Emf, Ss^Tf, Gd^Fp, Ss^Vhs, Gs^Fp, Gs^Fp, Gs^Fms, Gs^Fms, Gs^Fp, Gs^Fds, Gs^Fms, Gs^Fds, Gs^Fms
Gg, Re, Gg, Gs, Gs, Gs, Re, Ds, Re, Re, Gg, Gg, Gs, Re, Gs^Fp, Gll^Fp, Gs^Fms, Re, Gg^Fms, Ds, Re, Gd^Fp, Gg^Efm, Gg^Efm, Gs^Fp, Gs^Fms, Ss, Gs^Fp, Ss, Ss, Ss, Ss, Ss, Ss, Ss, Ss, Chs, 5 Khr, Chr, Ss^Emf, Ss^Emf, Gd, Gd^Fp, Ss, Gll^Tf, Gs^Fms, Gs^Em, Gs^Fms, Gll^Fp, Gs^Fds, Gll^Fp, Gll^Fp
Gg, Re, Re, Gs, Gs, Gs^Vht, Re, Ds, Re, Re, Gs, Gg, Ds^Esd, Gg, Gll^Fp, Gs^Fms, Gs^Fms, Gs^Fms, Gs^Fp, Gg^Fp, Gs, Re, Gg, Gs, Gg^Efm, Ss, Ss, Gg, Ss^Em, Ss, Ss, Ss, Ss^Tf, Ss, Ss, Chs^Em, Ss, Chr, Ss, Ss, Ss, Ss, Ss, Ss^Emf, Tb^Tf, Gs^Fp, Gs^Fp, Gs^Fms, Gll^Fp, Gs^Fds, Gll^Fp, Gll^Fp
Gs, Gg, Gg, Gd, Re, Gs, Gs, Gs, Gs^Fms, Gg, Gs, Ds, Ds, Gg, Gg, Gg, Re, Gg, Ds^Esd, Gs, Gs, Gs, Gg^Efm, Gs, Ds^Esd, Gg, Ds, Gg, Ds, Ss, Ss, Gs^Fp, Gs^Fms, Ss^Emf, Ss, Ss, Ss, Ss, Ss, Ss, Gs^Vht, Ss, Gs, Ss, Gd^Fms, Ss^Emf, Ss, Gs^Fp, Gll^Fp, Gs^Fms, Gll^Fp, Gll^Fp
Gs, Gs, Gs^Fds, Gg, Gs, Rd, Rd, Gs, Re, Gs^Fms, Gs, Gs, Gg, Re, Gs, Re, Re, Ds^Esd, Ds, Gs, Gs, Gg^Efm, Gs, Gs, Ds, Ds, Gs^Fms, Ds, Ss, Ss, Gd, Ss, Ss, Ss^Vhs, Ss, Ss, Ss, Ss, Ss, Ds, Ss, Ss, Gs^Fp, Ss, Gd^Fms, Ss, Gg, Gll^Fp, Gll^Emf, Tb^Tf, Gll^Fp, Gll^Fp
Hh, Gs, Gs, Gg, Gs, Re, Re, Gg, Gg, Gs, Gs, Re, Gg, Gg, Gg^Efm, Gs, Gg, Gg, Gg^Ve, Gs, Gs^Fds, Gs, Gs, Gs^Fp, Gd, Gd, Gs^Fp, Ss, Ss, Ss, Gs, Ds, Ss, Ss, Ss, Ss, Ds, Ss, Ds, Ss, Ss, Ss, Gs^Fp, Gs^Fms, Gs^Fp, Ss, Gg, Gs^Fms, Gll^Em, Gll^Tf, Gll^Fp, Gll^Fp
Hh, Hh^Fds, Gs, Gg, Gs, Ds, Ds, Re, Rd, Gd, Gs, Gg, Gs^Fms, Gg, Gg, Re, Gg, Gs, Gs, Gg, Gs^Fds, Gs^Fds, Gs^Fds, Gs, Gd, Ds, Gg, Gg, Ss, Ss, Ss, Ds, Ds, Ss, Gs, Gs, Ds^Esd, Gs, Ds, Ss, Gs^Fp, Gg, Ss, Ss, Ss, Ss, Gs^Fms, Gg, Gll, Gll^Emf, Gs^Fms, Gll^Fp
Hh, Hh, Hh, Gg, Gg, Ds^Esd, Ds^Esd, Gg, Gs, Rd, Gs, Re, Gg, Re, Re, Gg, Re, Gg, Gs, Gs, Gg, Gs^Fds, Gs^Fds, Gs^Fds, Gg, Gd, Gg, Gg, Gs^Fms, Ss, Ss, Ss, Ss, Hh, Ds, Ss, Ss, Ds, Hh, Gs^Fms, Gs^Fp, Ss, Ss, Gs^Fp, Gd, Gd, Gs^Fp, Gs^Fp, Gll^Fp, Gll^Fp, Gll^Fp, Gll^Fp
Hh^Fds, Hh^Fds, Gs, Gs, Gs^Fds, Gg, Rd, Rd, Gg, Re, Ds^Es, Gg, Gs, Re, Re^Edt, Gs, Gg, Re^Edt, Gg, Gs, Gs, Gs^Fds, Gs^Fds, Gg, Gs, Gg, Gg, Gs^Fds, Gs^Fms, Gs^Fms, Gs, Gg, Gg, Ds^Esd, Gd, Ss, Gs, Hh, Gs, Gs, Hh, Ss, Ss, Ss, Hh, Hh^Vhh, Hh, Gs^Fp, Gs^Fms, Gs^Fms, Gs^Fms, Gs^Fds
Hh, Hh, Gg, Gg, Gs^Fds, Gg, Re, Gs^Fds, Gs^Fds, Rd, Ds, Ds, Gs, Gg^Edt, Gs^Edt, Gs^Edt, Gg^Vc, Rd^Edt, Re, Gs, Gs, Gs, Gs, Gs, Gs, Gg, Ds, Gs^Fds, Gg, Gg, Gs, Gs^Fp, Ds, Gd, Gd, Hh, Gg, Gs, Gg, Gs^Fms, Gs^Fp, Hh, Gs, Gs^Fp, Hh, Hh, Mm, Hh, Hh, Gll^Fp, Gs^Fds, Gs^Fds
Gg, Gs, Gs, Gg, Gs^Fms, Gs^Fms, Re, Re, Gs, Re, Rd, Gg^Edt, Ch, Gd, Gg, Gg^Edt, Gg, Re, Gg, Ds^Es, Ds, Ds^Esd, Gg, Gs, Hh, Ds, Ds, Gs, Gs, Gg, Gg, Ds^Esd, Gg, Gg, Gg, Gg, Mm, Hh, Gg, Gs^Fms, Gg, Gg, Gs, Gs, Gs, Gg, Hh, Mm, Hh^Fp, Gll^Fp, Gs^Fms, Gs^Fms
Gs^Fms, Gll^Fp, Gs^Fms, Gg, Gs, Re, Ds, Gg, Gs^Vc, Gd, Re, Chr, 4 Khr, Chr, Chr, Gs, Gs, Gs^Es, Gs, Gg, Gs^Fds, Gg, Gs, Gs, Gg, Hh, Gs, Gg, Gs, Gg, Hh, Gg, Hh, Hh, Mm, Mm, Mm, Mm, Hh, Gg, Hh, Hh, Gg, Gs, Gg, Gs^Fms, Gg, Hh, Hh, Hh^Fp, Gll^Fp, Gll^Fp
Gll^Fp, Gll^Fp, Gg, Gg, Gg, Ds, Ds, Gg^Es, Gg^Edt, Gd^Edt, Re, Chr, Chr, Ch, Gg, Gg, Gg^Edt, Gs^Es, Gs, Gs^Fds, Gs, Gg, Gg, Ds^Esd, Gs, Gs, Gg, Gg, Gg, Hh, Gs, Hh, Gs, Hh, Mm, Mm, Hh, Gd, Hh, Hh^Vhh, Hh, Hh, Gs, Hh, Hh, Gs^Fp, Mm, Gg, Hh, Hh, Gll^Fp, Gll^Fp
Gg, Gg, Gg, Gg, Gs, Gg, Gs^Fms, Gg, Gg, Re^Edt, Rd, Gg^Edt, Gd, Ch, Gg, Re, Re^Edt, Gs, Gs, Gs^Fds, Gs, Gg, Re, Re^Es, Gs, Gg, Hh, Gs, Gs^Fms, Gs^Fms, Gs, Gs, Gs, Hh, Hh, Hh, Gd, Gd, Gs^Fms, Gg, Hh, Hh, Gs, Gs^Fp, Hh, Mm, Mm, Mm, Mm, Hh, Hh^Fp, Gll^Fp
Hh, Hh, Hh, Gg, Gs, Gs, Gs^Fms, Gs^Fds, Gg, Gs^Es, Gs, Re^Edt, Re^Edt, Gg, Gg^Es, Re^Edt, Gg, Gg, Gg, Gs, Gs, Gg, Ds, Re, Mm, Hh, Hh, Gs, Gs, Gs^Fp, Gs^Fms, Gs, Gs, Hh, Gg, Gs, Hh, Gs^Fp, Gs^Fp, Gg, Gg, Gg, Gs, Gs, Gs, Hh, Hh, Mm, Mm, Mm, Hh, Hh
Mm, Hh, Hh, Gg, Gs, Gs^Fds, Gs, Gs^Fms, Gg, Gg, Gg, Gd^Edt, Rd, Gg^Edt, Gs, Gg, Gg, Gg, Re, Hh, Gg, Gg, Hh, Hh, Mm, Mm, Gs, Hh, Hh, Gs, Gs, Gg, Gs, Hh, Hh, Gs, Gg, Gg, Gg, Gg, Hh, Hh, Gg, Gs, Gg, Gg^Efm, Hh, Mm, Hh, Hh, Hh, Hh
Mm, Mm, Hh, Hh, Hh, Gs, Gs, Gg^Efm, Hh, Hh, Gg, Rd, Gg, Gs, Re, Gs, Hh, Gs, Re, Re, Gg, Gs, Hh, Mm, Mm, Hh, Gs, Gs, Hh, Gs, Gs, Gg, Hh, Hh, Gg, Gg, Gg, Gg, Gg, Gg, Gs^Fms, Hh, Gg, Gg, Hh, Hh, Gg, Hh, Gg, Gs, Gs, Hh
Mm, Mm, Hh, Hh, Mm, Gs, Gs, Gs, Gs, Gll^Fms, Gs, Re, Gll^Fms, Re, Re, Gg^Vh, Hh, Hh, Gs, Gg, Hh, Gs, Hh, Mm, Hh, Hh, Gs, Gg, Gg, Hh, Gg, Gg, Gg, Hh, Hh, Gg, Gg, Hh, Gg, Gs^Fms, Gs^Fms, Gg^Ve, Gs, Gs, Gs, Hh, Gg, Gg, Gs, Gs, Gg, Gg
Hh, Gll^Fp, Gll^Fp, Hh, Mm, Mm, Gs, Hh, Gg, Gd, Re, Re, Gs^Fms, Gll^Fms, Hh, Gs, Gs, Gs, Hh, Mm, Mm, Gg, Gg, Hh, Gg, Gs, Gg, Gg, Gg, Gd, Gs, Gs^Fms, Gs^Fds, Gg, Hh, Hh, Gg, Gg, Gg, Gs^Fms, Gg, Re, Re^Eff, Gs^Eff, Gs, Gg, Gg, Gg, Gg, Gll^Fp, Gll^Fp, Gll^Fp
Gg, Gll^Fp, Gll^Fp, Hh, Hh, Hh, Gs^Fp, Gs, Gd, Gs, Re, Gs, Gs, Gs^Fms, Gg, Hh, Hh, Gs, Gs^Fms, Mm, Hh, Hh, Gg, Gg, Gg, Gg, Hh, Hh, Gg, Gg, Gd, Gd^Fms, Gg^Efm, Gg, Gg, Gg, Gg, Gs, Gs, Gs, Gg^Eff, Gg^Eff, Gd, Gs, Gs^Fp, Gs, Gs^Fp, Gg, Gg, Gll^Fp, Gll^Fp, Gs^Fms
Gll^Fp, Gll^Em, Gll^Emf, Gll^Fp, Gs^Fp, Gs^Fp, Gs^Fms, Hh, Gd, Gs^Es, Gs^Edt, Re, Re, Gs, Gg, Hh, Gs^Fp, Gs, Gs^Fms, Gg, Gg, Gg, Gg, Gg, Gs^Fds, Gg, Gg, Gg, Gg, Gg, Gg, Gg, Gg, Gg, Gs^Fds, Gg, Gg, Gg, Gs, Gs, Gg, Re, Gg, Gg, Gg, Gs^Fms, Gs^Fms, Gs^Fp, Gg, Gg, Gll^Fp, Gg
Gll^Fp, Gll^Fp, Gs^Em, Gll^Fp, Re, Re, Gs^Fms, Hh, Gs, Gd, Gg^Edt, Gg^Edt, Gg, Gd, Re, Gg, Gs^Fp, Gs^Fms, Gs^Fp, Gg, Gg, Hh, Gg^Efm, Gg, Gs^Fms, Gs^Fms, Gs^Fds, Gs^Fms, Gs^Fds, Gg^Es, Gs, Gs, Gs, Gg, Gs^Fds, Gs^Fms, Gs^Fp, Gg, Gg, Gg, Gg, Re, Re, Gg, Gg, Gs^Fp, Gg, Gs^Fp, Gg, Gs, Gg, Gg
Uu^Tf, Gll^Emf, Gll^Fp, Gg, Re, Gg^Efm, Gg, Gs^Fp, Gs^Fms, Gs, Hh, Hh, Gg^Edb, Gg^Edb, Gs, Re, Re, Gs^Fms, Gg^Efm, Gg, Gg, Hh, Gs, Gg, Gs^Fms, Gs^Fms, Gll^Fp, Gll^Fp, Gs^Fms, Gs^Fds, Gll^Fp, Gd, Gg, Gg, Gg, Gg, Gg, Gg, Gg, Gg, Gs^Fms, Gg, Re, Gg, Gg^Efm, Gg, Gg^Efm, Gg, Gg, Gg, Gs, Gs
Gll^Emf, Tb^Tf, Gll^Fp, Gg^Em, Gg^Em, Gg, Gs^Fms, Gs^Fp, Gg, Gs^Fp, Gg, Gs, Gg^Edb, Gd^Edb, Gd, Gs, Re, Gg, Gg, Gg, Re, Gg^Efm, Re, Gs, Gg, Gs^Fms, Gs, Gll^Fp, Gs^Fms, Gll^Fp, Gs, Gll^Fp, Gg, Gg, Gg^Efm, Gg, Gs, Gg, Gg, Gs^Fms, Gs^Fds, Gs^Fp, Gg, Re, Rp, Gg, Gs, Gg, Gg, Gg, Gs, Gs
Gll^Fp, Gll^Tf, Gll^Fp, Gg^Em, Ss, Gs^Fp, Gll^Fp, Gg, Gg, Gg, Gd, Gs, Gs^Fms, Gs^Fp, Gs, Gd^Es, Re, Re, Re, Re, Gg^Vhr, Re, Gs, Gs, Re, Gg, Gs, Gs^Fms, Gll^Fp, Gll^Fp, Re, Re^Ve, Gs^Fds, Gg, Gg, Gs, Gs, Gg, Gs^Fds, Gs^Fms, Gs^Fds, Gs^Fms, Gg, Gs, Gs, Rp, Gs^Fp, Gg, Gg, Gg, Gg, Gg
Ss, Ss, Gll^Fp, Gll^Fp, Ss, Ss, Ss^Edb, Gg^Edb, Gg, Gg^Edb, Gg^Edb, Gd, Gd, Gs^Fp, Re, Re, Gs^Edb, Gs^Edb, Gg, Gs^Fms, Gll^Fds, Gll^Fds, Gs^Fms, Gs^Fms, Gg, Re, Gs, Gs, Re, Re, Gs^Fms, Gs^Fds, Gg^Efm, Gg^Efm, Gs, Gs, Gs, Gg^Efm, Gg^Efm, Gg, Gg, Gg, Gg, Gs, Gs, Rp, Gs^Fms, Gs^Fp, Gg, Gg, Gg, Gg
Ss, Ss, Ss, Ss, Sm, Ss, Ss^Vhs, Ss^Edb, Ss^Edb, Gg^Edb, Ss, Ss, Gg, Gg^Edb, Ss^Edb, Gg^Edb, Gg^Efm, Gg^Edb, Gg, Gg, Gs^Fds, Gll^Fms, Gg, Gg, Gg, Re, Re, Gd, Re, Gs^Fds, Gs, Gs, Gg, Gs, Gs, Gs, Gs, Gg^Efm, Gs, Gs, Gs, Gs, Chr, Chr, Ch, Rp, Gg, Gs^Fms, Gs, Gg, Gs, Gg
Ss, Ss, Ss, Sm, Sm, Sm, Ss, Gg^Edb, Gg^Edb, Ss^Edb, Ss, Ss, Gg^Efm, Ss^Edb, Ss^Edb, Ss^Edb, Gg^Efm, Gg, Gg, Gll^Fp, Gs^Fms, Gs^Fms, Gg^Fds, Gg, Gg^Efm, Gg, Gs, Re, Gg, Gs^Fms, Gg, Gs, Gs, Gg, Gg, Gs, Gg, Gg, Gs, Gs, Gg^Vc, Gs, Ch, 2 Khr, Chr, Rp, Rp, Rp, Re, Gg, Re, Gg
Ss, Ss, Sm, Sm, Gs^Fp, Sm, Ss^Emf, Ss^Edb, Ss^Edb, Gg^Edb, Ss, Ss, Ss, Gs^Fp, Ss, Ss, Gd, Gg, Ss, Gll^Fp, Gll^Fp, Gll^Fp, Gg^Fds, Gs^Fms, Gg, Gd, Gg, Re, Gd, Gg^Es, Gg^Es, Gs, Gs, Gg^Efm, Gg, Gg^Efm, Gs^Fms, Gg, Gg^Efm, Gg, Gg, Gs, Gg, Ch, Rp, Rp, Gs^Vht, Gg, Gg, Rp, Gg, Re
Ss, Ss, Ss, Sm, Gs^Fp, Gs^Fp, Tb^Tf, Ss, Gd, Gs^Fp, Gll^Fp, Ss, Gs^Fp, Gs^Fms, Ss^Edb, Ss^Edb, Gd^Edb, Ss^Edb, Gs^Fms, Gs^Fp, Gg^Efm, Gll^Fp, Gg, Gg^Fds, Gs^Fp, Gs^Fms, Gg^Efm, Gg, Re, Gs, Gs, Gg^Efm, Gg^Efm, Gs, Gg, Gg, Gs^Fp, Gs^Fds, Gs^Fds, Gg, Re, Re, Rp, Rp, Gs, Gs, Gs, Gg, Gg, Gs, Gg, Gg
Ss, Ss, Sm, Ss, Ss^Emf, Ss^Tf, Ss^Tf, Gs^Fp, Gd, Gd^Efm, Gs^Fp, Gd^Fp, Gs^Fms, Gs^Fp, Gg^Edb, Ss^Edb, Gs^Fp, Gd^Edb, Ss^Edb, Gs^Fp, Gs^Fms, Gg, Gg, Gg^Efm, Gs, Gs, Gg, Gg^Efm, Re, Gs, Gs^Vht, Gg, Gg^Efm, Gg^Efm, Gg^Efm, Gg, Re, Gs^Fms, Rp, Rp, Gg, Gs, Gs, Gg, Gg^Vc, Gs, Gg, Gg, Gg, Gg, Gs^Fds, Gg
Ss, Ss, Sm, Ss, Ss, Ss, Chs, Ss^Emf, Ss, Ss^Vhs, Ss, Gs^Fp, Gg^Efm, Ss, Ss, Gg^Em, Ss^Edb, Ss^Edb, Ss^Edb, Gs^Fms, Gg, Gg, Gg^Es, Gg, Gs, Gs, Gs, Gs, Re, Gs, Gg^Efm, Gg, Ce, Ce, Ce, Re, Gg^Efm, Re, Gg, Gg, Gg^Efm, Gs, Gs, Gs^Fds, Gg, Gg, Gg, Gg, Gg, Gg, Gs^Fds, Gs^Fds
Ss, Sm, Ss^Edb, Ss^Edb, Gs^Fp, Chs, 3 Khr, Chr, Chr, Ss^Edb, Ss^Edb, Gg^Efm, Gll^Fp, Ss^Emf, Ss^Tf, Gg^Efm, Gg, Ss^Edb, Gs^Fp, Gs^Fms, Gs^Fp, Ss, Ss, Gg, Gg, Gg, Gs^Fms, Gs^Fp, Gg^Efm, Re, Re, Re, Ce, 1 Ke, Ce, Gg^Efm, Gg^Efm, Gg, Gs, Gg, Gg, Gs, Gg, Gg, Gs^Fds, Gs, Gs, Gs^Fds, Gg, Gg, Gs^Fds, Gs^Fds
Ss, Ss, Ss^Edb, Ss^Edb, Ss^Emf, Chs, Chs, Ss^Tf, Ss^Edb, Ss^Edb, Ss^Edb, Ss^Edb, Ss, Gll^Fp, Tb^Tf, Gs^Fp, Gs^Fp, Ss, Gll^Fp, Gs^Fms, Gs^Fp, Ss, Gs^Fp, Gs^Fp, Gg^Efm, Gs^Fp, Gs^Fms, Gs^Fp, Gg^Efm, Re, Gg^Efm, Gg^Efm, Gg^Efm, Ce, Gg, Gg, Gs, Gs, Gd, Gs, Gg, Gg, Gg, Gg, Gs, Gs, Gs^Fds, Gs^Fds, Gs^Fds, Gg, Gg, Gs^Fds
Gg, Ss^Edb, Ss^Edb, Ss, Ss, Ss^Tf, Ss^Emf, Ss^Edb, Ss, Ss^Edb, Gg^Efm, Gg, Gg, Ss^Vhs, Ss, Gg, Gg^Efm, Ss, Gll^Fp, Gg^Efm, Gll^Fp, Gg, Gs^Fds, Gs^Fp, Gs^Fp, Gg, Gs, Gs, Gg^Vh, Re, Gg^Efm, Gg, Gs^Vht, Gg, Gg^Efm, Gg^Efm, Gg^Efm, Gs, Gs^Fp, Gd, Gs^Fp, Gg, Gs^Fms, Gs^Fp, Gs, Gs, Gs^Fms, Gs^Fms, Gs^Fds, Gg, Gg, Gg
Gg, Ss, Ss, Ss, Gs^Fp, Gll^Tf, Gs^Fp, Ss, Ss^Edb, Ss^Edb, Ss^Edb, Gs^Fp, Ss, Gg, Ss, Ss, Ss, Ss, Gg, Gs^Fp, Gs^Fp, Gs^Fp, Gs^Fms, Gs^Fms, Gs^Fp, Gs^Fp, Gs^Fp, Gg^Efm, Rp, Rp, Gg^Efm, Gs, Gs, Gll^Fp, Gll^Fp, Gll^Fp, Gs^Fp, Gs^Fp, Gs^Fp, Gs^Fms, Gs^Fms, Gs^Fms, Gll^Fp, Gs^Fp, Gs^Fp, Gs^Fp, Gs^Fms, Gs^Fp, Gg, Gll^Fp, Gs, Gg
Gll^Fp, Gg, Gs^Fp, Gll^Tf, Gs^Fp, Ss^Emf, Gll^Fp, Ss, Ss^Edb, Ss^Edb, Gg, Gg, Ss, Gg, Gg, Gg, Ss, Gg, Gg, Gg, Gll^Fp, Gll^Fp, Gs^Fds, Gs^Fms, Gs^Fds, Gg^Em, Gs, Gg, Rp, Gg, Gg, Gg, Gs, Gs, Gs, Gll^Fp, Gs, Gll^Fp, Gs^Fms, Gs^Fds, Gs^Fds, Gll^Fp, Gll^Fp, Gll^Fp, Gll^Fp, Gll^Fp, Gg, Gg, Gs^Fms, Gll^Fp, Gs^Fms, Gll^Fp
Gll^Fp, Gs^Fp, Tb^Tf, Gs^Fp, Gll^Fp, Gll^Tf, Tb^Tf, Ss^Emf, Gg, Ss^Edb, Ss, Ss, Ss, Ss, Ss, Ss, Ss, Ss, Gg, Gg, Gll^Fp, Gs^Fms, Gs^Fds, Gs^Fms, Gs^Fms, Gs^Fms, Gs^Em, Gg, Rp, Gs, Gg, Gg, Gg, Gs, Gs, Gg, Gs, Gs^Em, Gll^Fp, Gll^Fp, Gll^Fp, Gll^Fp, Gll^Fp, Gll^Fp, Gs, Gll^Fp, Gg, Gll^Fp, Gs^Fds, Gs^Fms, Gs^Fms, Gll^Fp
Gll^Fp, Gll^Fp, Gll^Tf, Ss^Emf, Gs^Fms, Tb^Tf, Gll^Tf, Gll^Fp, Gg, Gg, Ss, Ss, Ss, Ss, Ss, Ss, Ss, Ss, Ss, Gll^Fp, Gll^Fp, Gs^Fds, Gs^Fms, Gs^Fds, Gll^Fp, Gll^Fp, Gg, Gg, Re, Gg, Gg, Gs, Gs, Gll^Fp, Gll^Fp, Gs, Gll^Fp, Gs, Gll^Fp, Gs^Fms, Gll^Fp, Gs, Gs, Gs, Gg, Gg, Gg, Gll^Fp, Gll^Fp, Gs^Fds, Gll^Fp, Gg
Gll^Fp, Gll^Fp, Gll^Fp, Gll^Fp, Gll^Fp, Gll^Fp, Gll^Fp, Gll^Fp, Gg, Ss, Ss, Ss, Ss, Ss, Ss, Ss, Ss, Ss, Ss, Ss, Gg, Gll^Fp, Gg, Gg, Gg, Gll^Fp, Gg, Gg, Rp, Gg, Gg, Gg, Gg, Gs, Gg, Gll^Fp, Gll^Fp, Gll^Fp, Gll^Fp, Gll^Fp, Gg, Gll^Fp, Gll^Fp, Gg, Gg, Gs, Gg, Gll^Fp, Gll^Fp, Gll^Fp, Gll^Fp, Gg
