border_size=1
usage=map

Re          , Gs          , Gs          , Re          , Gs          , Re          , Re          , Re          , Gg          , Gs          , Re          , Gg          , Re          , Gs          , Ds          , Re          , Re          , Ggf         , Ggf         , Gs^Fp       , Gs^Fp       , Gs^Fp       , Gs^Fms      , Gs^Fp       , Gs^Fp       , Ss          , Ss          , Ss          , Ss          , Gs^Fp       , Gs^Fp       , Ss          , Ss          , Ss          , Ss          , Ss          , Gs^Fp       , Gs^Fp       , Gs^Fms      , Gs^Fp       , Gs^Fp       , Gs^Fp       , Gs^Fms      , Gs^Fp       
Re          , Re          , Ds          , Gs          , Re          , Gs          , Gs          , Gs          , Gs          , Re          , Re          , Gs          , Re          , Gs^Fms      , Ds          , Gs          , Gs          , Ggf         , Gs          , Gs          , Gs          , Gs^Fp       , Gs^Fp       , Gs^Fms      , Ss          , Ss          , Gs^Fp       , Ss          , Ss          , Ss^Vhs      , Ss          , Ss          , Chs         , Chs         , Chs         , Ss          , Ss          , Gs^Fp       , Ss^Vhs      , Gs^Fp       , Gs^Fp       , Gs^Fms      , Gs^Fms      , Gs^Fp       
Gs          , Gs          , Re          , Ds          , Re          , Re          , Gg          , Gg          , Gs          , Re          , Gs          , Gs          , Gs          , Re          , Gg          , Ds          , Re          , Gg          , Ggf         , Ggf         , Gs^Fp       , Gs^Fms      , Ss          , Gs^Fp       , Ss          , Ss          , Ss          , Ss          , Ss          , Ss          , Ss          , Ss          , Chs         , 5 Khr       , Chr         , Ss          , Ss          , Gs          , Gs^Fp       , Ss          , Gs          , Gs^Fms      , Gs          , Gs^Fp       
Gs          , Gs^Vht      , Re          , Ds          , Re          , Re          , Gs          , Gg          , Ds          , Gg          , Gs          , Gs          , Gs^Fms      , Gs          , Gs          , Gg          , Gs          , Re          , Gg          , Gs          , Ggf         , Ss          , Ss          , Gg          , Ss          , Ss          , Ss          , Ss          , Ss          , Ss          , Ss          , Chs         , Ss          , Chr         , Ss          , Ss          , Ss          , Ss          , Ss          , Ss          , Gs^Fp       , Gs^Fp       , Gs^Fp       , Gs^Fms      
Gs          , Gs          , Gs          , Gs          , Gs^Fms      , Gg          , Gs          , Ds          , Ds          , Gg          , Gg          , Gg          , Re          , Gg          , Ds          , Gs          , Gs          , Gs          , Ggf         , Gs          , Ds          , Gg          , Ds          , Gg          , Ds          , Ss          , Ss          , Gs^Fp       , Gs^Fms      , Ss          , Ss          , Ss          , Ss          , Ss          , Ss          , Ss          , Gs^Vht      , Ss          , Gs          , Ss          , Gs^Fms      , Ss          , Ss          , Gs^Fp       
Gs          , Gs          , Re          , Gs          , Re          , Gs^Fms      , Gs          , Gs          , Gg          , Re          , Gs          , Re          , Re          , Ds          , Ds          , Gs          , Gs          , Ggf         , Gs          , Gs          , Ds          , Ds          , Gs^Fms      , Ds          , Ss          , Ss          , Gs          , Ss          , Ss          , Ss^Vhs      , Ss          , Ss          , Ss          , Ss          , Ss          , Ds          , Ss          , Ss          , Gs^Fp       , Ss          , Gs^Fms      , Ss          , Gg          , Gs^Fp       
Gs          , Re          , Re          , Re          , Gg          , Gs          , Gs          , Re          , Gg          , Gg          , Ggf         , Gs          , Gg          , Gg          , Gg^Ve       , Gs          , Gs^Fds      , Gs          , Gs          , Gs^Fp       , Gs          , Gs          , Gs^Fp       , Ss          , Ss          , Ss          , Gs          , Ds          , Ss          , Ss          , Ss          , Ss          , Ds          , Ss          , Ds          , Ss          , Ss          , Ss          , Gs^Fp       , Gs^Fms      , Gs^Fp       , Ss          , Gg          , Gs^Fms      
Gs          , Ds          , Ds          , Gg          , Gg          , Gg          , Gs          , Gg          , Gs^Fms      , Gg          , Gg          , Re          , Gg          , Gs          , Gs          , Gg          , Gs^Fds      , Gs^Fds      , Gs^Fds      , Gs          , Gs          , Ds          , Gg          , Gg          , Ss          , Ss          , Ss          , Ds          , Ds          , Ss          , Gs          , Gs          , Ds          , Gs          , Ds          , Ss          , Gs^Fp       , Gg          , Ss          , Ss          , Ss          , Ss          , Gs^Fms      , Gg          
Gg          , Ds          , Ds          , Gg          , Gs          , Gs          , Gs          , Re          , Gg          , Re          , Re          , Gg          , Re          , Gg          , Gs          , Gs          , Gg          , Gs^Fds      , Gs^Fds      , Gs^Fds      , Gg          , Gs          , Gg          , Gg          , Gs^Fms      , Ss          , Ss          , Ss          , Ss          , Hh          , Ds          , Ss          , Ss          , Ds          , Hh          , Gs^Fms      , Gs^Fp       , Ss          , Ss          , Gs^Fp       , Gs          , Gg          , Gs^Fp       , Gs^Fp       
Gs^Fds      , Gg          , Rd          , Rd          , Gg          , Re          , Ds          , Gg          , Gg          , Re          , Re          , Gs          , Gg          , Re          , Gg          , Gs          , Gs          , Gs^Fds      , Gs^Fds      , Gg          , Gs          , Gg          , Gg          , Gs^Fds      , Gs^Fms      , Gs^Fms      , Gs          , Gg          , Gg          , Ds          , Gs          , Ss          , Gs          , Hh          , Gs          , Gs          , Hh          , Ss          , Ss          , Ss          , Hh          , Hh^Vhh      , Hh          , Gs^Fp       
Gs^Fds      , Gg          , Re          , Gs^Fds      , Gs^Fds      , Gs          , Ds          , Ds          , Gg          , Gg          , Gg          , Gs          , Gg^Vc       , Rd          , Re          , Gs          , Gs          , Gs          , Gs          , Gs          , Gs          , Gg          , Ds          , Gs^Fds      , Gg          , Gg          , Gs          , Gs^Fp       , Ds          , Gg          , Gg          , Hh          , Gg          , Gs          , Gg          , Gs^Fms      , Gs^Fp       , Hh          , Gs          , Gs^Fp       , Hh          , Hh          , Mm          , Hh          
Gs^Fms      , Gs^Fms      , Re          , Re          , Gs          , Gs          , Gg          , Gg          , Ch          , Gg          , Gg          , Gg          , Gg          , Re          , Gg          , Ds          , Ds          , Ds          , Gg          , Gs          , Hh          , Ds          , Ds          , Gs          , Gs          , Gg          , Gg          , Ds          , Gg          , Gg          , Gg          , Gg          , Mm          , Hh          , Gg          , Gs^Fms      , Gg          , Gg          , Gs          , Gs          , Gs          , Gg          , Hh          , Mm          
Gs          , Re          , Ds          , Gg          , Gg^Vc       , Gg          , Gg          , Chr         , 4 Khr       , Chr         , Chr         , Gg          , Gs          , Gs          , Gs          , Gg          , Gs^Fds      , Gg          , Gs          , Gs          , Gg          , Hh          , Gs          , Gg          , Gs          , Gg          , Hh          , Gg          , Hh          , Hh          , Mm          , Mm          , Mm          , Mm          , Hh          , Gg          , Hh          , Hh          , Gg          , Gs          , Gg          , Gs^Fms      , Gg          , Hh          
Gg          , Ds          , Ds          , Gg          , Gg          , Gg          , Re          , Chr         , Chr         , Ch          , Gg          , Gg          , Gg          , Gs          , Gs          , Gs^Fds      , Gs          , Gg          , Gg          , Ds          , Gs          , Gs          , Gg          , Gg          , Gg          , Hh          , Gs          , Hh          , Gs          , Hh          , Mm          , Mm          , Hh          , Gs          , Hh          , Hh^Vhh      , Hh          , Hh          , Gs          , Hh          , Hh          , Gs^Fp       , Mm          , Gg          
Gs          , Gg          , Gs^Fms      , Gg          , Gg          , Re          , Gs          , Gg          , Gg          , Ch          , Gg          , Re          , Re          , Gs          , Gs          , Gs^Fds      , Gs          , Gg          , Re          , Re          , Gs          , Gg          , Hh          , Gs          , Gs^Fms      , Gs^Fms      , Gs          , Gs          , Gs          , Hh          , Hh          , Hh          , Gs          , Gs          , Gs^Fms      , Gg          , Hh          , Hh          , Gs          , Gs^Fp       , Hh          , Mm          , Mm          , Mm          
Gs          , Gs          , Gs^Fms      , Gs^Fds      , Gg          , Gs          , Gs          , Gg          , Gs          , Gg          , Gg          , Re          , Gg          , Gg          , Gg          , Gs          , Gs          , Gg          , Ds          , Re          , Mm          , Hh          , Hh          , Gs          , Gs          , Gs^Fp       , Gs^Fms      , Gs          , Gs          , Hh          , Gg          , Gs          , Hh          , Gs^Fp       , Gs^Fp       , Gg          , Gg          , Gg          , Gs          , Gs          , Gs          , Hh          , Hh          , Mm          
Gs          , Gs^Fds      , Gs          , Gs^Fms      , Gg          , Gg          , Gg          , Ds          , Gg          , Gg          , Gs          , Gg          , Gg          , Gg          , Re          , Hh          , Gg          , Gg          , Hh          , Hh          , Mm          , Mm          , Gs          , Hh          , Hh          , Gs          , Gs          , Gg          , Gs          , Hh          , Hh          , Gs          , Gg          , Gg          , Gg          , Gg          , Hh          , Hh          , Gg          , Gs          , Gg          , Ggf         , Hh          , Mm          
Hh          , Gs          , Gs          , Ggf         , Hh          , Hh          , Gg          , Gg          , Gg          , Gs          , Re          , Gs          , Hh          , Gs          , Re          , Re          , Gg          , Gs          , Hh          , Mm          , Mm          , Hh          , Gs          , Gs          , Hh          , Gs          , Gs          , Gg          , Hh          , Hh          , Gg          , Gg          , Gg          , Gg          , Gg          , Gg          , Gs^Fms      , Hh          , Gg          , Gg          , Hh          , Hh          , Gg          , Hh          
Mm          , Gs          , Gs          , Gs          , Gs          , Hh          , Gs          , Gs          , Gs^Fms      , Re          , Re          , Gg^Vh       , Hh          , Hh          , Gs          , Gg          , Hh          , Gs          , Hh          , Mm          , Hh          , Hh          , Gs          , Gg          , Gg          , Hh          , Gg          , Gg          , Gg          , Hh          , Hh          , Gg          , Gg          , Hh          , Gg          , Gs^Fms      , Gs^Fms      , Gg^Ve       , Gs          , Gs          , Gs          , Hh          , Gg          , Gg          
Mm          , Mm          , Gs          , Hh          , Gs          , Gg          , Gs          , Gs          , Gs^Fms      , Gs^Fms      , Hh          , Gs          , Gs          , Gs          , Hh          , Mm          , Mm          , Gg          , Gg          , Hh          , Gg          , Gs          , Gg          , Gg          , Gg          , Gg          , Gg          , Gs^Fms      , Gs^Fds      , Gg          , Hh          , Hh          , Gg          , Gg          , Gg          , Gs^Fms      , Gg          , Gg          , Gs          , Gs          , Gs          , Gg          , Gg          , Gg          
Hh          , Hh          , Gs^Fp       , Gs          , Gs          , Hh          , Hh          , Hh          , Gs          , Gs^Fms      , Gg          , Hh          , Hh          , Gs          , Gs^Fms      , Mm          , Hh          , Hh          , Gg          , Gg          , Gg          , Gg          , Hh          , Hh          , Gg          , Gg          , Gg          , Gs^Fms      , Ggf         , Gg          , Gg          , Gg          , Gg          , Gs          , Gs          , Gs          , Gg          , Gg          , Gs          , Gs          , Gs^Fp       , Gs          , Gs^Fp       , Gg          
Gs^Fp       , Gs^Fp       , Gs^Fms      , Hh          , Gs          , Gs          , Gg          , Hh          , Gs          , Gs          , Gs          , Hh          , Gs^Fp       , Gs          , Gs^Fms      , Gg          , Gg          , Gg          , Gg          , Gg          , Gs^Fds      , Gg          , Gg          , Gg          , Gg          , Gg          , Gg          , Gg          , Gg          , Gg          , Gs^Fds      , Gg          , Gg          , Gg          , Gs          , Gs          , Gg          , Re          , Gg          , Gg          , Gg          , Gs^Fms      , Gs^Fms      , Gs^Fp       
Re          , Re          , Gs^Fms      , Hh          , Gs          , Gs          , Gg          , Gg          , Re          , Re          , Gg          , Gg          , Gs^Fp       , Gs^Fms      , Gs^Fp       , Gg          , Gg          , Hh          , Ggf         , Gg          , Gs^Fms      , Gs^Fms      , Gs^Fds      , Gg          , Gg          , Gg          , Gs          , Gs          , Gs          , Gg          , Gs^Fds      , Gs^Fms      , Gs^Fp       , Gg          , Gg          , Gg          , Gg          , Re          , Re          , Gg          , Gg          , Gs^Fp       , Gg          , Gs^Fp       
Re          , Ggf         , Gg          , Gs^Fp       , Gs^Fms      , Gs          , Hh          , Hh          , Gg          , Gg          , Gs^Fms      , Ggf         , Gg          , Gs^Fms      , Ggf         , Gg          , Gg          , Hh          , Gs          , Gg          , Gs          , Gs^Fms      , Gs^Fms      , Gg          , Gs          , Gs          , Gs          , Gs          , Gg          , Gg          , Gg          , Gg          , Gg          , Gg          , Gg          , Gg          , Gs^Fms      , Gg          , Re          , Gg          , Ggf         , Gg          , Ggf         , Gg          
Gg          , Gg          , Gs^Fms      , Gs^Fp       , Gg          , Gs^Fp       , Gg          , Gg          , Gg          , Gg          , Gs          , Gg          , Gs          , Gg          , Gg          , Gg          , Gg          , Ggf         , Gs          , Gs          , Gg          , Gg          , Gs          , Gg          , Gg          , Gg          , Gs          , Gg          , Gg          , Gg          , Ggf         , Gg          , Gs          , Gg          , Gg          , Gs^Fms      , Gs^Fds      , Gs^Fp       , Gg          , Re          , Rp          , Gg          , Gs          , Gg          
Ss          , Gs^Fp       , Gs^Fp       , Gg          , Gg          , Gg          , Gs          , Gs          , Gs^Fms      , Gs^Fp       , Gs          , Gs          , Gs          , Gg          , Gg          , Gg          , Gg^Vh       , Gg          , Gs          , Gs          , Gg          , Gg          , Gs          , Gs          , Gg          , Gg          , Gs^Fds      , Gg^Ve       , Gs^Fds      , Gg          , Gg          , Gs          , Gs          , Gg          , Gs^Fds      , Gs^Fms      , Gs^Fds      , Gs^Fms      , Gg          , Gs          , Gs          , Rp          , Gs^Fp       , Gg          
Ss          , Ss          , Ss          , Gg          , Gg          , Gg          , Gg          , Gs          , Gg          , Gs^Fp       , Gg          , Gs          , Gs          , Gs          , Gg          , Gs^Fms      , Gs^Fds      , Gs^Fds      , Gs^Fms      , Gs^Fms      , Gg          , Gg          , Gs          , Gs          , Gs          , Gs^Fms      , Gs^Fms      , Gs^Fds      , Ggf         , Ggf         , Gs          , Gs          , Gs          , Ggf         , Ggf         , Gg          , Gg          , Gg          , Gg          , Gs          , Gs          , Rp          , Gs^Fms      , Gs^Fp       
Ss          , Ss          , Ss^Vhs      , Ss          , Ss          , Gg          , Ss          , Ss          , Gg          , Gg          , Ss          , Gg          , Ggf         , Gg          , Gg          , Gg          , Gg          , Gs^Fms      , Gg          , Gg          , Gg          , Gg          , Gs          , Gs          , Gs          , Gs^Fds      , Gs          , Gs          , Gg          , Gs          , Gs          , Gs          , Gs          , Ggf         , Gs          , Gs          , Gs          , Gs          , Chr         , Chr         , Ch          , Rp          , Gg          , Gs^Fms      
Gg          , Gg          , Ss          , Gg          , Gg          , Ss          , Ss          , Ss          , Ggf         , Ss          , Ss          , Ss          , Ggf         , Gg          , Gg          , Gs          , Gs          , Gs          , Gg          , Gg          , Ggf         , Gg          , Gg          , Gs          , Gg          , Gs^Fms      , Gg          , Gs          , Gs          , Gg          , Gg          , Gs          , Gg          , Gg          , Gs          , Gs          , Gg^Vc       , Gs          , Ch          , 2 Khr       , Chr         , Rp          , Rp          , Rp          
Gs^Fp       , Gg          , Ss          , Ss          , Ss          , Gg          , Ss          , Ss          , Ss          , Gs^Fp       , Ss          , Ss          , Gg          , Gg          , Ss          , Gg          , Gs^Fp       , Gs          , Gg          , Gg          , Gg          , Gg          , Gg          , Gg          , Gs          , Gg          , Gg          , Gs          , Gs          , Ggf         , Gg          , Ggf         , Gs^Fms      , Gg          , Ggf         , Gg          , Gg          , Gs          , Gg          , Ch          , Rp          , Rp          , Gs^Vht      , Gg          
Gs^Fp       , Gs^Fp       , Ss          , Ss          , Gg          , Gs^Fp       , Gs^Fp       , Ss          , Gs^Fp       , Gs^Fms      , Ss          , Ss          , Gg          , Ss          , Gs^Fms      , Gs^Fp       , Ggf         , Gg          , Gg          , Gg          , Gs^Fp       , Gs^Fms      , Ggf         , Gg          , Gs          , Gs          , Gs          , Ggf         , Ggf         , Gs          , Gg          , Gg          , Gs^Fp       , Gs^Fds      , Gs^Fds      , Gg          , Re          , Re          , Rp          , Rp          , Gs          , Gs          , Gs          , Gg          
Ss          , Ss          , Ss          , Gs^Fp       , Gg          , Ggf         , Gs^Fp       , Gs^Fp       , Gs^Fms      , Gs^Fp       , Gg          , Ss          , Gs^Fp       , Gg          , Ss          , Gs^Fp       , Gs^Fms      , Gg          , Gg          , Ggf         , Gs          , Gs          , Gg          , Ggf         , Gs          , Gs          , Gs^Vht      , Gg          , Ggf         , Ggf         , Ggf         , Gg          , Re          , Gs^Fms      , Rp          , Rp          , Gg          , Gs          , Gs          , Gg          , Gg^Vc       , Gs          , Gg          , Gg          
Ss          , Ss          , Chs         , Ss          , Ss          , Ss^Vhs      , Ss          , Gs^Fp       , Ggf         , Ss          , Ss          , Gg          , Ss          , Ss          , Ss          , Gs^Fms      , Gg          , Gg          , Gg          , Gg          , Gs          , Gs          , Gs          , Gs          , Gg          , Gs          , Ggf         , Gg          , Ce          , Ce          , Ce          , Re          , Ggf         , Re          , Gg          , Gg          , Ggf         , Gs          , Gs          , Gs^Fds      , Gg          , Gg          , Gg          , Gg          
Gs^Fp       , Chs         , 3 Khr       , Chr         , Chr         , Ss          , Ss          , Ggf         , Gs^Fp       , Ss          , Ss          , Ggf         , Gg          , Ss          , Gs^Fp       , Gs^Fms      , Gs^Fp       , Ss          , Ss          , Gg          , Gg          , Gg          , Gs^Fms      , Gs^Fp       , Ggf         , Gg          , Re          , Re          , Ce          , 1 Ke        , Ce          , Ggf         , Ggf         , Gg          , Gs          , Gg          , Gg          , Gs          , Gg          , Gg          , Gs^Fds      , Gs          , Gs          , Gs^Fds      
Ss          , Chs         , Chs         , Ss          , Ss          , Ss          , Ss          , Ss          , Ss          , Gs^Fp       , Gs^Fp       , Gs^Fp       , Gs^Fp       , Ss          , Gs^Fp       , Gs^Fms      , Gs^Fp       , Ss          , Gs^Fp       , Gs^Fp       , Ggf         , Gs^Fp       , Gs^Fms      , Gs^Fp       , Ggf         , Re          , Ggf         , Ggf         , Ggf         , Ce          , Gg          , Gg          , Gs          , Gs          , Gs          , Gs          , Gg          , Gg          , Gg          , Gg          , Gs          , Gs          , Gs^Fds      , Gs^Fds      
Ss          , Ss          , Ss          , Ss          , Ss          , Ss          , Ggf         , Gg          , Gg          , Ss^Vhs      , Ss          , Gg          , Ggf         , Ss          , Gs^Fp       , Ggf         , Gs^Fp       , Gg          , Gs^Fp       , Gs^Fp       , Gs^Fp       , Gg          , Gs          , Gs          , Gg^Vh       , Re          , Ggf         , Gg          , Gs^Vht      , Gg          , Ggf         , Ggf         , Ggf         , Gs          , Gs^Fp       , Gg          , Gs^Fp       , Gg          , Gs^Fms      , Gs^Fp       , Gs          , Gs          , Gs^Fms      , Gs^Fms      
Gs^Fp       , Gs^Fp       , Gs^Fp       , Ss          , Ss          , Ss          , Ss          , Gs^Fp       , Ss          , Gg          , Ss          , Ss          , Ss          , Ss          , Gg          , Gs^Fp       , Gs^Fp       , Gs^Fp       , Gs^Fp       , Gs^Fms      , Gs^Fp       , Gs^Fp       , Gs^Fp       , Ggf         , Rp          , Rp          , Ggf         , Gs          , Gs          , Gs^Fp       , Gs^Fp       , Gs^Fp       , Gs^Fp       , Gs^Fp       , Gs^Fp       , Gs^Fms      , Gs^Fms      , Gs^Fms      , Gs^Fms      , Gs^Fp       , Gs^Fp       , Gs^Fp       , Gs^Fms      , Gs^Fp       
