border_size=1
usage=map

Gs^Fdw      , Gs^Fdw      , Gs^Fdw      , Gs^Fdw      , Gs          , Gs          , Ds          , Ds          , Ds          , Gs^Fdw      , Gs^Fdw      , Gs^Fdw      , Gs^Fmw      , Gs^Fmw      , Gs^Fmw      , Gs^Fmw      , Re^Gvs      , Gg          , Ggf         , Rr          , Gg          , Re          , Re^Gvs      , Re^Gvs      , Re^Gvs      , Gs^Fmw      , Gs^Fmw      , Gs^Fmw      , Gs^Fms      , Gs^Fms      , Gg          , Gg          , Gs^Fms      , Gs^Fms      , Gs^Fms      , Rr          , Rr          , Gs          , Gs          , Gs^Fms      , Gs^Fms      , Gs^Fms      
Rd          , Rd          , Re          , Gs^Fdw      , Ds          , Rd          , Rd          , Ds          , Gs^Fdw      , Gs^Fdw      , Gs          , Gs          , Gs          , Gs^Fmw      , Re          , Re^Gvs      , Re          , Re^Gvs      , Re^Gvs      , Rr          , Gg          , Gg          , Gg          , Re          , Re^Gvs      , Re^Gvs      , Gs^Fmw      , Gs^Fmw      , Gs^Fmw      , Gs^Fmw      , Gs^Fmw      , Gs^Fms      , Gs^Fds      , Gs^Fds      , Re^Gvs      , Re^Gvs      , Re^Gvs      , Rr          , Re^Gvs      , Gs^Fms      , Gs^Fds      , Gs^Fms      
Rd          , Re          , Rd          , Gs          , Ds          , Re          , Re          , Gs          , Gs^Fmw      , Gs          , Ss          , Ss          , Ss          , Gs          , Rd          , Re^Gvs      , Re          , Re^Gvs      , Gs^Fmw      , Rr          , Gg          , Gg          , Re          , Re^Gvs      , Re          , Gs^Fmw      , Gs^Fmw      , Gs^Fmw      , Gs^Fmw      , Gs^Fms      , Gs^Fms      , Gs^Fds      , Gs^Fds      , Wwf         , Ww          , Re          , Re^Gvs      , Rr          , Rp          , Re^Gvs      , Gs^Fds      , Gs^Fms      
Re          , Re          , Ss^Vhs      , Ss          , Ds          , Ss          , Re          , Rd          , Gs          , Gs          , Rd          , Ss          , Re          , Ss          , Rd          , Gs^Fmw      , Gg          , Gg          , Gg^Vh       , Rr          , Ggf         , Re          , Re^Gvs      , Re          , Re^Gvs      , Gg          , Gg          , Gs^Fms      , Gg          , Gg^Ve       , Gs^Fds      , Gs^Fds      , Gs^Fds      , Ww          , Wo          , Ww          , Re^Gvs      , Re          , Ch          , Rp          , Wwf         , Gs          
Gs          , Rd          , Ss          , Ss          , Ss          , Ss          , Gs          , Rd          , Gs          , Gs^Vht      , Rd          , Re          , Ss          , Ss          , Rd          , Gg          , Gg          , Gg          , Gg          , Rr          , Gg          , Gs^Fmw      , Gs^Fmw      , Re^Gvs      , Gs^Fms      , Gg          , Gs^Fp       , Chr         , Wwf         , Gs^Fms      , Ww          , Wwf         , Ww          , Wo          , Wo          , Ww          , Ww          , Gs^Fds      , Ww          , Rp          , Ww          , Wwf         
Gs          , Gs          , Ds          , Ss          , Ss          , Ds          , Ds          , Gs^Fdw      , Gs          , Ds          , Gs          , Re          , Ds          , Ss          , Rd          , Gs          , Chr         , Gg          , Re^Gvs      , Rr          , Rr          , Gs^Fmw      , Gg          , Gs^Fmw      , Gg          , Gg          , Gg          , Ww^Bw\      , Ww          , Ww          , Wo          , Ww          , Wo          , Wo          , Wo          , Wo          , Ww          , Ww          , Ww          , Ww^Bw|      , Ww          , Ww          
Rd          , Gs          , Ds          , Ss          , Ds          , Ss          , Ds          , Ds          , Ds          , Ds          , Gs          , Gs^Fdw      , Ds          , Ss          , Gs          , Rd          , Chr         , Chr         , Re          , Re^Gvs      , Rr          , Ggf         , Re          , Gs^Fmw      , Re^Gvs      , Gg          , Gs^Fdw      , Wwf         , Ww          , Wo          , Wo          , Wo          , Wo          , Wo          , Wo          , Ww          , Wwf         , Wwf         , Wwf         , Ww^Bw|      , Chr         , Wwf         
Re          , Rd          , Gs^Fdw      , Ds          , Ch          , Chs         , Chs         , Ds          , Ds          , Re          , Re          , Gs^Fmw      , Ds          , Ds          , Gs          , Gs          , Re          , Re^Gvs      , Re          , Re          , Rr          , Re^Gvs      , Re          , Re^Gvs      , Re          , Re          , Re^Gvs      , Gs^Fmw      , Wwf         , Ww          , Ww          , Ww          , Wo          , Wo          , Wo          , Ww          , Chw         , Gg          , Gs^Fms      , Rp          , Gs^Fp       , Gg          
Ds          , Rd          , Gs          , Gg^Vh       , Chr         , 4 Khs       , Chs         , Gs          , Ds          , Re          , Rd          , Rd          , Gs^Fmw      , Gs          , Gs          , Re^Gvs      , Re^Gvs      , Re          , Re^Gvs      , Re          , Rr          , Re^Gvs      , Re^Gvs      , Re          , Rr          , Gs^Fmw      , Gg          , Gs^Fmw      , Gs^Fms      , Wwf         , Wwf         , Ww          , Ww          , Wo          , Ww          , Ww          , Gg          , Gg          , Gg          , Rp          , Gg^Ve       , Gg          
Ds          , Re          , Gs          , Gs          , Gs^Zi       , Chr         , Chs         , Ss          , Ss          , Rd          , Ds          , Ds          , Ds          , Gs          , Gs          , Gs^Fmw      , Re          , Re          , Re^Gvs      , Re          , Re^Gvs      , Rr          , Rr          , Rr          , Re^Gvs      , Rr          , Rr          , Gs^Fms      , Gg          , Gg          , Wwf         , Ww          , Ww          , Ww          , Wwf         , Gs^Fms      , Gg^Vh       , Gs^Fms      , Re^Gvs      , Rp          , Gs^Fds      , Gg
Re          , Gs          , Rd          , Rd          , Gs          , Rd          , Rd          , Gs^Fdw      , Ss^Vhs      , Ss          , Ss          , Ds          , Gs          , Gs^Fdw      , Gs          , Gs          , Re          , Ss          , Ss          , Gs^Fdw      , Gs^Fdw      , Re          , Rr          , Re^Gvs      , Re          , Re^Gvs      , Re          , Rr          , Rp          , Gg          , Ww          , Ww          , Chw         , Wwf         , Gg          , Gs^Fms      , Re^Gvs      , Re^Gvs      , Re          , Rp          , Gs^Fds      , Gs^Fds      
Gs          , Re          , Re          , Gs^Fdw      , Ds          , Re          , Rd          , Gs^Zi       , Ss          , Ss          , Ds          , Ds          , Gs          , Gs^Fdw      , Gs^Fmw      , Gs          , Gs          , Ss          , Ss          , Ss          , Gs^Fmw      , Gg          , Rr          , Re^Gvs      , Gg^Wm       , Re          , Re^Gvs      , Chr         , Ww          , Ww^Bw\      , Ww^Bw\      , Ww          , Gs^Fp       , Gg          , Re          , Re^Gvs      , Re^Gvs      , Re^Gvs      , Re          , Rp          , Gg^Wm       , Gs^Fds
Gs          , Re          , Gs^Vht      , Ds          , Ds          , Re          , Gs          , Ds          , Ce          , Ce          , Ds          , Rd          , Gs^Zi       , Gs          , Re          , Re          , Gs          , Gs          , Ss          , Gs^Fmw      , Gg          , Gg          , Rr          , Re          , Re^Gvs      , Re^Gvs      , Re^Gvs      , Wwf         , Ww          , Ww          , Gg          , Rp          , Rp          , Re^Gvs      , Re^Gvs      , Re^Gvs      , Ce          , Ce          , Ce          , Rr          , Rr          , Rp
Ds          , Gs          , Gs^Fdw      , Ss          , Ss          , Ds          , Gs          , Gs          , Rd          , 6 Ke        , Ce          , Rd          , Rd          , Rd          , Gs          , Re          , Rd          , Re          , Rr          , Gg          , Rr          , Rr          , Gg          , Rr          , Rr          , Re          , Re^Gvs      , Wwf         , Ww          , Chw         , Gg          , Gg          , Rp          , Re^Gvs      , Gg^Wm       , Re^Gvs      , Ce          , 1 Ke        , Ce          , Rr          , Gs^Fds      , Gs^Fds      
Ds          , Gs^Fdw      , Gs^Fdw      , Ss          , Ss          , Ds          , Gs          , Rd          , Rd          , Ce          , Gs          , Rd          , Rd          , Gs          , Re          , Ds          , Ds          , Rr          , Gs          , Rr          , Re^Gvs      , Re          , Re          , Gs^Fp       , Gg          , Rr          , Rr          , Wwf         , Ww          , Wwf         , Gs^Fds      , Gs^Fds      , Gs^Fds      , Rp          , Rp          , Re^Gvs      , Gs^Fds      , Ce          , Gg^Ve       , Rr          , Gs^Fds      , Gs^Fds      
Ss          , Ds          , Gs          , Gs          , Ss^Vhs      , Ss          , Ds          , Re          , Rd          , Gs^Fdw      , Gs          , Re          , Gs          , Gs          , Ds          , Ss          , Re          , Re          , Chr         , Gg^Vh       , Re          , Re          , Re          , Re^Gvs      , Gg          , Gs^Fp       , Gs^Fp       , Rr          , Ww          , Wwf         , Gs^Fds      , Gs^Fds      , Ggf         , Gg          , Gg          , Rp          , Rp          , Gg          , Rp          , Rp          , Gs^Fds      , Gs^Fds      
Ss          , Ss          , Wwf         , Gs          , Ds          , Ss          , Ds          , Gs          , Rd          , Gs^Fdw      , Gs^Fdw      , Gs          , Re          , Gs          , Ss          , Ss          , Ss          , Gs          , Chr         , Chr         , Re          , Re^Gvs      , Gs^Fp       , Gs^Fp       , Gg          , Gs^Fp       , Ww          , Ww^Bw|      , Ww          , Wwf         , Gs^Fds      , Gs^Fds      , Re          , Re^Gvs      , Re^Gvs      , Gs^Fds      , Gg          , Rp          , Gg^Vh       , Gs^Fds      , Gs^Fds      , Gs^Fds      
Ss          , Wwf         , Wwf         , Ds          , Ww          , Ds          , Wwf         , Ds          , Wwf         , Ds          , Gs          , Gs          , Gs          , Ss          , Ss          , Ss^Vhs      , Ss          , Gs          , Gs          , Re          , Gs^Fp       , Gs^Fp       , Gg          , Gs^Fp       , Gs^Fp       , Wwf         , Ww          , Ww^Bw|      , Gs^Fds      , Chr         , Gg          , Re          , Re^Gvs      , Re^Gvs      , Ce          , Ce          , Ce          , Rp          , Re^Gvs      , Re^Gvs      , Re^Gvs      , Gs^Fds      
Ww          , Wwf         , Ww          , Ww          , Ss          , Ww          , Ss          , Ww          , Ww          , Wwf         , Ww^Bw|      , Wwf         , Ww          , Ds          , Ds          , Ss          , Ss          , Ss          , Ss          , Gs^Fp       , Gs^Fp       , Gg          , Gg          , Gs^Fp       , Gs^Fp       , Ww          , Ww          , Rp          , Gs^Fds      , Gs^Fds      , Ggf         , Gs^Fds      , Gs^Fds      , Gg          , Ce          , 2 Ke        , Ce          , Rp          , Re^Gvs      , Re^Gvs      , Gg          , Gg          
Ds          , Ww          , Ds          , Wwf         , Ds          , Ss          , Ss^Vhs      , Ss          , Ss          , Ww          , Ww^Bw|      , Ww          , Wo          , Ww          , Ww          , Wwf         , Wwf         , Ss          , Wwf         , Gs          , Gs          , Gg          , Gg          , Gs^Fp       , Gg          , Ww          , Ww          , Rp          , Rp          , Gg          , Ggf         , Gs^Fds      , Re^Gvs      , Gg^Vh       , Gg          , Ce          , Rp          , Rp          , Gs^Fds      , Gs^Fds      , Gg          , Ss          
Gs          , Ds          , Ds          , Rd          , Rd          , Ds          , Ss          , Ss          , Ww          , Ww          , Rd          , Ww          , Ww          , Wo          , Wo          , Ww          , Ww          , Wwf         , Ww          , Ww          , Ww          , Ww          , Ww          , Gg          , Chr         , Ww          , Ww          , Ggf         , Ggf         , Rp          , Rr          , Re^Gvs      , Re^Gvs      , Re^Gvs      , Rp          , Rp          , Gg^Ve       , Gs^Fds      , Gg          , Gs^Fds      , Ss          , Ss          
Gs          , Gs          , Gs^Vht      , Rd          , Rd          , Ds          , Ss          , Ss          , Ww          , Wwf         , Chs         , Rd          , Ds          , Ww          , Ww          , Ww          , Wwf         , Ww          , Ww          , Wo          , Wo          , Wo          , Wo          , Ww          , Wo          , Ww          , Ww          , Wwf         , Gs^Fds      , Gs^Fds      , Gs^Fds      , Rr          , Rr          , Rr          , Re^Gvs      , Re^Gvs      , Re^Gvs      , Gs^Fds      , Ss          , Gg          , Ss          , Ss          
Gs          , Gs          , Gs^Fmw      , Gs          , Ww          , Ww^Bw|      , Wwf         , Ss          , Ss          , Chw         , 5 Khr       , Chr         , Ss          , Ds          , Ds          , Ds          , Ds          , Ds          , Wwf         , Ww          , Ww          , Ww          , Gg          , Ww          , Ww          , Wo          , Wo          , Ww          , Ww^Bw/      , Gs^Fds      , Gs^Fds      , Ggf         , Gg          , Rr          , Gg          , Re^Gvs      , Re^Gvs      , Re          , Gg          , Ss          , Ss          , Ss          
Wwf         , Wwf         , Ww          , Ww          , Ss          , Ss^Bw|      , Re          , Gs^Fdw      , Gs^Fdw      , Chs         , Chr         , Ds          , Ss          , Ss          , Ss          , Ds          , Gs          , Gg          , Rd          , Chr         , Gs^Fmw      , Gs^Fmw      , Re          , Gs^Fmw      , Gg          , Ww          , Wo          , Ww          , Ww          , Chw         , Ggf         , Gs^Fds      , Gs^Fds      , Rr          , Gs^Fp       , Ggf         , Gs^Fds      , Gs^Fds      , Gg          , Ss          , Gg          , Gg          
Ww          , Ww          , Ww          , Ww          , Ss^Bw/      , Ss^Bw\      , Gs          , Gs          , Gs          , Rd          , Rd          , Gs          , Ss          , Ss^Vhs      , Ss          , Re          , Rd          , Rd          , Ds          , Gs          , Re          , Re          , Re^Gvs      , Re^Gvs      , Gs^Fms      , Ww          , Ww          , Wo          , Wo          , Wwf         , Gg          , Gs^Fds      , Rr          , Rr          , Ggf         , Gg          , Gs^Fds      , Gs^Fds      , Gg          , Gg          , Gs^Fds      , Gg          
Gs^Fmw      , Gs^Fdw      , Ds          , Ss^Bw/      , Ss          , Ss          , Ss          , Re          , Ce          , Re          , Rd          , Gs^Zi       , Rd          , Rd          , Rd          , Re          , Rd          , Ds          , Ds          , Ds          , Gs^Vht      , Re          , Gs^Fmw      , Gs^Fmw      , Gs^Fms      , Gs^Fms      , Ww          , Wo          , Wo          , Ww          , Gg          , Rr          , Gg^Ve       , Rr          , Rr          , Ggf         , Re^Gvs      , Gg          , Gs^Fds      , Gs^Fds      , Gs^Fds      , Gg
Gs^Fdw      , Gs^Fdw      , Ds          , Ss          , Ss          , Ss^Vhs      , Ss          , Ds          , Gs          , Ce          , 3 Ke        , Re          , Re          , Rd          , Re          , Gs^Fdw      , Gs^Fdw      , Rd          , Ds          , Gs^Fdw      , Gs          , Gs          , Chr         , Gs^Fms      , Gg^Vh       , Gs^Fms      , Ww          , Wo          , Wo          , Ww          , Chr         , Rr          , Ggf         , Gs^Fms      , Rp          , Re^Gvs      , Re          , Re^Gvs      , Re^Gvs      , Gs^Fds      , Gg          , Gg          
Gs          , Gs          , Gs          , Ds          , Re          , Gs          , Rd          , Ds          , Rd          , Rd          , Re          , Ce          , Ce          , Re          , Rd          , Rd          , Gs^Fdw      , Rd          , Re          , Gs          , Gg          , Gs^Fmw      , Chr         , Gs^Fmw      , Gg          , Gg          , Ch          , Ww          , Wo          , Ww          , Rr          , Rr          , Gs^Fms      , Gs^Fms      , Gs^Fms      , Rp          , Rp          , Re^Gvs      , Gg^Vh       , Gg          , Rp          , Rp          
Gs          , Gs          , Gs^Fdw      , Re          , Gs^Fdw      , Rd          , Gs^Vht      , Re          , Gs          , Re          , Ds          , Gs^Fdw      , Gs^Fdw      , Rd          , Ds          , Ds          , Re          , Rd          , Rd          , Re          , Gs^Fdw      , Gs^Fmw      , Gs^Fmw      , Gs^Fms      , Re^Gvs      , Gs^Fmw      , Gg          , Ww          , Wo^Bw/      , Wo^Bw/      , Ww          , Gg          , Gg          , Ggf         , Gs^Fms      , Gs^Fms      , Gs^Fms      , Rp          , Rp          , Rp          , Gg          , Gg          
Rd          , Rd          , Re          , Gs^Fdw      , Gs          , Gs          , Gs          , Rd          , Gs^Fmw      , Re          , Re          , Gs^Fdw      , Gs^Fmw      , Gs^Vht      , Ss          , Ds          , Ss          , Re          , Rd          , Re          , Gs^Fdw      , Gg          , Re          , Re          , Re^Gvs      , Re^Gvs      , Rr          , Ww^Bw/      , Ww          , Wo          , Wo          , Ww          , Ww          , Chr         , Gg          , Gs^Fms      , Gs^Fms      , Gg          , Rp          , Gg          , Gs^Fms      , Gs^Fms      
Re          , Rd          , Re          , Rd          , Gs          , Gs          , Rd          , Gs          , Re          , Gs^Fmw      , Ss          , Ss          , Ss          , Ss          , Ss          , Ss          , Gs          , Ds          , Gs^Fdw      , Rd          , Gs          , Gg^Wm       , Gg          , Re^Gvs      , Rr          , Rr          , Re          , Re^Gvs      , Re          , Ww          , Ww          , Wo          , Wo          , Ww          , Gs^Fms      , Gs^Fms      , Gs^Fms      , Ggf         , Rp          , Gs^Fms      , Gs^Fms      , Gs^Fms      
Gs          , Gs          , Re          , Gs          , Gs          , Gs          , Rd          , Re          , Re          , Re          , Gs          , Ss          , Ss          , Ss          , Ss          , Gs          , Gs          , Gs          , Gs          , Gs          , Gs          , Gg          , Rr          , Rr          , Gs^Fmw      , Re^Gvs      , Re^Gvs      , Re          , Gs^Fmw      , Gg          , Ww          , Wo          , Wo          , Ww          , Gg          , Ggf         , Gg          , Gs^Fms      , Rp          , Gg          , Gs^Fms      , Gs^Fms      
