border_size=1
usage=map

Gll^Fp, Gg, Gll^Fp, Gll^Fp, Gs^Fms, Gs^Fms, Gs^Fms, Gs^Fms, Gs^Fms, Gs^Fms, Gs^Fms, Re, Gs^Fp, Gs^Fms, Gs^Fms, Gs^Fms, Gs^Fms, Gs^Fp, Gs^Fp, Gs^Fp, Gs^Fms, Gs^Fms, Gs^Fms, Gs^Fp, Gs^Fms, Gs^Fp, Gs^Fms, Gs^Fms, Gs^Fms, Gs^Fp, Ds, Gs^Fp, Ww, Ww, Ds, Gs^Fp, Gg, Gs^Fms, Gs^Fms, Gs^Fp, Gg, Gg, Gs^Fp, Gs^Fp, Gs^Fms, Gs^Fp, Gg, Gg, Gs^Fp, Gg
Gg, Gll^Fp, Gll^Fp, Gll^Fp, Gs^Fms, Gs^Fms, Gg, Gs^Fp, Gs^Fds, Gs^Fms, Gs^Fms, Re, 1 Re, Gs^Fms, Gg, Gs^Fms, Gs^Fds, Gs^Fp, Gs^Fms, Gs^Fp, Gs^Fds, Gs^Fms, Gs^Fds, Gs^Fp, Gg, Gs^Fms, Gs^Fp, Gs^Fp, Ds, Gs^Fp, Ww, Ww, Ds, Ds, Gg, Gg, Hh, Gs^Fp, Gs^Fms, Gs^Fp, Mm, Hh, Hh, Gs^Fms, Gs^Fms, Gs^Fp, Gs^Fp, Gs^Fp, Hh, Hh
Gll^Fp, Gll^Fp, Gll^Fp, Gll^Fp, Gs^Fp, Gs^Fms, Gs^Fms, Gg^Em, Gg, Gg, Gs^Fds, Gs^Fp, Rd, Gg^Efm, Gs^Fms, Gs^Fds, Gs^Fds, Gs^Fms, Gs^Fms, Gs^Fms, Gg^Efm, Gg^Efm, Gg, Gs^Fp, Gg, Gs^Fp, Gg, Ds, Ww, Ww, Gs^Fp, Gs^Fms, Gg, Gg, Hh, Hh, Mm, Hh, Gs^Fp, Hh, Mm, Mm, Gs^Fms, Gs^Fms, Gs^Fms, Gs^Fp, Hh, Gs^Fp, Gs^Fp, Hh
Gll^Fp, Gll^Fp, Gll^Fp, Gll^Fp, Gs^Fp, Gs^Fp, Gs^Fms, Gg, Gg^Efm, Gs^Fds, Gs^Fp, Gg, Re, Gg, Gg^Efm, Gs^Fds, Gg^Efm, Gs^Fms, Gs^Fp, Gs^Fp, Gg, Gg, Ds, Gs^Fp, Ww, Ds, Ds, Ds, Ww, Ds, Gg, Gs^Fms, Gs^Fp, Gg, Hh, Mm, Hh, Mm, Gs^Fp, Gs^Fp, Hh, Mm, Hh, Gs^Fms, Hh, Gs^Fp, Hh, Hh, Mm, Mm
Gll^Fp, Gll^Fp, Gll^Fp, Gll^Fp, Gg, Gg^Efm, Gs^Fms, Gg, Gs^Fms, Gg, Gg^Efm, Gg, Gg^Vh, Re, Rd, Gg, Gg, Gs^Fp, Ds, Ds, Ds, Gg, Ww, Ww, Ds, Ww, Ww, Ww, Ds, Ds, Gg, Gs^Fp, Hh, Gs^Fp, Mm, Mm, Hh, Hh, Gg, Hh, Hh, Hh, Hh, Mm, Hh, Gg, Gs^Fp, Hh, Mm, Mm
Gll^Fp, Gg^Em, Gg, Gll^Fp, Gs^Fp, Gg, Gs^Fds, Gs^Fp, Gs^Fms, Gs^Fms, Gs^Fms, Gg, Gg, Re, Rd, Ds, Wwf, Ww, Ww, Ww, Ww, Ww, Ds, Gg, Gs^Fp, Gg, Gs^Fp, Gg, Gg, Gs^Fp, Gs^Fp, Hh, Hh, Mm, Mm, Mm, Gg, Gg, Hh, Hh, Mm, Mm, Mm, Hh, Hh, Gs^Fp, Gs^Fp, Gs^Fp, Mm, Mm
Gg, Gg^Em, Gll^Fp, Gg, Gs^Fp, Gg, Gs^Fp, Gs^Fp, Gg, Gs^Fp, Gs^Fp, Gs^Fp, Gs^Fp, Ds, Wwf, Wwf, Ds, Rd, Gs^Fp, Ds, Gs^Fms, Gg, Gs^Fms, Gs^Fms, Gs^Fms, Gg, Gs^Fp, Gs^Fp, Gg^Em, Gs^Fp, Gs^Fp, Mm, Hh, Gs^Fp, Gg, Gg, Gg, Gs^Fp, Gg, Mm, Mm, Mm, Mm, Mm, Hh, Gs^Fp, Hh, Mm, Mm, Mm
Gg, Gg^Efm, Gll^Fp, Gg, Gs^Fp, Gs^Fp, Ds, Ds, Ww, Ww, Ww, Ww, Ww, Ww, Ds, Ds, Gg, Gg, Gg^Efm, Gg, Gg^Ve, Gs^Fds, Gg, Gs^Fms, Gs^Fds, Gs^Fds, Gs^Fp, Gs^Fp, Gg, Gg, Hh, Hh, Gs^Fp, Gs^Fp, Hh, Hh, Hh, Gs^Fp, Gs^Fms, Hh, Gs^Fds, Gs^Fms, Hh, Mm, Hh, Hh, Hh, Mm, Mm, Mm
Gg, Gll^Fp, Gg, Gg, Ds, Gs^Fp, Ww, Ww, Gs^Fp, Ds, Ds, Gs^Fp, Ds, Gg, Gg, Gs^Fms, Gs^Fms, Re, Gg, Gg^Efm, Gs^Fms, Gs^Fds, Gg, Gs^Fms, Gs^Fds, Gs^Fms, Gs^Fms, Gs^Fp, Gg, Gs^Fp, Gs^Fms, Gs^Fp, Gs^Fp, Hh, Hh, Mm, Mm, Hh, Gs^Fds, Gs^Fms, Hh, Gs^Fms, Gs^Fds, Gs^Fds, Gs^Fp, Hh, Hh, Mm, Mm, Mm
Gg, Gll^Fp, Ds, Ds, Ww, Ww, Ds, Gg, Gs^Fms, Gs^Fms, Gs^Fds, Gg, Gg, Gs^Fp, Gg^Efm, Gg, Gs^Fds, Re, Re, Gg^Efm, Gs^Fms, Gg, Gg, Gs^Fp, Gs^Fds, Gs^Fms, Gs^Fds, Gs^Fms, Gs^Fms, Gs^Fms, Gs^Fp, Hh, Hh, Mm, Mm, Mm, Mm, Hh, Gs^Fp, Gs^Fms, Gg^Em, Gs^Fp, Hh, Gs^Fds, Hh, Mm, Hh, Hh, Hh, Hh
Gg^Efm, Gg, Ds, Ww, Gs^Fds, Ds, Gs^Fds, Gs^Fds, Gg, Gs^Fms, Gs^Fds, Gs^Fms, Gs^Fms, Gs^Fms, Gs, Gs^Fds, Gg^Fet, Gs^Fms, Gg, Rd, Rd, Gg, Gg, Gs^Fp, Gg, Gg, Gs^Fms, Gs^Fds, Gs^Fds, Gs^Fms, Gs^Fms, Hh, Hh, Gs^Fms, Gs^Fms, Hh, Gs^Fds, Hh, Gg, Gg, Gg, Gg, Hh, Hh, Mm, Mm, Mm, Hh, Hh, Hh
Rp, Gg, Wwf, Ww, Gs^Fp, Gs^Fms, Gs^Fms, Gs^Fds, Gg^Ve, Gs^Fp, Gg, Gs, Gs, Gs, Gg, Gg, Gg, Gs^Fp, Gg, Gg, Rp, Gg, Re, Re, Re, Gg, Gg, Gs^Fp, Gs^Fds, Gs^Fp, Gs^Fp, Gs^Fp, Gg^Ve, Gg, Gg, Gs^Fds, Gs^Fds, Gs^Fms, Gg, Gs^Fms, Gg, Gg, Hh, Mm, Mm, Mm, Mm, Mm, Mm, Hh
Rp, Gg, Ww, Wwf, Gg, Gs^Fms, Gg, Gg, Gg, Gg, Gg, Gs, Re, Gg, Re, Gg, Rd, Gg^Fet, Rp, Gg, Rp, Rd, Rd, Re, Re, Gg, Gg, Gg, Gs^Fms, Gg, Ce, Gg, Gg, Gs^Fms, Gs^Fds, Gg, Gs^Fms, Gg, Gg, Gs^Fds, Gs^Fds, Gs^Fms, Gs^Fms, Mm, Mm, Mm, Mm, Mm, Mm, Hh
Gg, Rp, Wwf, Rp, Rp, Gg, Ce, Ce, Ce, Ce, Rp, Re, Gg, Re, Gs, Re, Gs^Fms, Rp, Gs, Rp, Rd, Rp, Rp, Re, Gg, Gg, Gg, Gg^Vh, Gg, Ce, 2 Ke, Ce, Ce, Gs^Fms, Gs^Fms, Gs^Fms, Gs^Fds, Gg, Gs^Fds, Gs^Fds, Gs^Fms, Gg, Gg, Hh, Mm, Mm, Hh, Hh, Hh, Hh
Ww, Wwf, Ds, Gg, Gs^Fms, Rp, Ce, 3 Ke, Ce, Ce, Gg, Gg^Vh, Gs^Fms, Gs^Fms, Gs, Gg, Gs^Fds, Gg, Gs, Gs^Fds, Re, Gg, Gs, Re, Re, Re, Re, Re, Re, Ce, Ce, Ce, Gs, Gg, Gs^Fms, Gs^Fds, Gs^Fds, Gs^Fms, Gs, Gs^Fds, Gs^Fds, Gs^Fds, Gs^Fds, Hh, Hh, Mm, Hh, Hh, Hh, Hh
Gll^Fp, Ds, Gll^Fp, Gg, Gs^Fms, Gg, Gg, Ce, Gg, Gg, Gg, Gg, Gs^Fms, Gs^Fds, Gs^Fms, Gs, Gs^Fds, Gg, Gs^Fds, Gs^Fds, Re, Gg, Gs, Gs, Re^Gvs, Re^Gvs, Re, Re^Gvs, Gg^Vh, Re^Gvs, Re^Gvs, Ce, Gs, Gg^Ve, Gg, Gs^Fds, Gs^Fms, Gs^Fds, Gs, Gs^Fms, Gs^Fms, Gs^Fms, Gs^Fms, Gg, Gs^Fms, Hh, Gs^Fp, Gs^Fp, Gs^Fms, Gs^Fms
Gll^Fp, Gll^Fp, Gs^Fds, Gll^Fp, Gs^Fds, Gs^Fms, Gg^Vh, Gg, Gg, Gg, Gs^Fms, Gs, Gs, Gs^Fds, Gs^Fds, Gs^Fds, Gs^Fms, Gg, Gs^Fds, Gs^Fms, Gg, Re, Gg^Wm, Re^Gvs, Re, Re, Re^Gvs, Re^Gvs, Re, Re, Re^Gvs, Re^Gvs, Re^Gvs, Gs, Gs^Fms, Gs^Fds, Gs^Fds, Gs, Gs, Gs, Gs, Gg^Ve, Gs, Gs, Gs^Fms, Gs^Fms, Gs^Fp, Gs^Fms, Gg, Gg
Gs^Fds, Gll^Fp, Gs^Fms, Gs^Fds, Gs^Fms, Gs^Fds, Gs^Fds, Gs^Fds, Gs^Fms, Gs^Fds, Gs, Gs^Fds, Gs, Gs^Fms, Gs^Fds, Hh, Hh, Gs^Fds, Gg, Gg, Gg, Rd, Gs, Re^Gvs, Re^Gvs, Re^Gvs, Re, Re, Re^Gvs, Re^Gvs, Re, Re, Gs, Gs^Fms, Gs, Gs^Fms, Gs^Fds, Gs^Fms, Gg^Wm, Gs, Re^Gvs, Gs, Gs^Fms, Gs, Gs^Fms, Gs^Fp, Gg, Gs^Fms, Gg, Gg
Gs^Fms, Gs^Fms, Gs^Fms, Gs^Fds, Gs^Fds, Gs^Fds, Gs^Fms, Gs^Fds, Hh, Gs^Fds, Gs^Fds, Gs^Fds, Gs^Fms, Gs^Fms, Hh, Hh, Gs^Fds, Gs^Fds, Gg^Vh, Gs, Gs^Fms, Rd, Gs, Gs, Re, Re, Re, Re^Gvs, Re, Re, Gg^Wm, Gg, Gs, Gs^Fms, Gs, Gs, Gs, Gs^Fms, Re, Re, Re^Gvs, Re^Gvs, Re^Gvs, Gs^Fms, Gg^Vh, Gg, Gg, Gg, Gg, Gg
Gs^Fms, Gs^Fms, Gs^Fds, Gs^Fds, Hh, Gs^Fds, Hh, Hh, Gs^Fms, Gs^Fds, Gs^Fmw, Gs^Fds, Gg^Ve, Gg, Gg, Gs^Fmw, Gg, Gs^Fms, Gg, Gs, Gs, Re, Re, Re, Re, Re, Gs, Re, Gs, Gs, Gs, Gg, Gs, Rd, Rd, Gs, Re, Re^Gvs, Re^Gvs, Re, Re^Gvs, Re^Gvs, Re, Re, Re^Gvs, Gg, Gg, Gg, Gg, Gg
Gll^Fmw, Gs^Fds, Gll^Fmw, Gs^Fds, Hh, Hh, Hh, Hh, Gs, Gs^Fmw, Gg, Gg, Gg, Gg, Re^Gvs, Re^Gvs, Re^Gvs, Gg^Wm, Gg, Gg, Gg, Gs, Gg, Re, Gs, Re, Re, Gs, Re, Re, Gs, Gs, Re, Re, Re, Gs, Gg^Vh, Re^Gvs, Re^Gvs, Re^Gvs, Re^Gvs, Re^Gvs, Re^Gvs, Re^Gvs, Re, Re^Gvs, Gg, Gg, Gg, Gg
Gll^Fmw, Gll^Fmw, Gll^Fmw, Gll^Fmw, Gs^Fp, Hh, Gs^Fmw, Hh, Gs, Gs^Fmw, Gs, Gg^Vh, Gg, Gg, Gg, Re^Gvs, Gg, Gg, Gg, Gg, Re^Gvs, Gg, Gg^Wm, Gs, Gs, Re, Re, Gs, Re, Rd, Gg, Re, Re, Re, Gg, Gg, Gg, Gg, Gg^Wm, Re, Re^Gvs, Re^Gvs, Re, Re^Gvs, Re^Gvs, Re^Gvs, Gg, Gg, Gg, Gg
Gll^Fmw, Gll^Fmw, Gd^Fmw, Gll^Fmw, Hh, Gs^Fmw, Gs, Hh, Re, Gg, Re^Gvs, Gg, Gg^Wm, Gg, Gg, Gg, Gg, Gg, Gg, Re, Re, Re, Gg, Gg, Gs, Re, Re, Re, Re, Re, Gs, Re, Rd, Rd, Rd, Gs, Gs, Gg, Gg, Gg, Gg^Ve, Re^Gvs, Re^Gvs, Re^Gvs, Gs, Gs, Gg, Gs, Gs, Gg
Gll^Fmw, Gll^Fdw, Gd^Fdw, Gll^Fdw, Gs, Gs, Re, Gs, Re, Re^Gvs, Re, Re^Gvs, Gg, Re, Re, Re^Gvs, Re^Gvs, Gg^Wm, Gg, Gg, Gg, Gs, Re, Gs, Re, Re, Re, Gd, Gd, Gs, Rd, Rd, Rd, Re, Re, Gs, Gs^Fdw, Hh^Fdw, Hh, Gg, Gg, Gg, Gg, Gs, Gs, Gs, Gs, Gs, Gs, Gg
Gll^Fdw, Gd^Fdw, Gd, Gd, Gs, Re, Ce, Gs, Gs, Re, Re, Gs, Gg, Re, Re, Re^Gvs, Gg, Gg, Hh, Gs, Gd, Gs, Re, Re, Re, Rd, Gs, Gd, Re, Gs, Gs, Re, Re, Re, Re, Gs, Gs, Hh^Fdw, Hh, Gs, Hh, Hh, Hh, Hh, Hh^Fdw, Hh, Gs, Gs, Gs, Gg
Gg, Gs, Re, Gs, Gs, Ce, 6 Ke, Ce, Gs^Vc, Re, Gs, Gs, Re, Gs, Gs, Re, Gs, Gs, Hh^Fdw, Gs, Re, Gd, Re, Re, Rd, Rd, Gs, Gd, Re, Rd, Gs, Hh^Fdw, Hh, Gs, Re, Re, Gs, Gs, Hh, Hh^Fdw, Mm, Mm, Hh, Hh, Hh, Hh, Hh^Fdw, Gs, Gs, Gs
Gg, Re, Re, Gd, Re, Ce, Ce, Ce, Re, Re, Re, Gs, Re, Gs, Re, Re, Gs, Gs, Hh, Re, Re, Gs, Gs, Gd, Re, Gs, Re, Re, Re, Rd, Gs, Gd, Gs, Gs, Re, Rd, Rd, Re, Re, Hh, Gs, Hh, Gg^Vc, Hh^Fdw, Hh^Fdw, Hh, Hh, Hh, Hh^Fdw, Hh
Gd, Re, Re, Gs, Re, Re, Gs, Re, Re, Gs, Rd, Gd, Gs, Rd, Re, Re, Gs, Hh, Hh^Fdw, Hh^Fdw, Rd, Gs, Gs, Re, Re, Hh, Hh, Gs, Hh^Fdw, Re, Re, Re, Gs, Re, Gs, Gs, Re, Re, Gs^Fdw, Rd, Gs, Gs, Gg, Gg, Gs^Fdw, Hh^Fdw, Hh, Hh, Hh, Hh
Re, Gs, Gd^Fdw, Gs, Re, Gs, Gd^Fdw, Gd^Fdw, Re, Re, Gs, Gd, Gs, Gs, Ds, Re, Ds, Gs, Rd, Hh, Re, Rd, Gd, Gd, Gd^Fdw, Hh^Fdw, Gd^Fdw, Gs, Gs, Hh, Gs, Gd, Rd, Rd, Gs, Gs, Hh^Fdw, Hh, Gs^Fdw, Re, Rd, Gg, Ce, Gs^Fdw, Gs^Fdw, Gs, Hh, Mm, Mm, Hh
Gs, Re, Gs, Gd^Fdw, Gll^Fdw, Gd^Fdw, Gll^Fdw, Gd^Fdw, Wwf, Ds, Wwf, Ds, Ww, Ds, Ww, Ds, Ww, Wwf, Wwf, Gs, Ds, Re, Re, Ds, Ds, Ds, Ds, Ds, Ds, Gs, Gd, Gd, Re, Rd, Re, Gg, Hh, Hh, Gg^Vc, Gs^Fdw, Gg, Ce, 7 Ke, Ce, Gs, Gs, Hh, Mm, Mm, Mm
Gll^Fdw, Gd^Fdw, Ds, Gd^Fdw, Ww, Gll^Fdw, Wwf, Ds, Ww, Ww, Wwf, Wwf, Ww, Ww, Ww, Ww, Ww, Wwf, Wwf, Ww, Wwf, Re, Wwf, Ww, Ww, Wwf, Wwf, Wwf, Wwf, Ww, Wwf, Gs, Ds, Rd, Re, Re, Hh, Gs, Gd, Gs, Gs, Ce, Ce, Ce, Gs, Gs, Hh, Hh, Mm, Mm
Ds, Ds, Ww, Ww, Ww, Ww, Wwf, Ww, Ds, Ds, Ds, Ds, Ds, Ww, Hh, Ds, Hh, Gs^Fmw, Rd, Wwf, Rd, Ww, Wwf, Wwf, Ww, Ww, Wwf, Ww, Wwf, Ww, Wwf, Wwf, Ww, Ds, Gs, Re, Gs, Re, Gs, Gg, Gs^Fdw, Gg, Gs, Gs, Gs, Hh, Mm, Hh, Mm, Mm
Ww, Ww, Ww, Ww, Wwf, Ww, Re, Re, Gs^Vc, Gs, Hh, Hh, Mm, Hh, Mm^Xm, Mm, Mm, Hh, Gs^Fmw, Ds, Rd, Ds, Ds, Wwf, Gs^Vc, Ds, Ds, Ds, Gg, Ds, Ww, Ww, Ww, Ds, Gs, Gs, Re, Re, Gs^Fdw, Gs^Fdw, Gs^Fdw, Gg^Vc, Hh, Gs^Fdw, Hh, Hh, Mm, Mm, Mm, Mm
Ww, Ww, Ds, Ds, Ds, Ds, Gs, Re, Gs, Re, Hh, Hh, Mm^Xm, Mm^Xm, Mm^Xm, Mm^Xm, Mm, Hh, Gs, Gg, Ce, Ce, Ce, Gs, Gs^Fmw, Gs, Hh, Gs^Fmw, Hh, Ds, Hh, Ww, Ww, Ww, Wwf, Ds, Gs, Gs, Hh^Fdw, Hh, Mm, Hh, Mm, Hh, Mm, Hh, Mm, Mm, Mm, Mm
Hh, Gs, Gs, Ds, Gs, Gs, Hh, Gs, Hh, Hh, Mm, Mm^Xm, Mm^Xm, Mm^Xm, Mm^Xm, Mm^Xm, Mm, Hh, Gs^Fmw, Gs, Ce, 9 Ke, Ce, Gs, Gs, Hh, Hh, Mm, Hh, Mm, Mm, Hh, Ww, Wwf, Wwf, Ww, Ww, Gs, Hh, Mm, Mm, Mm, Ds, Mm, Hh, Mm, Mm, Mm, Mm, Mm
Mm, Hh, Gs, Gs, Gs, Hh, Hh, Hh, Hh, Mm, Mm, Mm^Xm, Mm^Xm, Mm^Xm, Mm^Xm, Mm, Mm, Hh, Gs^Fmw, Gs, Gs, Ce, Re, Gs^Vc, Gs, Mm, Hh, Mm, Mm, Mm, Mm, Mm, Hh, Wwf, Ww, Wwf, Ww, Ww, Wwf, Ds, Ds, Ds, Ww, Ds, Ww, Hh, Hh, Hh, Hh, Mm
Mm, Hh, Hh, Hh, Mm, Mm, Mm, Hh, Mm, Mm, Mm^Xm, Mm^Xm, Mm^Xm, Mm^Xm, Mm^Xm, Mm, Mm, Hh, Hh, Gs, Gs, Re, Hh, Hh, Gs, Hh, Hh, Mm, Mm, Hh, Hh, Hh, Gs^Fdw, Gs^Fdw, Re, Wwf, Wwf, Wwf, Wwf, Ww, Ww, Ww, Ww, Ww, Ww, Ww, Ww, Hh, Hh, Hh
Mm, Mm, Mm, Mm, Mm, Mm, Mm, Mm, Mm^Xm, Mm^Xm, Mm^Xm, Mm^Xm, Mm, Mm, Mm, Mm, Mm^Xm, Mm, Hh, Gs^Fmw, Gg, Re, Gg^Fp, Hh, Hh, Hh, Mm, Mm, Mm, Mm, Mm, Hh, Hh, Gs, Gd, Gs, Gs^Fdw, Ww, Hh, Ww, Ww, Ww, Ds, Ww, Ds, Ww, Ww, Ww, Ww, Hh
Mm^Xm, Mm, Mm, Mm^Xm, Mm^Xm, Mm, Mm, Mm, Mm^Xm, Mm^Xm, Mm^Xm, Mm, Mm, Mm, Mm, Mm^Xm, Mm, Mm, Hh, Hh, Gg, Gs, Hh, Mm, Hh, Hh, Mm, Mm, Mm, Mm, Mm, Hh, Gs^Fdw, Gs, Re, Gs, Hh, Hh, Mm, Hh, Hh, Ds, Hh, Hh, Mm, Mm, Hh, Ww, Ww, Hh
Mm^Xm, Mm, Mm, Mm^Xm, Mm^Xm, Mm, Mm, Mm, Mm^Xm, Mm^Xm, Mm^Xm, Mm^Xm, Mm, Mm, Mm, Mm, Hh, Mm, Gs^Fmw, Gs^Fdw, Gs, Re, Gg^Fp, Mm, Hh, Hh, Mm, Mm, Mm, Mm, Hh, Hh^Vc, Re, Re, Re, Gs^Fdw, Hh, Mm, Mm, Mm, Mm, Mm, Mm, Mm, Mm, Hh, Hh, Ww, Ww, Ww
Mm^Xm, Mm^Xm, Mm, Mm^Xm, Mm^Xm, Mm, Mm, Mm^Xm, Mm^Xm, Mm^Xm, Mm, Mm, Mm, Mm, Hh, Hh, Hh, Hh, Gs^Fmw, Gs^Fmw, Re, Rd, Gg, Hh, Mm, Hh, Hh, Hh, Hh, Hh, Gs^Fmw, Re, Ce, Ce, Ce, Hh, Hh^Vc, Mm, Mm, Mm, Mm^Xm, Mm, Mm, Mm, Mm, Mm, Hh, Hh, Hh, Ww
Mm^Xm, Mm^Xm, Mm^Xm, Mm^Xm, Mm^Xm, Mm^Xm, Mm^Xm, Mm^Xm, Mm^Xm, Mm^Xm, Mm, Mm, Mm, Mm, Hh, Hh, Gg, Gg^Fp, Gg, Gs, Rd, Gg, Gs^Fmw, Hh, Gs^Fp, Mm, Hh, Hh, Hh, Hh, Gs^Fdw, Re, Ce, 8 Ke, Ce, Re, Gs, Mm, Mm, Mm, Mm^Xm, Mm^Xm, Mm^Xm, Mm, Mm, Mm, Mm, Hh, Hh, Hh
Mm^Xm, Mm^Xm, Mm^Xm, Mm^Xm, Mm^Xm, Mm^Xm, Mm^Xm, Mm^Xm, Mm^Xm, Mm^Xm, Mm, Mm, Mm, Hh, Hh, Hh, Gs^Fdw, Gg, Gs^Fmw, Gg, Rd, Gs, Gs^Fdw, Gs^Fmw, Gg, Hh, Hh, Gs^Fp, Hh, Gs, Gs, Re, Re, Ce, Gs, Re, Gs, Hh, Mm, Mm, Mm^Xm, Mm^Xm, Mm^Xm, Mm^Xm, Mm, Mm^Xm, Md^Xm, Mm, Mm, Hh
Mm^Xm, Mm^Xm, Mm^Xm, Mm^Xm, Mm^Xm, Mm^Xm, Mm^Xm, Mm^Xm, Mm^Xm, Mm^Xm, Mm, Mm, Mm, Mm, Hh, Hh, Gs^Fdw, Gs^Fdw, Gs^Fmw, Gg, Gd, Gs, Gs^Fmw, Hh, Hh, Gg, Gs, Gs, Gs, Gs, Gs, Re, Gs^Fdw, Gs^Vc, Gs, Gs, Hh, Hh, Hh, Mm, Mm^Xm, Mm^Xm, Md, Mm, Md^Xm, Md^Xm, Md^Xm, Mm, Mm, Mm
Mm^Xm, Mm^Xm, Mm^Xm, Mm^Xm, Mm^Xm, Mm^Xm, Mm^Xm, Mm^Xm, Mm^Xm, Mm^Xm, Mm, Mm, Hh, Hh, Mm, Hh, Gg, Gs^Fmw, Re, Rd, Gg, Gs^Fdw, Gs^Fdw, Hh, Hh, Gs^Fp, Hh, Gs^Fp, Gs^Fmw, Gll^Fmw, Gll^Fmw, Gs, Gs, Gs, Gs, Gs, Hh, Hh, Md, Mm, Md, Md, Md, Md, Md^Xm, Md^Xm, Md^Xm, Mm, Mm, Mm
Mm^Xm, Mm^Xm, Mm^Xm, Mm^Xm, Mm^Xm, Mm^Xm, Mm^Xm, Mm^Xm, Mm, Mm, Mm, Mm, Mm, Hh, Mm, Hh, Gs^Fmw, Gs^Fmw, Rd, Gg, Gs^Fmw, Gs^Fdw, Gs^Fp, Hh, Mm, Hh, Mm, Hh, Mm, Hh, Mm, Mm, Mm, Hh, Hh, Hh, Mm, Md, Md, Md, Md, Md, Md, Md, Md, Md^Xm, Mm, Mm, Mm, Mm
Mm^Xm, Mm^Xm, Mm^Xm, Mm^Xm, Mm^Xm, Mm^Xm, Mm^Xm, Mm^Xm, Mm, Mm, Mm, Mm, Mm, Mm, Mm, Hh^Fdw, Gs^Fdw, Gg, Gd, Gg, Hh, Hh, Mm, Mm, Mm, Mm, Mm, Mm, Mm, Mm, Mm, Mm, Mm, Mm, Md, Mm, Mm, Md, Md, Mm, Mm, Hhd^Fdw, Hhd, Md, Md, Md, Mm, Mm, Md^Xm, Mm^Xm
Mm^Xm, Mm^Xm, Mm^Xm, Mm^Xm, Mm^Xm, Mm^Xm, Mm, Mm^Xm, Mm, Mm, Mm, Mm, Mm, Hh, Mm, Hh^Fdw, Gs^Fmw, Re, Gs^Fdw, Gs^Fdw, Hh, Hh, Hh, Mm, Mm, Mm, Mm, Mm, Mm, Mm^Xm, Mm, Mm, Mm, Mm, Md, Md, Md, Md, Mm, Mv, Mm, Hhd, Md, Md, Md, Md, Md, Md, Md, Md
Mm^Xm, Mm^Xm, Mm^Xm, Mm^Xm, Mm^Xm, Mm^Xm, Mm, Mm, Mm, Mm, Mm, Hh, Hh, Hh, Gs^Fmw, Hh, Re, Re, Hh, Hh, Hh, Hh, Mm, Mm, Mm, Mm, Mm, Mm^Xm, Mm^Xm, Mm^Xm, Mm, Mm, Mm, Md, Md, Hhd, Hhd^Fdw, Hhd, Hhd, Mm, Hhd, Md, Md, Md, Md, Md, Md, Md, Md, Md
Mm^Xm, Mm^Xm, Mm^Xm, Mm^Xm, Mm^Xm, Mm^Xm, Mm, Mm, Mm, Hh, Hh, Hh, Hh, Gs^Fmw, Hh^Fdw, Gd, Gs, Hh^Fdw, Hh, Hh, Hh, Hh, Mm, Mm, Mm, Mm, Mm, Mm^Xm, Mm^Xm, Mm^Xm, Mm, Mm, Md, Md, Md, Hhd, Gll, Hhd^Fdw, Hhd, Hhd, Hhd, Md, Md, Md, Md, Md, Mm, Md, Md, Mm
Mm^Xm, Mm^Xm, Mm^Xm, Mm^Xm, Mm^Xm, Mm, Mm, Mm, Hh, Hh, Hh, Hh, Gs^Fp, Gs^Fmw, Gs, Re, Gs, Gs^Fdw, Hh, Mm, Mm, Mm, Mm, Mm, Mm, Mm, Mm^Xm, Mm^Xm, Mm^Xm, Mm, Mm, Mm, Md, Md, Md, Hhd, Hhd, Hhd^Fdw, Hhd, Hhd, Md, Md, Md, Md, Md, Md, Md, Md, Md, Md
Mm^Xm, Mm^Xm, Mm^Xm, Mm^Xm, Mm^Xm, Mm, Mm, Mm, Hh, Hh, Hh, Hh, Mm, Hh, Gg, Re, Hh, Hh, Mm, Mm, Mm, Mm, Mm, Mm, Mm, Mm, Mm^Xm, Mm^Xm, Mm^Xm, Md, Md, Md, Md, Md, Md, Md, Md, Md, Md, Hhd, Hhd, Md, Md, Md, Md, Md, Md, Md, Md, Md
