Gll^Fp, Gll^Fp, Gll^Fp, Gg, Gll^Fp, Gg, Gll^Fp, Gg, Re, Gg, Gll^Fp, Gg, Hh, Gg, Hh, Hh, Gg, Gg, Hh, Gg, Hh, Hh, Gg, Gs^Fp, Gs^Fp, Gg, Gs^Fp, Gs^Fp, Gs^Fds, Gs^Fms, Gs^Fms, Gs^Fp, Gg, Gg, Ds, Ww, Ds^Qhh, Gg, Gll^Fp, Gll^Fp, Gs^Fds, Gs^Fds, Gs^Fms, Gg, Gll^Fp, Gg, Gll^Fp, Gll^Fp, Gll^Fp, Gll^Fp
Gll^Fp, Gll^Fp, Gll^Fp, Gs^Fms, Gs^Fms, Gll^Fp, Gg, Gs, Rd, Gg, Gg, Gll^Fp, Gll^Fp, Hh^Fms, Hh, Hh, Hh^Fms, Gg, Gg, Gs^Fp, Gs^Fp, Gs, Gs, Gs^Fp, Gs, Gs, Gs^Fms, Gs^Fp, Gs^Fms, Gs^Fms, Gs^Fp, Gs^Fp, Gg, Ds^Esd, Ww, Ww, Gg^Qhh, Gg, Gg, Gg, Gs^Fms, Gs^Fds, Gs^Fms, Gll^Fp, Gll^Fp, Gll^Fp, Gs^Fms, Gll^Fp, Gll^Fp, Gg^Fet
Gs^Fms, Gll^Fp, Gd^Fetd, Gll^Fp, Gs^Fms, Hh, Hh, Gs, Gg, Re, 1 Re, Gg, Gll^Fms, Hh^Fms, Gs^Fms, Hh, Hh, Hh, Gs^Fp, Gs^Fp, Gs^Fp, Gs, Gs^Fms, Gs^Fp, Gg, Gs^Fp, Gs^Fp, Gs^Fp, Gs, Gs^Fp, Gs^Fp, Gg, Gg, Ds, Ww, Ds^Esd, Gg^Qhh, Gg, Gg, Gs^Fms, Gg, Gg^Em, Gs^Fms, Gs^Fds, Gs^Fms, Gs^Fms, Gll^Fp, Gll^Fp, Gll^Fp, Gll^Fp
Gll^Fp, Gll^Fp, Gll^Fp, Gll^Fp, Gg, Hh, Hh^Fp, Gs, Gs, Gg, Re, Gg, Gg, Gll^Fp, Gs, Gg, Hh, Hh^Fms, Gs^Fds, Gs^Fds, Gs^Fds, Gs^Fds, Gs^Fp, Gs^Fp, Gs, Gg, Gg, Gg, Gg, Gg, Gs, Gg, Gg, Ww, Gg^Qhh, Gg^Qhh, Gg, Gg, Gg^Em, Gg, Gg, Gg, Gg^Em, Gs^Fms, Gs^Fms, Gs^Fds, Gs^Fds, Gs^Fms, Gll^Fp, Gll^Fp
Gll^Fp, Gll^Fp, Gll^Fp, Gll^Fp, Gs^Fms, Gs^Fms, Gs^Fms, Hh^Fms, Gs^Fms, Gs^Fms, Gs^Fms, Re, Gs^Fp, Gs^Fms, Gs^Fms, Gs^Fms, Gs^Fms, Gs^Fp, Gs^Fp, Gs^Fp, Gs^Fms, Gs^Fms, Gs^Fms, Gs^Fp, Gs^Fms, Gs^Fp, Gs^Fms, Gs^Fms, Gs^Fms, Gs^Fp, Ds, Gs^Fp, Ww, Ww, Ds^Qhh, Gs^Fp, Gg, Gs^Fms, Gs^Fms, Gs^Fp, Gg, Gg, Gs^Fp, Gs^Fp, Gs^Fms, Gg^Fet, Gs^Fms, Gll^Fp, Gs^Fp, Gll^Fp
Gg, Gll^Fp, Gll^Fp, Gll^Fp, Gs^Fms, Gs^Fms, Gg, Gs^Fp, Gs^Fds, Gs^Fms, Gs^Fms, Re, Re, Gs^Fms, Gg, Gs^Fms, Gs^Fds, Gs^Fp, Gs^Fms, Gs^Fp, Gs^Fds, Gs^Fms, Gs^Fds, Gs^Fp, Gg, Gs^Fms, Gs^Fp, Gs^Fp, Ds, Gs^Fp, Ww, Ww, Ds, Ds^Esd, Gg^Qhh, Gg, Hh, Gs^Fp, Gs^Fms, Gs^Fp, Mm, Hh, Hh, Gs^Fms, Gs^Fms, Gs^Fms, Gs^Fp, Gs^Fp, Hh, Hh
Gll^Fp, Gll^Fp, Gll^Fp, Gll^Fp, Gs^Fp, Gs^Fms, Gs^Fms, Gg^Em, Gg, Gg, Gs^Fds, Gs^Fp, Rd, Gg^Efm, Gs^Fms, Gs^Fds, Gs^Fds, Gs^Fms, Gs^Fms, Gs^Fms, Gg^Efm, Gg^Efm, Gg, Gs^Fp, Gg, Gs^Fp, Gg, Ds, Ww, Ww, Gs^Fp, Gs^Fms, Gg, Gg^Qhh, Hh, Hh, Mm, Hh, Gs^Fp, Hh, Mm, Mm, Gs^Fms, Gs^Fms, Gs^Fms, Gs^Fp, Hh, Gs^Fp, Gs^Fp, Hh
Gll^Fp, Gll^Fp, Gll^Fp, Gll^Fp, Gs^Fp, Gs^Fp, Gs^Fms, Gg, Gg^Efm, Gs^Fds, Gs^Fp, Gg, Re, Gg, Gg^Efm, Gs^Fds, Gg^Efm, Gs^Fms, Gs^Fp, Gs^Fp, Gg, Gg, Ds, Gs^Fp, Ww, Ds, Ds, Ds, Ww, Ds, Gg, Gs^Fms, Gs^Qhhf, Gg^Qhh, Hh, Mm, Hh, Mm, Gs^Fp, Gs^Fp, Hh, Mm, Hh, Gs^Fms, Chr, Chr, Hh, Hh, Mm, Mm
Gll^Fp, Gll^Fp, Gll^Fp, Gll^Fp, Gg, Gg^Efm, Gs^Fms, Gg, Gs^Fms, Gg, Gg^Efm, Gg, Gg^Vh, Re, Rd^Esd, Gg, Gg, Gs^Fp, Ds, Ds^Xo, Ds^Xo, Gg, Ww, Ww, Ds, Ww, Ww, Ww, Ds, Ds^Esd, Gg, Gs^Qhhf, Hh, Gs^Fp, Mm, Mm, Hh, Hh, Gg, Hh, Hh, Hh, Hh, Mm, Hh, Chr, Gs^Fp, Hh, Mm^_mh, Mm
Gll^Fp, Gg^Em, Gg, Gll^Fp, Gs^Fp, Gg, Gs^Fds, Gs^Fp, Gs^Fms, Gs^Fms, Gs^Fms, Gg, Gg, Re, Rd^Esd, Ds^Esd, Wwf^Qhu, Ww^Qhu, Ww^Qhu, Ww^Qhu, Ww^Qhu, Ww^Xo, Ds, Gg, Gs^Fp, Gg, Gs^Fp, Gg, Gg, Gs^Fp, Gs^Fp, Hh^Qhh, Hh^Qhh, Mm, Mm, Mm, Gg, Gg, Hh, Hh, Mm, Mm, Mm, Hh, Hh, Gs^Fp, Gs^Fp, Chr, Mm, Mm
Gg, Gg^Em, Gll^Fp, Gg, Gs^Fp, Gg, Gs^Fp, Gs^Fp, Gg^Qhu, Gs^Fp, Gs^Qhuf, Gs^Fp, Gs^Fp, Ds, Wwf^Qhu, Wwf^Qhu, Ds^Esd, Rd, Gs^Fp, Ds, Gs^Fms, Gg^Xo, Gs^Fms, Gs^Fms, Gs^Fms, Gg, Gs^Fp, Gs^Fp, Gg^Em, Gs^Fp, Gs^Fp, Mm, Hh^Qhh, Gs^Fp, Gg, Gg, Gg, Gs^Fp, Gg, Mm, Mm, Mm, Mm, Mm, Hh, Gs^Fp, Hh, Mm, Mm, Mm
Gg, Gg^Efm, Gll^Fp, Gg, Gs^Fp, Gs^Fp, Ds, Ds^Qhu, Ww, Ww^Qhu, Ww^Xo, Ww^Qhu, Ww^Qhu, Ww^Qhu, Ds, Ds, Gg, Gg, Gg^Efm, Gg, Gg^Ve, Gs^Fds, Gg, Gs^Fms, Gs^Fds, Gs^Fds, Gs^Fp, Gs^Fp, Gg, Gg, Hh, Hh, Gs^Qhhf, Gs^Fp, Hh, Hh, Hh, Gs^Fp, Gs^Fms, Hh, Gs^Fds, Gs^Fms, Hh, Mm, Hh, Hh, Hh^Qhh, Mm, Mm, Mm
Gg, Gll^Fp, Gg, Gg, Ds^Qhu, Gs^Fp, Ww^Qhu, Ww^Qhu, Gs^Fp, Ds, Ds^Xo, Gs^Fp, Ds^Esd, Gg, Gg, Gs^Fms, Gs^Fms, Re, Gg, Gg^Efm, Gs^Fms, Gs^Fds, Gg, Gs^Fms, Gs^Fds, Gs^Fms, Gs^Fms, Gs^Fp, Gg, Gs^Fp, Gs^Fms, Gs^Fp, Gs^Fp, Hh^Qhh, Hh, Mm, Mm, Hh, Gs^Fds, Gs^Fms, Hh, Gs^Fms, Gs^Fds, Gs^Fds, Gs^Fp, Chr^Qhh, Hh, Mm^Qhh, Mm^Qhh, Mm^Qhh
Gg, Gll^Fp, Ds, Ds^Esd, Ww^Qhu, Ww^Qhu, Ds^Esd, Gg, Gs^Fms, Gs^Fms, Gs^Fds, Gg, Gg, Gs^Fp, Gg^Efm, Gg, Gs^Fds, Re, Re, Gg^Efm, Gs^Fms, Gg, Gg, Gs^Fp, Gs^Fds, Gs^Fms, Gs^Fds, Gs^Fms, Gs^Fms, Gs^Fms, Gs^Fp, Hh, Hh, Mm^Qhh, Mm^Qhh, Mm^Qhh, Mm^Qhh, Hh^Qhh, Gs^Qhhf, Gs^Fms, Gg^Em, Gs^Fp, Hh, Gs^Fds, Hh, Mm^Qhh, Hh, Hh, Hh, Hh
Gg^Efm, Gg, Ds, Ww^Qhu, Gs^Fds, Ds, Gs^Fds, Gs^Fds, Gs, Gs^Fms, Gs^Fds, Gs^Fms, Gs^Fms, Gs^Fms, Gs^Xo, Gs^Fds, Gg^Fet, Gs^Fms, Gg, Rd, Rd, Gg, Gg, Gs^Fp, Gg, Gg, Gs^Fms, Gs^Fds, Gs^Fds, Gs^Fms, Gs^Fms, Hh, Hh, Gs^Fms, Gs^Fms, Hh, Gs^Fds, Hh, Gg, Gg^Qhh, Gg^Qhh, Gg^Qhh, Hh^Qhh, Hh, Mm, Mm^Qhh, Mm, Hh, Hh, Hh
Rp, Gg, Wwf^Qhu, Ww^Qhu, Gs^Fp, Gs^Fms, Gs^Fms, Gs^Fds, Gg^Ve, Gs^Fp, Gg, Gs, Gs, Gs, Gg, Gg, Gg, Gs^Fp, Gg^Efm, Gg, Rp, Gg^Vh, Gs, Gs, Re, Gs, Gg, Gs^Fp, Gs^Fds, Gs^Fp, Gs^Fp, Gs^Fp, Gg^Ve, Gg, Gg, Gs^Fds, Gs^Fds, Gs^Fms, Gg, Gs^Fms, Gg, Gg, Hh, Mm^Qhh, Mm^Qhh, Mm^Qhh, Mm, Mm, Mm, Hh
Rp, Gg, Ww^Qhu, Wwf, Gg, Gs^Fms, Gg, Gs, Gg, Gg, Gg, Gs, Re, Gg, Re, Gg, Rd, Gg^Fet, Rp, Gg^_ml, Rp, Rd, Ce, Ce, Ce, Gg, Gg, Gg, Gs^Fms, Gg, Gs, Gg, Gg, Gs^Fms, Ce, Ce, Ce, Gg, Gg, Gs^Fds, Gs^Fds, Gs^Fms, Gs^Fms, Mm, Mm, Mm, Mm, Mm, Mm, Hh
Gg, Rp, Wwf^Qhu, Rp, Rp, Gg, Ce, Ce, Ce, Ce, Rp, Re, Gg, Re, Gs, Re, Gs^Fms, Rp, Gs, Rp, Rd, Rp, Ce, 9 Ke, Ce, Gs, Gs, Rd^Vh, Gg, Gg, Gs, Gs, Re, Ce, Ce, 2 Ke, Ce, Gg, Gg^Ve, Gs^Fds, Gs^Fms, Gg, Gg, Hh, Mm, Mm, Hh, Hh, Hh, Hh
Ww^Qhu, Wwf^Qhu, Ds, Gg, Gs^Fms, Rp, Ce, 3 Ke, Ce, Ce, Gg, Gg^Vh, Gs^Fms, Gs^Fms, Gs, Gg, Gs^Fds, Gg, Gs, Gs^Fds, Rd, Gg, Gs, Ce, Re, Re, Re, Re, Re, Gs, Re, Re, Gs, Gg, Gs^Fms, Ce, Gs^Fds, Gs^Fms, Gs, Gs^Fds, Gs^Fds, Gs^Fds, Gs^Fds, Hh, Hh, Mm, Hh, Hh, Hh, Hh
Gll^Fp, Ds, Gll^Fp, Gg, Gs^Fms, Gg, Gg, Ce, Gg, Gs, Gg, Gg, Gs^Fms, Gs^Fds, Gs^Fms, Gs, Gs^Fds, Gg, Gs^Fds, Gs^Vh, Re, Gg, Gs, Gs, Re^Gvs, Re^Gvs, Re, Re^Gvs, Re, Re^Gvs, Re^Gvs, Re, Gs, Gg^Ve, Gg, Gs^Fds, Gs^Fms, Gs^Fds, Gs, Gs^Fms, Gs^Fms, Gs^Fms, Gs^Fms, Gg, Gs^Fms, Hh, Gs^Fp, Gs^Fp, Gs^Fms, Gs^Fms
Gll^Fp, Gll^Fp, Gs^Fds, Gll^Fp, Gs^Fds, Gs^Fms, Gg^Vh, Gg, Gs, Gs, Gs^Fms, Gs, Gs, Gs^Fds, Gs^Fds, Gs^Fds, Gs^Fms, Gg, Gs^Fds, Gs^Fms, Gg, Re, Gg^Wm, Re^Gvs, Re, Re, Re^Gvs, Re^Gvs, Re, Re, Re^Gvs, Re^Gvs, Re^Gvs, Gs, Gs^Fms, Gs^Fds, Gs^Fds, Gs, Gs, Gs, Gs, Gg, Gs, Gs, Gs^Fms, Gs^Fms, Gs^Fp, Gs^Fms, Gs^Fms, Gs^Fms
Gs^Fds, Gll^Fp, Gs^Fms, Gs^Fds, Gs^Fms, Gs^Fds, Gs^Fds, Gs^Fds, Gs^Fms, Gs^Fds, Gs, Gs^Fds, Gs, Gs^Fms, Gs^Fds, Hh, Hh, Gs^Fds, Gs, Gs, Gg, Rd, Gs, Re^Gvs, Re^Gvs, Re^Gvs, Re, Re, Re^Gvs, Re^Gvs, Re, Re, Gs, Gs^Fms, Gs, Gs^Fms, Gs^Fds, Gs^Fms, Gg^Wm, Gs, Re^Gvs, Gs, Gs^Fms, Gs, Gs^Fms, Gs^Fp, Gg, Gs^Fms, Gg, Gs^Fms
Gs^Fms, Gs^Fms, Gs^Fms, Gs^Fds, Gs^Fds, Gs^Fds, Gs^Fms, Gs^Fds, Hh, Gs^Fds, Gs^Fds, Gs^Fds, Gs^Fms, Gs^Fms, Hh, Hh, Gs^Fds, Gs^Fds, Gg^Vh, Gs, Gs^Fms, Rd, Gs, Gs, Re, Re, Re, Re^Gvs, Re, Re, Gg^Wm, Gg, Gs, Gs^Fms, Gs, Gs, Gs, Gs^Fms, Re, Re, Re^Gvs, Re^Gvs, Re^Gvs, Gs^Fms, Gg^Vh, Re, Re^Qhu, Gg^Qhu, Gg, Gs^Fms
Gs^Fms, Gs^Fms, Gs^Fds, Gs^Fds, Hh, Gs^Fds, Hh, Hh, Gs^Fms, Gs^Fds, Gs^Fmw, Gs^Fds, Gg^Ve, Gs, Gg, Gs^Fmw, Gg, Gs^Fms, Gg, Gs, Gs, Re, Re, Re, Re, Re, Gs, Re, Gs, Gs, Gs, Gg, Gs, Rd, Rd, Gs, Re, Re^Gvs, Re^Gvs, Re, Re^Gvs, Re^Gvs, Re, Re, Re^Gvs, Gg, Gg^Qhu, Gs, Re, Gg
Gll^Fmw, Gs^Fds, Gll^Fmw, Gs^Fds, Hh, Hh, Hh, Hh, Gs, Gs^Fmw, Gg, Gs, Gg, Gg, Re^Gvs, Re^Gvs, Re^Gvs, Gg^Wm, Gg, Gs, Gg, Gs, Gg, Re, Gs, Re, Re, Gs, Re, Re, Gs, Gs, Gs, Gd, Re, Gs, Gg^Vh, Re^Gvs, Re^Gvs, Re^Gvs, Re^Gvs, Re^Gvs, Re^Gvs, Re^Gvs, Re, Re^Gvs, Gg^Fet, Gs^Qhu, Gd, Gg
Gll^Fmw, Gll^Fmw, Gll^Fmw, Gll^Fmw, Gs^Fp, Hh, Gs^Fmw, Hh, Gs, Gs^Fmw, Gs, Gg^Vh, Gg, Gg, Gg, Re^Gvs, Gg, Gg, Gs, Gg, Re^Gvs, Gg, Gg^Wm, Gs, Gs, Re, Re, Gs, Re, Rd, Gg, Re, Re, Re, Gs, Gs, Gg, Gg, Gg^Wm, Re, Re^Gvs, Re^Gvs, Re, Re^Gvs, Re^Gvs, Re^Gvs, Gg, Gs^Qhu, Re, Gg
Gll^Fmw, Gll^Fmw, Gd^Fmw, Gll^Fmw, Hh, Gs^Fmw, Gs, Hh, Re, Gg, Re^Gvs, Gg, Gg^Wm, Gs, Gg, Gg, Gg, Gg, Gs, Re, Re, Re, Gg, Gg, Gs, Gd, Re, Re, Re, Re, Gs, Re, Rd, Rd, Rd, Gs, Gs, Gg, Gg, Gg, Gg^Ve, Re^Gvs, Re^Gvs, Re^Gvs, Gs, Gs, Gg, Gs^Qhu, Gs, Re
Gll^Fmw, Gll^Fdw, Re^Fdw, Re^Fdw, Re, Gs, Gd, Gs, Re, Re^Gvs, Re, Re^Gvs, Gg, Re, Re, Re^Gvs, Re^Gvs, Gg^Wm, Gs, Gs, Gg, Gs, Re, Gs, Re, Re, Re, Gd, Gd, Gs, Rd, Rd, Rd, Re, Re, Gs, Gs^Fdw, Hh^Fdw, Hh, Gg, Gg, Gg, Gg, Gs, Gs^Qhu, Gg^Qhu, Gs^Qhu, Gg^Qhu, Gs^Fms, Gg
Gll^Fdw, Gd^Fdw, Gd, Re, Gd^Edt, Gd^Edt, Gs, Gs, Gs, Re, Re, Gs, Gg, Re, Re, Re^Gvs, Gs, Gs, Gd, Gs, Gd, Gs, Re, Gs, Re, Rd, Gs, Gd, Re, Gs, Gs, Re, Re, Re, Re, Gs, Gs, Hh^Fdw, Hh, Gs, Hh, Hh, Hh, Hh^Qhu, Hh^Fdw, Hh, Gs, Gg, Gs^Fms, Gs^Fms
Gd, Gs, Cer^Edt, Cer^Edt, Cer, Re^Edt, Gs, Gd, Gs^Vc, Re, Gs, Gs, Re, Gs, Gs, Re, Gs, Gd, Hhd^Fdw, Gs, Re, Gd, Re, Re, Rd, Rd, Gs, Gd, Re, Rd, Gs, Hhd^Fdw, Hhd, Gs, Re, Gd, Gs, Gs, Hh, Hh^Fdw, Mm, Mm, Hh, Hh^Qhu, Hh^Qhu, Hh, Hh, Gs, Gs, Gs
Gd^Edt, Re^Edt, Cer^Edt, 4 Ke^Edt, Cer, Re, Re^Edt, Re, Re^Edt, Re, Re, Gs, Re, Gs, Re, Re, Gs, Gs, Hhd, Re, Re, Gs, Gs, Gd, Re, Gs, Re, Re, Re, Rd, Gs, Gd, Gs, Gs, Re, Rd, Rd^Edt, Re, Re, Hh, Gs^Edt, Hh, Gg^Vc, Hh^Fdw, Hh^Qhu, Hh, Hh, Hh, Hh, Hh
Gd, Re^Edt, Gd, Cer^Edt, Re^Edt, Re, Gs, Re, Re, Gs, Rd, Gd, Gs, Rd, Re^Esd, Re, Gs, Hhd, Hhd^Fdw, Hhd^Fdw, Rd, Gs, Gs, Re, Re, Hhd, Hhd, Gs, Hhd^Fdw, Re, Re, Re, Gs, Re, Gs, Gs, Re, Re, Gs^Fdw, Rd, Gs^Edt, Gs, Gg, Gg, Gs^Qhu, Hh^Qhu, Hh, Hh, Hh, Hh
Re, Gs, Gd^Fdw, Gs, Re, Gs, Gd^Fdw, Re^Fdw, Re^Edt, Re, Gs, Gd, Ww, Gs, Ds, Re^Edt, Ds^Es, Gs, Rd, Hhd, Re, Rd, Gd, Gd, Gd^Fdw, Hhd^Fdw, Gd^Fdw, Gs, Gs^Esd, Hhd, Gs, Gd, Rd^Edt, Rd, Gs, Gs, Hh^Fdw, Hh, Gs^Fdw, Re, Rd^Edt, Gg^Edt, Cer^Edt, Gs^Fdw, Gs^Fdw, Gs^Qhu, Hh, Mm, Mm, Hh
Gs, Re, Ds, Ds^Esd, Ds^Fdw, Gd^Fdw, Re^Fdw, Re^Fdw, Wwf, Ds, Wwf, Ww, Ww, Ww, Ww, Ds, Ww, Wwf, Wwf, Gs, Ds, Re, Re, Ds^Esd, Ds, Ds, Ds, Ds^Esd, Ds, Gs, Gd, Gd, Re^Edt, Rd, Re^Edt, Gg, Hh, Hh, Gg^Vc, Gs^Fdw, Gg, Cer, 5 Ke, Cer^Edt, Gs, Gs^Qhu, Hh^Qhu, Mm^Qhu, Mm^Qhu, Mm^Qhu
Re^Fdw, Re^Fdw, Ds, Ds, Ww, Ds^Fdw, Wwf, Ds, Ww, Ww, Wwf, Wwf, Ww, Ww, Wo, Ww, Ww, Wwf^Es, Wwf, Ww^Es, Wwf, Ww, Wwf, Ww, Ww, Wwf^Es, Wwf^Es, Wwf, Wwf, Ww, Wwf, Gs, Ds, Rd, Gd^Edt, Gs, Gd, Gs, Gd, Gs, Gs, Cer^Edt, Cer^Edt, Cer^Edt, Gs, Gs, Hh, Hh, Mm, Mm
Ds, Ds, Ww, Ww, Ww, Ww, Wwf^Es, Ww, Ww, Ww, Ds^Es, Ds, Ds, Ww, Ww, Ww, Ww, Ww, Ww, Wwf, Rd, Ww, Wwf^Es, Wwf, Ww, Ww^Es, Wwf, Ww, Wwf^Es, Ww, Wwf, Wwf, Ww, Ds, Gs, Re^Edt, Gs, Re^Edt, Gs, Gg^Edt, Gs^Fdw, Gg, Gs, Gs, Gs, Hh, Mm, Hh, Mm, Mm
Ww, Ww, Wo, Ww, Wwf, Ww, Ww, Ww, Gs^Vc, Gs, Hh, Hh, Mm^Qhh, Hh^Qhh, Hh^Qhh, Hh, Wwf, Ww, Gs^Fmw, Ds, Rd, Ds, Ds, Wwf, Gs^Vc, Ds, Ds, Ds, Mm^Qhh, Ds, Ww, Ww, Ww, Ds^Esd, Gs, Gs, Re^Edt, Re, Gs^Fdw, Gs^Fdw, Gs^Fdw, Gg^Vc, Hh, Gs^Fdw, Hh, Hh, Mm, Mm, Mm, Mm
Ww, Wo, Wo, Ww, Ds^Esd, Ds, Re, Re, Gs, Re, Hh, Hh, Mm^Qhh, Mm, Mm, Hh^Qhh, Mm^Qhh, Hh, Gs, Gg, Cer, Cer^Edt, Cer^Edt, Gs, Gs^Fmw, Gs, Hh^Qhh, Mm^Qhh, Mm, Hh^Qhh, Hh^Qhh, Ww, Ww, Ww, Wwf, Ds, Gs, Gs, Hh^Fdw, Hh, Mm, Hh, Mm, Hh, Mm, Hh, Mm, Mm, Mm, Mm
Wo, Wo, Gs, Ds^Esd, Gs, Gs, Gs, Re, Hh, Hh, Mm^Qhh, Mm^Qhh, Mm, Mm, Mm, Mm, Mm^Qhh, Hh, Gs^Fmw, Gs, Cer, 7 Ke, Cer^Edt, Gs, Gs, Hh, Hh, Mm, Hh, Mm, Mm, Hh^Qhh, Ww, Wwf, Wwf^Es, Ww, Ww, Gs, Hh, Mm, Mm, Mm, Ds, Mm, Hh, Mm, Mm, Mm, Mm, Mm
Gs, Gs, Gs, Gs, Gs, Hh, Hh, Gs, Hh^Qhh, Mm^Qhh, Mm, Mm, Mm, Mm, Mm, Mm, Mm^Qhh, Hh, Gs^Fmw, Gs, Gs^Edt, Cer^Edt, Re, Gs^Vc, Gs, Mm, Hh, Mm, Mm, Mm, Mm, Mm^Qhh, Hh^Qhh, Wwf, Ww, Wwf, Ww, Ww, Wwf, Ds, Ds^Es, Ds, Ww, Ds, Ww, Hh, Hh, Hh, Hh, Mm
Hh, Hh, Hh, Hh, Mm^Qhh, Mm^Qhh, Mm^Qhh, Hh^Qhh, Mm, Mm, Mm^Xm, Mm, Mm, Mm, Mm, Mm, Mm, Hh^Qhh, Hh^Qhh, Gs, Gs, Re^Edt, Hh, Hh, Gs, Hh, Hh, Mm, Mm, Hh, Hh, Hh, Gs^Qhhf, Gs^Fdw, Re, Wwf^Es, Wwf, Wwf, Wwf^Es, Ww, Ww, Ww, Wo, Wo, Wo, Ww, Ww, Hh, Hh, Hh
Hh^Qhh, Mm^Qhh, Mm^Qhh, Mm^Qhh, Mm, Mm, Mm, Mm, Mm^Xm, Mm^Xm, Mm^Xm, Mm, Mm, Mm, Mm, Mm, Mm, Mm, Hh^Qhh, Gs^Fmw, Gg, Re, Gg^Fp, Hh, Hh, Hh, Mm, Mm, Mm, Mm, Mm, Hh, Hh, Gs^Qhh, Gd, Gs, Gs^Fdw, Ww, Hh, Ww, Ww, Ww, Ww, Ww, Ww, Ww, Wo, Ww, Ww, Hh
Mm, Mm, Mm, Mm^Xm, Mm^Xm, Mm, Mm, Mm, Mm^Xm, Mm^Xm, Mm^Xm, Mm, Mm, Mm, Mm, Mm, Mm^Qhh, Mm, Hh^Qhh, Hh, Gg, Gs, Hh, Mm, Hh, Hh, Mm, Mm, Mm, Mm, Mm, Hh, Gs^Fdw, Gs^Qhh, Re^Qhh, Gs, Hh^Qhh, Hh, Mm^Qhh, Hh, Hh^Qhh, Hh^Qhh, Hh^Qhh, Hh^Qhh, Mm^Qhh, Mm, Ww, Ww, Wo, Hh
Mm, Mm, Mm, Mm^Xm, Mm^Xm, Mm, Mm, Mm, Mm^Xm, Mm^Xm, Mm^Xm, Mm^Xm, Mm, Mm, Mm, Mm^Qhh, Hh, Mm^Qhh, Gs^Fmw, Gs^Fdw, Gs, Re, Gg^Fp, Mm, Hh, Hh, Mm, Mm, Mm, Mm, Hh, Hh^Vc, Re^Edt, Re, Re, Gs^Qhhf, Hh, Mm^Qhh, Mm, Mm^Qhh, Mm, Mm, Mm, Mm, Mm^Qhh, Hh, Hh, Ww, Wo, Ww
Mm, Mm^Xm, Mm, Mm^Xm, Mm^Xm, Mm, Mm^_mhh, Mm^Xm, Mm^Xm, Mm^Xm, Mm, Mm, Mm, Mm, Hh^Qhh, Hh^Qhh, Hh, Hh, Gs^Fmw, Gs^Fmw, Re, Rd, Gg, Hh, Mm, Hh, Hh, Hh, Hh, Hh, Gs^Fmw, Re, Cer^Edt, Cer^Edt, Cer, Hh, Hh^Vc, Mm, Mm, Mm, Mm^Xm, Mm, Mm, Mm, Mm, Mm^Qhh, Hh, Ww, Ww, Wo
Mm^Xm, Mm^Xm, Mm^Xm, Mm^Xm, Mm^Xm, Mm^Xm, Mm^Xm, Mm^Xm, Mm^Xm, Mm^Xm, Mm, Mm, Mm, Mm, Hh^Qhh, Hh, Gg, Gg^Fp, Gg, Gs, Rd, Gg, Gs^Fmw, Hh, Re, Gs, Gs, Hh, Gs, Hh, Re^Fdw, Re, Cer, 6 Ke, Cer^Edt, Re^Edt, Gs, Mm, Mm, Mm, Mm^Xm, Mm^Xm, Mm^Xm, Mm, Mm, Mm^Qhh, Mm^Qhh, Hh, Hh, Ww
Mm^Xm, Mm^Xm, Mm^Xm, Mm^Xm, Mm^Xm, Mm^Xm, Mm^Xm, Mm^Xm, Mm^Xm, Mm^Xm, Mm, Mm, Mm, Hh, Hh^Qhh, Hh, Gs^Fdw, Gg, Gs^Fmw, Gg, Rd, Gs, Gs^Fdw, Gs, Gg, Gs, Gg, Gg, Gg, Gg, Gs, Re^Edt, Re^Edt, Cer, Re^Edt, Re, Gs, Hh, Mm, Mm, Mm^Xm, Mm^Xm, Mm^Xm, Mm^Xm, Mm, Mm^Xm, Md^Xm, Mm^Qhh, Mm^Qhh, Hh
Mm^Xm, Mm^Xm, Mm^Xm, Mm^Xm, Mm^Xm, Mm^Xm, Mm^Xm, Mm^Xm, Mm^Xm, Mm^Xm, Mm, Mm, Mm^Qhh, Mm^Qhh, Hh, Hh, Gs^Fdw, Gs^Fdw, Gs^Fmw, Gg, Gd, Gs, Gs^Fmw, Gg, Hh, Gg, Gs, Gs, Gs, Gs, Gs, Re^Edt, Gs^Fdw, Gs^Vc, Re, Gs, Hh, Hh, Hh, Mm, Mm^Xm, Mm^Xm, Md, Mm, Md^Xm, Md^Xm, Md^Xm, Mm, Mm, Mm^Qhh
Mm^Xm, Mm^Xm, Mm^Xm, Mm^Xm, Mm^Xm, Mm^Xm, Mm^Xm, Mm^Xm, Mm^Xm, Mm^Xm, Mm, Mm, Hh^Qhh, Hh, Mm, Hh, Gg, Gs^Fmw, Re, Rd, Gg, Gs^Fdw, Gs^Fdw, Hh, Hh, Gs^Fp, Hh, Gs^Fp, Gs^Fmw, Gll^Fmw, Gll^Fmw, Gs, Gs, Gs, Gs, Gg, Hh, Hh, Md, Mm, Md, Md, Md, Md, Md^Xm, Md^Xm, Md^Xm, Mm, Mm, Mm
Mm^Xm, Mm^Xm, Mm^Xm, Mm^Xm, Mm^Xm, Mm^Xm, Mm^Xm, Mm^Xm, Mm, Mm, Mm, Mm, Mm^Qhh, Hh, Mm, Hh, Gs^Fmw, Gs^Fmw, Rd, Gg, Gs^Fmw, Gs^Fdw, Gs^Fp, Hh, Mm, Hh, Mm, Hh, Mm, Hh, Mm, Mm, Mm, Hh, Hh, Hh, Mm, Md, Md, Md, Md, Md, Md, Md, Md, Md^Xm, Mm, Mm, Mm, Mm
Mm^Xm, Mm^Xm, Mm^Xm, Mm^Xm, Mm^Xm, Mm^Xm, Mm^Xm, Mm^Xm, Mm, Mm, Mm, Mm, Mm, Mm^Qhh, Mm^Qhh, Hh^Fdw, Gs^Fdw, Gg, Gd, Gg, Hh, Hh, Mm, Mm, Mm, Mm, Mm, Mm, Mm, Mm, Mm, Mm, Mm, Mm, Md, Mm, Mm, Md, Md, Mm, Mm, Hhd^Fdw, Hhd, Md, Md, Md, Mm, Mm, Md^Xm, Mm^Xm
Mm^Xm, Mm^Xm, Mm^Xm, Mm^Xm, Mm^Xm, Mm^Xm, Mm, Mm^Xm, Mm, Mm, Mm, Mm, Mm, Hh, Mm^Qhh, Hh^Fdw, Gs^Fmw, Re, Gs^Fdw, Gs^Fdw, Hh, Hh, Hh, Mm, Mm, Mm, Mm, Mm, Mm, Mm^Xm, Mm, Mm, Mm, Mm, Md, Md, Md, Md, Mm, Mv, Mm, Hhd, Md, Md, Md, Md, Md, Md, Md, Md
Mm^Xm, Mm^Xm, Mm^Xm, Mm^Xm, Mm^Xm, Mm^Xm, Mm, Mm, Mm, Mm, Mm^Qhh, Hh^Qhh, Hh^Qhh, Hh^Qhh, Gs^Fmw, Hh, Re, Re, Hh, Hh, Hh, Hh, Mm, Mm, Mm, Mm, Mm, Mm^Xm, Mm^Xm, Mm^Xm, Mm, Mm, Mm, Md, Md, Hhd, Hhd^Fdw, Hhd, Hhd, Mm, Hhd, Md, Md, Md, Md, Md, Md, Md, Md, Md
Mm^Xm, Mm^Xm, Mm^Xm, Mm^Xm, Mm^Xm, Mm^Xm, Mm, Mm, Mm, Hh, Hh^Qhh, Hh, Hh, Gs^Fmw, Hh^Fdw, Gd, Gs, Hh^Fdw, Hh, Hh, Hh, Hh, Mm, Mm, Mm, Mm, Mm, Mm^Xm, Mm^Xm, Mm^Xm, Mm, Mm, Md, Md, Md, Hhd, Gll^_mh, Hhd^Fdw, Hhd, Hhd, Hhd, Md, Md, Md, Md, Md, Mm, Md, Md, Mm
Mm^Xm, Mm^Xm, Mm^Xm, Mm^Xm, Mm^Xm, Mm, Mm, Mm, Hh, Hh^Qhh, Hh, Hh, Gs^Fp, Gs^Fmw, Gs, Re, Gs, Gs^Fdw, Hh, Mm, Mm, Mm, Mm, Mm, Mm, Mm, Mm^Xm, Mm^Xm, Mm^Xm, Mm, Mm, Mm, Md, Md, Md, Hhd, Hhd, Hhd^Fdw, Hhd, Hhd, Md, Md, Md, Md, Md, Md, Md, Md, Md, Md
Mm^Xm, Mm^Xm, Mm^Xm, Mm^Xm, Mm^Xm, Mm, Mm, Mm, Hh, Hh^Qhh, Hh, Hh, Mm, Hh, Gg, Re, Hh, Hh, Mm, Mm, Mm, Mm, Mm, Mm, Mm, Mm, Mm^Xm, Mm^Xm, Mm^Xm, Md, Md, Md, Md, Md, Md, Md, Md, Md, Md, Hhd, Hhd, Md, Md, Md, Md, Md, Md, Md, Md, Md
