border_size=1
usage=map

Mm^Xm       , Mm^Xm       , Mm^Xm       , Mm^Xm       , Mm^Xm       , Mm^Xm       , Mm^Xm       , Hh          , Hh          , Gs          , Rd          , Ds          , Ds          , Gs          , Gs          , Gs          , Gd          , Hhd         , Hhd         , Mm          , Mm          , Mm^Xm       , Mm          , Mm          , Mm          , Mm^Xm       , Mm^Xm       , Mm^Xm       , Mm^Xm       , Mm^Xm       , Mm^Xm       , Mm^Xm       
Mm^Xm       , Mm^Xm       , Mm          , Mm^Xm       , Mm          , Mm^Xm       , Mm^Xm       , Mm^Xm       , Hh          , Gd          , Gd          , Ds          , Gs          , Gs^Es       , Ds          , Ds          , Gd          , Hhd         , Hhd         , Hhd         , Hhd         , Mm          , Mm^Xm       , Mm          , Mm          , Mm^Xm       , Mm^Xm       , Mm^Xm       , Mm^Xm       , Mm^Xm       , Mm^Xm       , Mm^Xm       
Mm^Xm       , Mm          , Mm          , Mm          , Mm          , Mm          , Mm          , Mm^Xm       , Hh          , Hh          , Hh          , Hhd         , Hh          , Gs          , Ds          , Ds          , Ds          , Hh          , Ds          , Hh          , Hhd         , Mm          , Mm          , Mm^Xm       , Mm^Xm       , Mm^Xm       , Mm          , Mm^Xm       , Mm^Xm       , Mm^Xm       , Mm^Xm       , Mm^Xm       
Mm          , Mm          , Mm^Xm       , Mm          , Mm          , Mm^Xm       , Mm          , Mm          , Mm          , Hh          , Hhd         , Hhd         , Ds          , Re^Vct      , Gs          , Ds          , Gs          , Hh          , Ds          , Ds          , Hh          , Mm          , Mm          , Mm          , Mm          , Mm          , Mm^Xm       , Mm          , Mm^Xm       , Mm^Xm       , Mm^Xm       , Mm^Xm       
Mm          , Mm^Xm       , Mm          , Mm          , Mm          , Mm          , Mm          , Mm          , Mm          , Hh          , Ds          , Rd          , Ds          , Ds          , Ce          , Ce          , Ce^Es       , Ds          , Rd          , Hh^Vc       , Hh          , Hh          , Hh          , Mm          , Mm          , Mm          , Mm          , Mm          , Mm^Xm       , Mm^Xm       , Mm^Xm       , Mm^Xm       
Mm          , Mm          , Mm^Xm       , Mm^Xm       , Mm          , Mm          , Mm          , Mm          , Mm          , Hh          , Ds          , Ds^Es       , Gs          , Ce          , Ce          , 3 Ke        , Ce          , Ce          , Gd          , Hh          , Hh          , Hh          , Hh          , Mm          , Mm          , Mm          , Mm^Xm       , Mm          , Mm^Xm       , Mm^Xm       , Mm^Xm       , Mm^Xm       
Mm^Xm       , Mm^Xm       , Mm^Xm       , Mm^Xm       , Mm          , Mm          , Mm          , Mm          , Hh          , Hh^Vc       , Gs          , Ds          , Gs          , Ds          , Ds          , Ce          , Ds          , Ds          , Ds          , Gd          , Gs          , Hhd         , Mm          , Mm          , Mm          , Mm          , Mm          , Mm^Xm       , Mm          , Mm^Xm       , Mm^Xm       , Mm^Xm       
Mm^Xm       , Mm^Xm       , Mm          , Mm^Xm       , Mm          , Mm          , Mm          , Mm          , Hh          , Hh          , Hh          , Hh          , Gs          , Gs          , Hh          , Ds          , Gs          , Re          , Rd          , Gs          , Hhd         , Hhd         , Mm          , Mm^Xm       , Mm          , Mm          , Mm          , Mm          , Mm          , Mm^Xm       , Mm^Xm       , Mm^Xm       
Mm^Xm       , Mm^Xm       , Mm          , Mm          , Mm          , Mm          , Mm          , Mm          , Hh          , Ds          , Ds          , Gd          , Gs          , Hh          , Hh          , Ds          , Gd          , Gs^Es       , Hh          , Hhd         , Hhd         , Mm          , Mm          , Mm          , Mm          , Mm          , Mm          , Mm          , Mm^Xm       , Mm^Xm       , Mm^Xm       , Mm^Xm       
Mm^Xm       , Mm^Xm       , Mm^Xm       , Mm          , Mm          , Mm          , Mm          , Mm          , Hh          , Ds          , Gd          , Ds          , Gd          , Gs          , Hh          , Hh          , Gd          , Hh          , Ds          , Gs          , Hhd         , Hh          , Hh          , Mm          , Mm^Xm       , Mm          , Mm          , Mm^Xm       , Mm          , Mm^Xm       , Mm^Xm       , Mm^Xm       
Mm^Xm       , Mm^Xm       , Mm^Xm       , Mm^Xm       , Mm          , Mm          , Mm          , Mm          , Hh          , Gd          , Hhd         , Gd          , Ds          , Gs          , Ds          , Gd          , Gs          , Gs          , Gs          , Gd          , Gs          , Hhd^Es      , Hh          , Mm          , Mm          , Mm          , Mm          , Mm          , Mm          , Mm          , Mm          , Mm^Xm       
Mm          , Mm^Xm       , Mm          , Mm          , Mm^Xm       , Mm          , Mm          , Hhd         , Hhd         , Hh          , Hhd         , Hhd         , Ds          , Gs          , Gs          , Ds          , Gs          , Gs          , Re^Vct      , Rd          , Ds          , Ds          , Hh          , Hh          , Mm          , Mm          , Mm          , Mm          , Mm^Xm       , Mm          , Mm^Xm       , Mm^Xm       
Mm^Xm       , Mm^Xm       , Mm          , Mm          , Mm          , Mm          , Mm          , Hhd         , Hhd         , Hh          , Ds          , Gs          , Gd          , Re^Vct      , Gs          , Gs          , Ds          , Gs^Es       , Gs          , Ds          , Hh          , Hh          , Hh          , Hh          , Mm^Xm       , Mm          , Mm          , Mm^Xm       , Mm^Xm       , Mm^Xm       , Mm^Xm       , Mm^Xm       
Mm^Xm       , Mm          , Mm          , Mm          , Mm          , Mm          , Mm          , Mm          , Hh          , Hh          , Ds          , Gs^Es       , Gd          , Gs          , Ce          , Ce          , Ce          , Ds          , Rd          , Hh          , Hh          , Hh          , Hhd         , Mm          , Mm          , Mm          , Mm          , Mm          , Mm          , Mm          , Mm^Xm       , Mm^Xm       
Mm^Xm       , Mm          , Mm          , Mm          , Mm          , Mm          , Mm          , Mm^Xm       , Mm          , Hh          , Hh          , Hh          , Gs          , Gd          , Ce          , 1 Ke        , Ce          , Ce          , Re          , Hh          , Gd          , Hh          , Hh          , Hhd         , Mm^Xm       , Mm          , Mm          , Mm          , Mm          , Mm^Xm       , Mm^Xm       , Mm^Xm       
Mm^Xm       , Mm^Xm       , Mm          , Mm          , Mm          , Mm          , Mm          , Mm          , Mm          , Hhd         , Hhd^Vc      , Hhd         , Ds          , Gd          , Ds          , Ce          , Gs          , Gs          , Ds          , Gd          , Hd          , Ds          , Hd          , Hhd         , Mm^Xm       , Mm^Xm       , Mm^Xm       , Mm          , Mm^Xm       , Mm^Xm       , Mm^Xm       , Mm^Xm       
Mm^Xm       , Mm^Xm       , Mm^Xm       , Mm          , Mm          , Mm          , Mm          , Mm^Xm       , Mm^Xm       , Hhd         , Hhd         , Hhd         , Ds          , Ds          , Gd          , Gd          , Gd          , Ds          , Gd          , Uzw         , Hd          , Hd          , Hd          , Hhd         , Hd          , Mm^Xm       , Md^Xm       , Mm^Xm       , Mm^Xm       , Mm^Xm       , Mm^Xm       , Mm^Xm       
Md^Xm       , Mm^Xm       , Mm^Xm       , Mm^Xm       , Mm^Xm       , Mm^Xm       , Mm^Xm       , Mm^Xm       , Md^Xm       , Md^Xm       , Hd          , Hhd         , Hd          , Gd          , Hd          , Gd          , Hd          , Ds          , Ds          , Uzw         , Uzw         , Hd          , Hd          , Hd          , Hd          , Md^Xm       , Md^Xm       , Md^Xm       , Md^Xm       , Mm^Xm       , Md^Xm       , Mm^Xm       
Md^Xm       , Md^Xm       , Md^Xm       , Mm^Xm       , Md^Xm       , Md^Xm       , Md^Xm       , Md^Xm       , Hd          , Hd          , Hd          , Hd^Es       , Dd          , Dd          , Ds          , Ds          , Uzw         , Ds          , Yhs         , Yhs         , Yhs         , Hd          , Hd          , Hd          , Hd          , Md          , Md          , Md^Xm       , Md^Xm       , Md^Xm       , Md^Xm       , Md^Xm       
Md^Xm       , Md^Xm       , Md^Xm       , Md^Xm       , Md^Xm       , Md^Xm       , Md^Xm       , Md^Xm       , Hd          , Hd          , Uzw         , Dd          , Yhs^Xp      , Yhs         , Yhs^Xp      , Ds^Esd      , Uzw         , Uzw         , Yhs         , Yhs^Xp      , Yhs         , Yhs^Xp      , Dd          , Hd          , Hd          , Md          , Md          , Md          , Md          , Md^Xm       , Md^Xm       , Md^Xm       
Md^Xm       , Md^Xm       , Md^Xm       , Md^Xm       , Md          , Md          , Md          , Hd          , Co          , Uzw         , Yhs^Xp      , Yhs         , Yhs         , Yhs^Es      , Yhs         , Yhs         , Uzw         , Yhs         , Yhs^Xp      , Yhs^Xp      , Uzw         , Uzw         , Ds          , Hd          , Hd          , Hd          , Md          , Md          , Md          , Md^Xm       , Md^Xm       , Md^Xm       
Md^Xm       , Md^Xm       , Md^Xm       , Md^Xm       , Md          , Md          , Hd          , Dd          , Co          , Yhs         , Ds^Esd      , Ds          , Dd^Vdt      , Yhs^Xp      , Yhs^Xp      , Yhs         , Co          , Co          , Uzw         , Uzw         , Uzw         , Uzw         , Co          , Ds          , Hd          , Hd          , Md          , Md          , Md^Xm       , Md          , Md          , Md^Xm       
Md^Xm       , Md^Xm       , Md^Xm       , Md^Xm       , Md          , Md          , Co          , Co          , Uzw         , Ds          , Uzw         , Uzw         , Uzw         , Dd          , Co          , Co          , Uzw         , Uzw         , Yhs         , Yhs         , Yhs^Xp      , Dd^Vdt      , Co          , Co          , Hd          , Hd          , Md          , Md^Xm       , Md^Xm       , Md          , Md^Xm       , Md^Xm       
Md^Xm       , Md^Xm       , Md^Xm       , Md          , Md^Xm       , Md          , Hd          , Uzw         , Uzw         , Ds          , Ds          , Yhs         , Yhs^Xp      , Uzw         , Yhs         , Uzw         , Uzw         , Yhs         , Yhs^Xp      , Yhs^Es      , Yhs         , Uzw         , Dd          , Co          , Hd          , Md          , Md          , Md          , Md          , Md^Xm       , Md^Xm       , Md^Xm       
Md^Xm       , Md^Xm       , Md^Xm       , Md^Xm       , Md^Xm       , Md          , Hd          , Ds          , Yhs         , Yhs         , Yhs         , Co          , Co          , Yhs         , Yhs         , Yhs         , Uzw         , Co          , Yhs         , Yhs         , Yhs         , Uzw         , Dd          , Ds          , Md          , Md          , Md^Xm       , Md          , Md^Xm       , Md^Xm       , Md^Xm       , Md^Xm       
Md^Xm       , Md^Xm       , Md^Xm       , Md^Xm       , Md          , Md          , Hd          , Rd          , Yhs         , Yhs^Xp      , Uzw         , Uzw         , Co          , Yhs^Xp      , Yhs         , Co          , Co^Es       , Co          , Co          , Co          , Dd          , Yhs         , Dd^Vdt      , Dd          , Hd          , Md          , Md^Xm       , Md^Xm       , Md^Xm       , Md^Xm       , Md^Xm       , Md^Xm       
Md^Xm       , Md^Xm       , Md^Xm       , Md^Xm       , Md          , Md          , Hd          , Hd          , Hd          , Yhs         , Uzw         , Uzw         , Co          , Uzw         , Yhs^Xp      , Yhs         , Co          , 2 Ko        , Co          , Dd          , Yhs         , Uzw         , Hd          , Ds          , Hd          , Md          , Md          , Md^Xm       , Md^Xm       , Md^Xm       , Md^Xm       , Md^Xm       
Md^Xm       , Md^Xm       , Md          , Md^Xm       , Md^Xm       , Md          , Md          , Hd          , Hd          , Dd^Vdt      , Ds          , Ds^Es       , Uzw         , Uzw         , Yhs         , Co          , Uzw         , Co          , Dd          , Co          , Dd          , Hd          , Dd          , Hd          , Hd          , Md          , Md^Xm       , Md^Xm       , Md          , Md^Xm       , Md^Xm       , Md^Xm       
Md^Xm       , Md          , Md          , Md^Xm       , Md          , Md^Xm       , Md          , Md          , Co          , Dd          , Uzw         , Uzw         , Yhs         , Yhs^Xp      , Uzw         , Yhs         , Dd^Vdt      , Co          , Dd          , Dd          , Hd          , Hd          , Ds          , Co          , Hd          , Hd          , Md          , Md          , Md^Xm       , Md^Xm       , Md^Xm       , Md^Xm       
Md^Xm       , Md          , Md          , Md          , Hd          , Md          , Hd          , Co          , Co          , Dd          , Yhs         , Yhs^Xp      , Yhs         , Uzw         , Uzw         , Dd          , Dd          , Dd          , Ds          , Ds          , Uzw         , Uzw         , Uzw         , Co          , Co          , Hd          , Md          , Md          , Md^Xm       , Md^Xm       , Md^Xm       , Md^Xm       
Md          , Md          , Hd          , Hd          , Hd          , Hd          , Uzw         , Hd          , Co          , Co          , Co          , Uzw         , Ds          , Yhs         , Yhs         , Dd          , Co          , Co          , Uzw         , Uzw         , Uzw         , Yhs         , Yhs^Xp      , Uzw         , Ds          , Hd          , Hd          , Md          , Md^Xm       , Md^Xm       , Md^Xm       , Md^Xm       
Md          , Md          , Hd          , Hd          , Uzw         , Uzw         , Uzw         , Uzw         , Co          , Yhs         , Yhs         , Yhs         , Yhs         , Ds          , Ds          , Co          , Dd          , Ds          , Yhs         , Yhs^Xp      , Yhs         , Yhs         , Ds          , Rd          , Ds          , Hd          , Md^Xm       , Md^Xm       , Md^Xm       , Md^Xm       , Md^Xm       , Md^Xm       
