Mm^Xm, Mm, Mm^Xm, Mm, Mm, Mm, Mm^Xm, Mm^Xm, Mm^Xm, Mm^Xm, Mm^Xm, Mm^Xm, Mm^Xm, Mm^Xm, Mm^Xm, Mm^Xm, Mm^Xm, Mm, Mm, Mm, Mm, Hh, Hh, Hh, Gs, Gs, Re, Re, Re, Gs, Hh, Hh, Mm, Mm, Mm, Wog, Mm, Mm, Mm^Xm, Mm^Xm, Mm^Xm, Mm^Xm, Mm^Xm, Mm^Xm
Mm^Xm, Mm^Xm, Mm^Xm, Mm, Mm, Mm, Mm^Xm, Mm^Xm, Mm^Xm, Mm^Xm, Mm^Xm, Mm^Xm, Mm^Xm, Mm, Mm^Xm, Mm^Xm, Mm, Mm, Mm, Mm, Hh, Mm, Hh, Hh, Gs, Re, Re, Re^Edt, Gs^Vct, Gs, Gs^Fdw, Hh, Hh, Mm, Mm, Wog, Wog, Mm, Mm^Xm, Mm^Xm, Mm^Xm, Mm^Xm, Mm^Xm, Mm^Xm
Mm^Xm, Mm^Xm, Mm^Xm, Mm, Mm, Mm, Mm^Xm, Mm^Xm, Mm^Xm, Mm^Xm, Mm^Xm, Mm^Xm, Mm, Mm, Mm, Mm^Xm, Mm, Mm, Hh, Hh, Hh^Fdw, Hh, Gs, Gs, Ce, Re, Re^Es, Re^Es, Gs, Gs, Hh^Fdw, Hh^Fdw, Hh, Mm, Mm^Xm, Mm, Mm^Xm, Wog, Wog, Mm^Xm, Mm^Xm, Mm^Xm, Mm^Xm, Mm^Xm
Mm^Xm, Mm^Xm, Mm^Xm, Mm^Xm, Mm^Xm, Mm^Xm, Mm^Xm, Mm^Xm, Mm, Mm^Xm, Mm, Mm, Mm, Mm, Mm, Mm, Mm, Hh, Gs, Gs, Gd^Fdw, Gs, Gs, Ce, 1 Ke, Ce, Re, Gs, Hh^Fdw, Hh^Fdw, Hh, Hh, Mm, Mm, Mm, Mm^Xm, Wog^Xo, Wog, Mm^Xm, Mm^Xm, Mm^Xm, Mm^Xm, Mm^Xm, Mm^Xm
Mm^Xm, Mm^Xm, Mm^Xm, Mm, Mm, Mm^Xm, Mm, Mm, Mm, Mm^Xm, Hh, Mm, Hh, Mm, Mm, Hh, Gll^Fdw, Gs^Fdw, Gll^Fdw, Gs^Fdw, Gs, Gs^Vct, Re^Edt, Ce, Ce, Ce, Gs, Hh, Hh, Mm, Mm, Mm, Mm, Mm, Mm, Mm^Xm, Wog, Mm^Xm, Mm^Xm, Mm^Xm, Mm^Xm, Mm^Xm, Mm^Xm, Mm^Xm
Mm^Xm, Mm^Xm, Mm^Xm, Mm^Xm, Mm, Mm, Hh, Mm, Mm, Hh, Hh, Mm, Hh, Mm, Hh, Hh^Fdw, Gll^Fdw, Gd^Fdw, Gd, Gs^Fdw, Re^Es, Re, Re, Re, Gs, Gs, Gg, Gs, Hh, Mm, Mm, Mm, Mm, Mm^Xm, Mm^Xm, Mm^Xm, Mm^Xm, Wog, Mm^Xm, Mm^Xm, Mm^Xm, Mm^Xm, Mm^Xm, Mm^Xm
Mm^Xm, Mm^Xm, Mm^Xm, Mm^Xm, Mm, Mm, Hh, Mm, Hh, Hh, Mm, Hh, Hh, Hh, Hh, Gd^Fdw, Gll^Fdw, Gll^Fdw, Gs, Gs, Re, Re^Edt, Gs, Gs^Edt, Gd^Vct, Gs^Es, Gd, Gs, Hh, Hh^Fdw, Mm, Mm, Mm, Mm, Mm^Xm, Mm^Xm, Mm^Xm, Mm^Xm, Mm^Xm, Mm^Xm, Mm^Xm, Mm^Xm, Mm^Xm, Mm^Xm
Mm^Xm, Mm^Xm, Mm^Xm, Mm^Xm, Mm, Mm, Hh, Hh, Hh, Hh, Hh, Hh, Gs, Gs, Gs^Fdw, Gd^Fdw, Gd, Gd, Re, Re^Es, Re, Re, Gll^Fdw, Gs, Gs, Gd^Es, Gs, Gs, Hh^Fdw, Hh, Mm, Mm, Mm, Mm^Xm, Mm, Mm^Xm, Mm^Xm, Mm^Xm, Mm^Xm, Mm^Xm, Mm^Xm, Mm^Xm, Mm^Xm, Mm^Xm
Mm^Xm, Mm^Xm, Mm^Xm, Mm, Mm, Hh, Hh, Mm, Mm, Hh, Gs, Gs, Gs, Gd, Gd, Gs, Gs, Gs^Fdw, Re, Re, Gs, Gs, Gs, Gs, Hh^Fdw, Gs, Gs, Hh, Hh, Hh^Fdw, Mm, Mm, Mm, Re, Mm, Mm^Xm, Mm^Xm, Mm^Xm, Mm^Xm, Mm^Xm, Mm^Xm, Mm^Xm, Mm^Xm, Mm^Xm
Mm, Mm^Xm, Mm, Mm, Mm, Mm, Hhd, Mm, Hhd, Hhd, Gd^Fdw, Gd, Chr, Chr, Gd^Edt, Gd, Re, Re, Re, Re, Gd^Fdw, Gd, Gs, Hh, Hh, Hh, Hh, Hh, Mm, Hh, Mm, Mm, Mm, Mm, Mm^Xm, Mm^Xm, Mm^Xm, Mm^Xm, Mm^Xm, Mm^Xm, Mm^Xm, Mm^Xm, Mm^Xm, Mm^Xm
Mm, Mm, Mm, Mm, Mm, Mm, Hhd, Hhd, Hhd, Hhd^Fdw, Gd^Fdw, Gs, Chr, Gs^Edt, Gs^Edt, Gs^Fdw, Re, Re, Gs, Gs, Chr, Gd, Gs, Hh^Fdw, Mm, Mm, Mm, Hh, Hh, Hh, Mm, Mm, Mm, Mm^Xm, Wog^Xo, Wog, Mm^Xm, Mm^Xm, Mm^Xm, Mm^Xm, Mm^Xm, Mm^Xm, Mm^Xm, Mm^Xm
Mm, Mm, Mm^Xm, Mm^Xm, Mm, Mm, Hhd, Hhd, Gd^Fdw, Gd^Fdw, Gd^Fdw, Gs, Gd, Chr, Gd, Gs, Re, Re, Gs, Gd, Chr, Gs, Hh, Hh, Mm, Mm, Mm, Mm, Mm, Mm, Mm, Hh, Wog, Wog, Mm^Xm, Mm^Xm, Mm^Xm, Mm^Xm, Mm^Xm, Mm^Xm, Mm^Xm, Mm^Xm, Mm^Xm, Mm^Xm
Mm, Mm, Mm, Mm^Xm, Mm^Xm, Mm, Mm, Hhd, Gll^Fdw, Gll^Fdw, Gll^Fdw, Gs, Gll^Fdw, Gs, Gll^Fdw, Gs, Re^Es, Re, Gs^Edt, Chr, Hh, Gs, Mm, Mm, Chs, Mm, Mm, Mm, Mm, Mm, Mm, Hh, Wog, Mm^Xm, Mm, Mm^Xm, Mm^Xm, Mm^Xm, Mm^Xm, Wog, Mm^Xm, Mm^Xm, Mm^Xm, Mm^Xm
Mm, Mm, Mm, Mm^Xm, Mm, Mm, Mm, Hhd, Hhd^Fdw, Hhd^Fdw, Hhd^Fdw, Gd^Fdw, Gd^Fdw, Gd, Gll^Fdw, Gs, Re, Re^Edt, Re^Edt, Gs^Edt, Hh, Hh, Hh, Hh, Ss, Mm, Mm, Mm, Wog, Mm, Wog, Wog, Mm^Xm, Mm^Xm, Mm, Mm, Mm, Mm^Xm, Wog^Xo, Wog, Mm^Xm, Mm^Xm, Mm^Xm, Mm^Xm
Mm, Mm, Mm, Mm, Mm, Mm, Hhd, Hhd, Hhd^Fdw, Hhd^Fdw, Hhd, Gd, Gd, Gd, Chr, Gs^Fdw, Gs, Re, Re, Re, Sm, Sm, Ss, Ss, Ss, Ss, Ss, Wog, Hh, Wog, Mm^Xm, Mm^Xm, Mm^Xm, Mm^Xm, Mm, Mm, Wog, Wog, Mm^Xm, Mm^Xm, Mm^Xm, Mm^Xm, Mm^Xm, Mm^Xm
Mm, Mm, Mm, Mm^Xm, Mm, Mm, Mm, Mm, Hhd, Hhd, Hhd, Hhd, Mm, Gs, Hh, Gd, Gs^Fdw, Re, Re, Re, Ss^Bw\r, Sm, Ss, Ss, Ss, Ss, Ss, Mm, Mm, Mm, Mm^Xm, Mm^Xm, Mm, Mm, Mm, Wog, Mm, Mm, Mm, Mm, Mm^Xm, Mm^Xm, Mm^Xm, Mm^Xm
Mm, Mm, Mm, Mm^Xm, Mm, Mm, Mm, Hhd, Hhd, Hhd, Mm, Mm, Mm, Hh, Gs^Fdw, Gs, Gd, Re, Ss^Bw\r, Ss, Ss, Ss^Bw\r, Ss^Bw\r, Ss, Sm, Sm, Chr, Mm, Mm, Mm, Mm, Mm, Hh, Mm, Hh, Wog, Mm, Mm, Mm, Mm, Mm, Mm, Mm^Xm, Mm^Xm
Mm^Xm, Mm, Mm, Mm^Xm, Mm^Xm, Mm, Mm, Mm, Mm, Mm, Mm, Mm, Mm, Hh, Hh, Gd, Ss, Ss, Ss, Ss^Bw\r, Ss^Bw\r, Ss, Gs, Re, Re, Gs, Gs, Mm, Hh, Hh, Hh, Hh, Hh, Mm, Hh, Wog, Wog, Mm, Mm, Mm, Mm, Mm^Xm, Mm^Xm, Mm^Xm
Mm^Xm, Mm^Xm, Mm, Mm, Mm, Mm, Mm, Mm, Mm, Hh, Hh, Mm, Mm, Hh, Sm, Hh, Ss, Ss, Ss, Ss, Ss, Ss^Bw\r, Re, Re, Re^Edt, Gs^Vct, Gs, Mm, Hh, Gs, Hh, Hh^Fdw, Hh^Fdw, Hh^Fdw, Sm, Hh, Wwg, Hh, Mm, Mm, Mm, Mm, Mm, Mm
Mm, Mm^Xm, Mm^Xm, Mm, Mm, Mm, Mm, Mm^Xm, Mm, Mm, Hh, Hh, Hh, Hh, Sm, Sm, Ss, Ss, Hh, Ss, Ss, Gs, Gs, Re, Re, Re, Re^Edt, Gs, Gs^Edt, Gs, Gs, Gd^Fdw, Gll^Fdw, Sm, Ss, Hh, Wwg, Hh, Hh, Mm, Mm, Mm, Hh, Mm
Mm, Mm^Xm, Mm^Xm, Mm^Xm, Mm, Mm, Mm^Xm, Mm^Xm, Mm, Mm, Mm, Hh, Mm, Hh, Hh, Sm, Hh, Hh, Sm, Ss, Hh, Hh^Fdw, Hh, Gs^Fdw, Gs^Fdw, Re, Ce, Re, Re^Edt, Gd^Vct, Gd, Gd^Fdw, Gd^Fdw, Gll^Fdw, Ss, Ss, Hh, Hh^Fdw, Hh^Fdw, Mm, Mm, Hh, Hh^Fdw, Hh
Mm, Mm^Xm, Mm^Xm, Mm, Mm^Xm, Mm^Xm, Mm, Mm^Xm, Mm^Xm, Mm, Mm, Mm, Mm, Hh, Hh, Hh, Hh, Mm, Sm, Sm, Sm, Hh, Hhd^Fdw, Hhd^Fdw, Gd^Fdw, Ce, 3 Ket, Ce, Re, Gs, Gs^Es, Gs^Es, Gg^Es, Ss, Chs, Ss, Hh, Hh, Hh, Hh, Hh, Hh, Hh, Hh
Mm, Mm, Mm^Xm, Mm^Xm, Mm, Mm^Xm, Mm, Mm^Xm, Mm^Xm, Mm, Mm, Mm, Hh, Hh, Hh, Hh, Mm, Mm^Xm, Mm, Chr, Sm, Hhd, Hhd, Hhd^Fdw, Gll^Fdw, Ce, Ce, Ce, Re, Re, Re, Gd^Es, Ss, Ss, Ss, Ss, Hh, Hh^Fdw, Hh, Hh^Fdw, Hh, Mm, Mm, Mm
Mm, Mm^Xm, Mm, Mm, Mm^Xm, Mm, Mm^Xm, Mm^Xm, Mm^Xm, Mm, Mm, Hh, Mm, Mm, Hh, Hh, Mm^Xm, Mm^Xm, Mm, Hhd, Hhd, Mm, Mm, Hhd, Gd^Fdw, Gll^Fdw, Gd^Fdw, Gs, Gs^Vct, Re^Edt, Re, Gs, Ss, Ss, Gs, Gs, Mm, Hh, Mm, Hh, Mm, Hh, Mm, Mm
Mm^Xm, Mm^Xm, Mm, Mm, Mm^Xm, Mm^Xm, Mm, Mm^Xm, Mm, Mm^Xm, Mm^Xm, Mm, Mm, Mm, Mm, Mm, Mm^Xm, Mm^Xm, Mm^Xm, Hhd, Mm, Hhd, Hhd, Hhd^Fdw, Gll^Fdw, Gd^Fdw, Hhd, Gd^Edt, Gs, Re^Edt, Re, Gs^Es, Gs, Ss, Gs, Hh, Mm, Mm, Mm, Mm, Mm, Mm, Mm, Mm
Mm^Xm, Mm^Xm, Mm, Mm, Mm^Xm, Mm^Xm, Mm, Mm, Mm^Xm, Mm^Xm, Mm^Xm, Mm^Xm, Mm^Xm, Mm, Mm^Xm, Mm^Xm, Mm^Xm, Mm, Mm, Mm, Mm, Mm, Mm, Hhd, Hhd^Fdw, Hhd, Mm, Hhd, Gd, Re, Re, Re, Gs^Es, Gg, Hh, Hh^Fdw, Mm, Mm, Mm, Mm, Mm, Mm, Mm, Mm
Mm^Xm, Mm, Mm^Xm, Mm, Mm^Xm, Mm^Xm, Mm, Mm, Mm, Mm, Mm^Xm, Mm^Xm, Mm^Xm, Mm^Xm, Mm^Xm, Mm^Xm, Mm^Xm, Mm^Xm, Mm, Mm, Mm, Mm, Hhd, Hhd, Mm, Mm, Mm, Hhd, Gs, Gs, Re, Re, Gd^Fdw, Gs, Hh, Hh^Fdw, Mm, Mm, Mm, Mm, Mm, Mm, Mm^Xm, Mm^Xm
Mm^Xm, Mm^Xm, Mm, Mm^Xm, Mm^Xm, Mm, Mm^Xm, Mm, Mm, Mm, Mm, Mm, Mm, Mm, Mm, Mm, Mm, Mm, Mm, Hhd, Co, Hhd, Hhd, Mm, Hhd, Mm, Gd^Fdw, Gs, Re^Efs, Re, Re, Re, Gd, Gs, Gs, Hh^Fdw, Hh, Mm, Mm, Mm, Mm^Xm, Mm^Xm, Mm^Xm, Mm^Xm
Mm^Xm, Mm^Xm, Mm^Xm, Mm, Mm^Xm, Mm, Mm^Xm, Mm, Mm, Mm, Mm, Mm, Hh, Mm, Mm, Mm, Hhd^Fdw, Hhd, Hhd^Fdw, Mm, Hhd, Co, Co, Hhd, Gd, Gd^Fdw, Gs, Re, Re, Re, Gs^Efs, Gs, Hhd, Gs, Hh, Hh, Mm, Mm, Mm, Mm^Xm, Mm^Xm, Mm^Xm, Mm^Xm, Mm^Xm
Mm, Mm^Xm, Mm^Xm, Mm, Mm^Xm, Mm^Xm, Mm^Xm, Mm^Xm, Mm^Xm, Mm, Mm, Hh, Hh^Fdw, Hh, Hh, Hh, Hhd^Fdw, Hhd, Hhd, Hhd, Hhd, Hhd, Gd, Co, Ko, Gd, Re^Efs, Re, Re, Re^Edt, Gd, Gs, Hhd, Mm, Mm, Mm, Mm, Mm, Mm, Mm, Mm, Mm, Mm^Xm, Mm^Xm
Mm, Mm, Mm^Xm, Mm^Xm, Mm^Xm, Mm^Xm, Mm^Xm, Mm, Mm, Mm, Hh, Hh, Hh, Hh, Hh, Hh^Vd, Hh, Hhd, Hhd, Hhd, Gs, Hhd, Gs, Gd, Re, Re, Re, Re, Gs^Efs, Gs^Fdw, Gd^Edt, Gs, Gs, Hhd, Mm, Mm, Mm, Mm, Mm, Mm, Mm^Xm, Mm^Xm, Mm^Xm, Mm
Mm, Mm, Mm^Xm, Mm^Xm, Mm^Xm, Mm, Mm^Xm, Mm, Mm, Mm, Hh, Hh, Mm, Mm, Hh, Hh^Fdw, Hh, Gs, Gs, Gs, Gd^Edt, Gs, Re^Efs, Re^Es, Re, Re, Re, Ko, Co, Gd, Gd, Gs, Hhd, Hhd^Fdw, Mm, Mm, Mm, Mm, Mm, Mm, Mm, Mm^Xm, Mm^Xm, Mm
Mm, Mm^Xm, Mm^Xm, Mm^Xm, Mm^Xm, Mm^Xm, Mm, Mm, Hhd, Mm, Hh, Hh, Hh, Hh, Chr, Khr, Chr, Chr, Ch, Gs, Re^Efs, Re, 2 Re, Re, Re, Re, Gs, Gd, Gs, Co, Co, Gs, Hhd^Fdw, Hhd, Hhd, Mm, Mm, Mm, Mm, Mm, Mm, Mm, Mm, Mm^Xm
Mm^Xm, Mm^Xm, Mm^Xm, Mm^Xm, Mm^Xm, Mm^Xm, Mm, Mm, Hhd, Hhd, Mm, Hh, Chr, Ch, Gs, Gs, Gs, Gs, Gd^Edt, Gd^Edt, Re, Re^Es, Re, Re, Gd, Gs^Efs, Gd^Fdw, Gs, Hh, Hh, Hh, Co, Hhd, Mm, Hhd, Hhd^Fdw, Mm, Mm, Mm, Mm, Mm, Mm, Mm, Mm^Xm
Mm^Xm, Mm^Xm, Mm^Xm, Mm, Mm^Xm, Mm^Xm, Mm, Hhd, Mm, Hhd, Mm, Chr, Gs, Re, Gd, Gs, Re^Vd, Gs, Re^Edt, Re^Edt, Re, Re, Gs, Gs^Efs, Gd, Gs^Fdw, Gll^Fdw, Gs, Hh^Fdw, Hh^Fdw, Hh, Hh, Mm, Mm, Mm, Hhd, Mm, Mm, Mm, Mm, Mm^Xm, Mm, Mm, Mm
Mm^Xm, Mm^Xm, Mm, Mm, Mm, Mm, Mm, Mm, Mm, Hhd, Hhd, Ch, Gd, Gs, Re, Gd^Efs, Re, Gd, Re, Re, Re, Re, Gs, Chr, Ch, Gs^Fdw, Gd^Fdw, Gs^Fdw, Hh^Vd, Hh^Fdw, Hh, Hh, Mm, Mm, Mm, Mm, Mm, Mm^Xm, Mm^Xm, Mm, Mm, Mm^Xm, Mm^Xm, Mm
Mm^Xm, Mm^Xm, Mm^Xm, Mm, Mm, Mm, Mm, Mm, Mm, Hhd, Hhd, Ch, Gs, Gd^Edt, Gd^Edt, Gs, Ch, Chr, Ch, Re, Re, Gd^Edt, Gd, Gs, Gs, Kh, Hh, Hh^Fdw, Hh^Fdw, Hh^Fdw, Hh, Mm, Hh, Mm, Mm, Mm, Mm, Mm, Mm^Xm, Mm^Xm, Mm^Xm, Mm, Mm^Xm, Mm
Mm^Xm, Mm^Xm, Mm^Xm, Mm, Mm, Mm, Mm, Mm, Hhd, Hhd^Fdw, Hhd, Ch, Kh, Re^Edt, Gd^Edt, Gd, Ch, 4 Kh, Chr, Re, Gd^Efs, Re^Vd, Re, Re, Ch, Ch, Mm, Hh, Hh, Hh, Hh, Hh, Mm, Mm, Mm, Mm, Mm^Xm, Mm, Mm^Xm, Mm^Xm, Mm^Xm, Mm^Xm, Mm^Xm, Mm^Xm
Mm^Xm, Mm^Xm, Mm^Xm, Mm, Mm, Mm, Mm, Mm, Mm, Mm, Hhd, Hhd, Chr, Re, Gs, Gs, Gd, Chr, Re, Gs, Gd, Gs, Gs^Edt, Chr, Mm, Mm, Hh, Hh, Hh, Hh, Hh, Hh, Mm, Mm, Mm, Mm^Xm, Mm^Xm, Mm, Mm^Xm, Mm^Xm, Mm^Xm, Mm^Xm, Mm, Mm
Mm^Xm, Mm^Xm, Mm^Xm, Mm^Xm, Mm^Xm, Mm, Mm, Mm, Mm, Hhd, Hhd, Hhd, Hhd, Chr, Chr, Gs^Edt, Gs, Gd, Re, Re, Gs^Edt, Re, Chr, Khr, Mm, Mm, Mm, Hh, Hh, Hh, Mm, Hh, Mm, Mm, Mm, Mm, Mm^Xm, Mm^Xm, Mm^Xm, Mm^Xm, Mm^Xm, Mm^Xm, Mm, Mm
Mm^Xm, Mm^Xm, Mm^Xm, Mm^Xm, Mm^Xm, Mm, Mm, Mm^Xm, Mm, Mm, Mm, Mm, Mm, Hhd^Fdw, Hhd, Ch, Ch, Gs, Chr, Re, Rd, Chr, Hhd, Hhd, Mm, Mm, Mm, Hh, Mm, Mm, Mm, Mm, Mm, Mm, Mm^Xm, Mm^Xm, Mm^Xm, Mm^Xm, Mm^Xm, Mm^Xm, Mm^Xm, Mm, Mm, Mm
Mm^Xm, Mm^Xm, Mm^Xm, Mm^Xm, Mm^Xm, Mm, Mm, Mm, Mm, Mm, Hhd, Mm, Hhd, Hhd, Hhd^Fdw, Hhd^Fdw, Hhd, Chr, Gd, Gd, Rd, Gd, Gd, Hhd, Mm, Mm, Mm, Mm, Mm, Mm, Mm, Mm, Mm, Mm^Xm, Mm^Xm, Mm^Xm, Mm^Xm, Mm^Xm, Mm, Mm, Mm, Mm^Xm, Mm, Mm
Mm^Xm, Mm^Xm, Mm^Xm, Mm^Xm, Mm^Xm, Mm^Xm, Mm, Mm, Hhd, Mm, Mm, Mm, Mm, Hhd^Fdw, Gd, Gd, Gd, Gd, Re, Rd, Gd^Fdw, Gd, Re, Hhd, Mm, Mm, Mm, Mm, Mm, Mm, Mm, Mm, Mm, Mm, Mm^Xm, Mm, Mm^Xm, Mm^Xm, Mm, Mm, Mm, Mm, Mm, Mm
Mm^Xm, Mm^Xm, Mm^Xm, Mm^Xm, Mm^Xm, Mm^Xm, Mm, Mm, Mm, Hhd, Hhd, Mm, Hhd, Gd^Fdw, Re, Gd^Fdw, Re^Fdw, Gd, Gd, Rd, Re^Fdw, Gd, Hhd, Mm, Mm, Mm, Mm, Mm, Hhd, Mm, Mm, Mm, Mm, Mm, Mm, Mm^Xm, Mm^Xm, Mm^Xm, Mm^Xm, Mm, Mm^Xm, Mm, Mm, Mm
Mm^Xm, Mm^Xm, Mm^Xm, Mm^Xm, Mm^Xm, Mm^Xm, Mm, Mm, Mm, Hhd, Mm, Hhd, Hhd, Hhd, Re, Gd, Gd, Re, Rd, Re, Rd, Gd, Hhd, Hhd, Mm, Mm, Mm, Hhd, Hhd, Mm, Mm, Mm, Mm^Xm, Mm, Mm^Xm, Mm^Xm, Mm^Xm, Mm^Xm, Mm, Mm^Xm, Mm, Mm^Xm, Mm, Mm
Mm^Xm, Mm^Xm, Mm^Xm, Mm^Xm, Mm^Xm, Mm^Xm, Mm, Mm, Mm, Mm, Mm, Hhd^Fdw, Hhd, Hhd, Gd, Hhd, Re, Re^Fdw, Gd, Gd, Rd, Gd, Gd, Mm, Mm, Mm, Hhd, Hhd, Mm, Mm, Mm, Mm, Mm, Mm^Xm, Mm^Xm, Mm^Xm, Mm^Xm, Mm^Xm, Mm^Xm, Mm^Xm, Mm, Mm, Mm, Mm
Mm^Xm, Mm^Xm, Mm^Xm, Mm^Xm, Mm^Xm, Mm^Xm, Mm^Xm, Mm, Mm^Xm, Mm, Mm, Mm, Mm, Hhd, Hhd, Re, Re, Rd, Gd, Rd, Rd, Gd, Hhd, Hhd, Hhd, Hhd, Hhd^Fdw, Mm, Mm, Mm, Mm, Mm, Mm, Mm, Mm^Xm, Mm, Mm, Mm^Xm, Mm^Xm, Mm^Xm, Mm^Xm, Mm, Mm, Mm
Mm^Xm, Mm^Xm, Mm^Xm, Mm^Xm, Mm, Mm^Xm, Mm^Xm, Mm^Xm, Mm, Mm, Gd, Hhd, Mm, Gd, Gd, Gd, Gd, Re, Rd, Rd, Gd, Gd, Gs, Hhd, Mm, Hhd, Mm, Mm, Mm, Mm, Mm, Mm, Mm, Mm, Mm, Mm^Xm, Mm^Xm, Mm, Mm, Mm^Xm, Mm^Xm, Mm^Xm, Mm, Mm
