Md^Xm, Md^Xm, Md^Xm, Md^Xm, Md, Md^Xm, Md^Xm, Md^Xm, Md, Md, Md, Dd, Rd, Rd, Dd, Hhd, Hhd, Hhd, Hhd, Hhd, Md^Xm, Md^Xm, Md^Xm, Md^Xm, Md^Xm, Md, Hhd, Md, Hhd, Hhd, Md, Hhd, Md^Xm, Md^Xm, Md^Xm, Md, Md, Md, Md, Md, Md^Xm, Md^Xm, Md^Xm, Md, Md, Md, Md^Xm, Hhd, Md^Xm, Md^Xm, Md^Xm, Md^Xm, Md^Xm, Md^Xm, Md^Xm, Md^Xm, Md^Xm, Md^Xm
Md^Xm, Md^Xm, Md, Md^Xm, Md, Md^Xm, Md^Xm, Md^Xm, Md, Md, Hhd, Dd, Dd, Rd, Ds^Esd, Dd, Dd^Esd, Hhd, Hhd, Md, Md, Md^Xm, Md^Xm, Md, Md, Md, Md, Hhd, Hhd, Hhd, Hhd, Md, Md, Md^Xm, Md, Md, Md, Hhd, Md, Md, Md, Md^Xm, Md, Md, Hhd, Md, Md, Md^Xm, Md^Xm, Md, Md, Md^Xm, Md, Md, Md, Md^Xm, Mv, Md^Xm
Md, Md, Md, Md, Mv, Md, Md, Md, Md^Xm, Md, Hhd, Dd, Ds^Esd, Rd^Esd, Rd, Ds^Esd, Dd, Dd, Hhd, Hhd, Hhd, Md, Md, Md, Md, Md, Md, Md, Hhd, Hhd, Cte, Hhd, Hhd, Md, Hhd, Hhd, Md, Hhd, Hhd, Hhd, Md, Md, Hhd, Hhd, Hhd, Hhd, Md, Md, Md, Md, Hhd, Md, Hhd, Qlf, Qlf, Md, Md, Md
Md^Xm, Md, Md, Md, Md, Md, Hhd, Md, Md, Md, Dd, Ds, Ds, Rd^Esd, Rd, Dd, Ce, Dd, Dd, Hhd, Dd, Md, Md, Md, Md, Hhd, Hhd, Hhd, Hhd, Hhd, Hhd, Hhd, Hhd, Md, Hhd, Hhd, Hhd, Hhd, Hhd, Hhd, Hhd, Md, Hhd, Hhd, Hhd, Hhd, Hhd, Md, Hhd, Hhd, Hhd, Hhd, Qlf, Qlf, Md^Xm, Hhd, Hhd, Md
Md, Md, Md, Md, Qlf, Qlf, Hhd, Qlf, Md, Md, Md, Hhd, Hd, Ds^Vct, Dd, Ce, 1 Ke, Ce, Dd, Dd, Hhd, Hhd, Md, Md, Hhd, Hd, Dd, Hhd, Hhd, Hhd, Dd, Hd, Hhd, Dd, Hd, Hd, Hhd, Hhd, Hhd, Hd, Cte, Hhd, Dd, Hhd, Hhd, Hhd, Hd, Hhd, Hhd, Hhd, Hhd, Md, Md, Md^Xm, Md, Md, Md, Md
Hhd, Hhd, Md, Md, Md, Md, Hhd, Md, Md, Md, Hhd, Hhd, Hhd, Dd, Dd, Ce, Ce, Ce, Rd^Esd, Dd, Dd, Md, Md, Md, Hhd, Dd, Hhd, Hhd, Hhd, Hd, Dd, Hd, Hd, Dd, Dd, Hd, Dd, Hhd, Hd, Hd, Dd, Dd, Hd, Hd, Hhd, Hhd, Hd, Dd, Cte, Hd, Md, Md, Md, Md, Hhd, Hhd, Md, Md
Hhd, Hhd, Hd, Md, Hhd, Md, Hhd, Hhd, Md, Md, Hhd, Dd, Dd, Hd, Dd^Vct, Dd, Ds, Rd, Rd, Dd^Vct, Dd, Md, Hd, Hhd, Dd, Dd, Hd, Hd, Dd, Hd, Dd, Dd, Hd, Dd, Dd^Dc, Dd, Dd, Hd, Dd, Hd, Dd, Dd, Hd, Hhd, Hhd, Dd, Dd, Dd, Hd, Hd, Hhd, Hhd, Hd, Hhd, Hd, Hd, Md, Hhd
Hhd, Hd, Dd, Hd, Hd, Hd, Dd, Hhd, Md, Hhd, Hhd, Hhd, Dd, Dd, Dd, Ds, Dd, Ds^Esd, Rd^Esd, Rd, Ds, Dd, Hd, Hd, Dd, Dd, Dd, Ds, Yhs, Tb^Tf, Tb^Tf, Dd, Dd, Dd, Hd, Dd, Ds, Ds, Ds, Dd, Dd, Hd, Dd, Dd, Dd, Dd, Hhd, Dd, Hd, Hhd, Dd, Dd, Hd, Hd, Dd, Hd, Hhd, Hhd
Hd, Hd, Dd, Dd, Hd, Dd, Hd, Hhd, Md, Md, Md, Hhd, Hd, Hhd, Hd, Hd, Dd, Dd, Re^Esd, Rd^Esd, Dd, Dd, Dd, Dd^Dr, Dd, Hd, Ds, Yhs, Yhs^Xp, Uu^Tf, Tb^Tf, Dd, Dd, Dd, Dd, Dd, Qxv, Re^Esd, Rd, Uzw, Yhs, Dd, Dd, Dd, Hd, Hhd, Hhd, Dd, Dd, Dd, Dd, Dd, Dd, Dd, Hd, Hd, Dd, Hd
Dd, Dd, Dd^Dc, Dd, Dd, Hd, Hd, Hhd, Hhd, Md, Hd, Hd, Hd, Hd, Dd, Hd, Dd, Dd, Uzw, Rd, Re^Esd, Ds, Ds, Dd, Dd, Dd, Dd, Ds, Ds, Uzw, Uzw, Re, Re, Dd, Uzw, Qxv, Qxv, Re, Tb^Tf, Uzw, Yhs^Xp, Yhs^Xp, Dd, Hd, Dd, Hd, Dd, Dd, Dd, Dd^Dc, Dd, Dd, Dd, Dd, Hd, Hd, Dd, Dd
Hd, Dd, Hd, Dd, Dd, Hd, Dd, Hd, Hd, Hhd, Dd, Hd, Dd, Dd, Dd, Dd, Dd, Re, Uzw, Uzw, Yhs, Yhs, Yhs^Xp, Yhs, Dd^Dr, Dd^Edt, Rd^Edt, Ds, Re, Uzw, Ds, Re^Esd, Ds^Esd, Dd, Uzw, Qxv, Re, Tb^Tf, Tb^Tf, Yhs, Ds, Ds, Dd, Dd, Re^Esd, Dd, Dd, Dd, Dd, Dd, Yhs, Re^Esd, Re, Ds, Ds, Dd, Dd, Dd
Qxv, Qxv, Tb^Tf, Tb^Tf, Ds, Dd, Dd, Dd, Dd, Dd, Dd, Dd, Hd, Dd, Rd, Dd, Ds, Re, Tb^Tf, Qxv, Qxv, Yhs, Rd, Rd^Edt, Dd^Dr, Dd^Edt, Rd^Tf, Tb^Tf, Re^Tf, Dd, Dd, Ds, Dd, Dd, Rd, Yhs^Xp, Yhs, Re, Dd, Dd, Ds, Ds, Dd, Re, Tb^Tf, Uzw, Qxv, Dd, Ds, Ds, Uzw, Yhs^Xp, Re^Tf, Tb^Tf, Dd, Dd, Ds, Dd
Qxv, Uh, Uh, Yhs, Ds, Dd, Hd, Dd, Dd, Re, Re^Edt, Hd, Ds, Dd, Re, Yhs, Yhs, Tb^Tf, Re^Tf, Qxv, Qxv, Ds, Dd, Re^Edt, Dd^Edt, Rd, Uzw, Tb^Tf, Uzw, Uzw, Dd, Dd, Dd, Dd, Dd, Re^Esd, Dd, Cte, Dd, Dd, Dd^Dc, Dd, Dd, Tb^Tf, Uh, Uzw^&A, Qxv, Qxv, Ds, Uzw, Uzw, Yhs^Xp, Yhs, Tb^Tf, Dd, Dd, Re^Tf, Ds
Qxv, Qxv, Hd, Dd, Re, Tb^Tf, Hd, Hd, Dd, Uzw, Uzw^Edt, Dd^Edt, Ds, Ds, Dd, Yhs^Xp, Qxv, Tb^Tf, Re, Dd, Dd, Dd, Dd, Dd, Re, Yhs, Yhs^Xp, Uzw, Yhs, Qxv, Qxv, Dd, Dd, Dd, Ds, Dd, Tb^Tf, Dd, Dd, Dd, Dd, Dd, Dd, Uu^Tf, Re, Uzw, Qxv, Qxv, Dd, Dd, Uu^Tf, Tb^Tf, Qxv, Qxv, Qxv, Qxv, Tb^Tf, Re^Tf
Dd, Hd, Dd, Dd, Dd, Tb^Tf, Hd, Dd, Ds, Uzw, Uzw, Yhs^Xp, Yhs, Ds, Dd, Qxv, Qxv, Qxv, Rd, Dd, Dd, Dd, Rd^Es, Dd, Re, Re, Qxv, Yhs, Qxv, Qxv, Re, Re, Tb^Tf, Ds, Ds, Uu^Tf, Tb^Tf, Uh, Qxv, Dd, Dd, Dd, Hd, Dd, Yhs, Re^Esd, Ds, Dd, Dd, Dd, Ds, Tb^Tf, Dd, Dd, Dd, Qxv, Yhs, Yhs
Dd, Dd, Dd, Dd, Dd, Dd, Dd, Dd, Ds, Qxv, Tb^Tf, Tb^Tf, Yhs, Ds, Dd, Qxv, Dd, Re^Es, Rd, Rd, Dd, Rd, Rd, Dd, Dd, Re, Qxv, Qxv, Qxv, Qxv, Dd^Edt, Re^Edt, Re^Tf, Re^Tf, Yhs^Xp, Uzw, Uzw^&A, Uzw, Qxv, Qxv, Dd, Hd, Hd, Dd, Dd, Yhs, Ds, Dd, Hd, Ds, Dd, Dd, Hd, Hd, Dd, Dd, Dd, Yhs
Qxv, Ds, Tb^Tf, Re^Edt, Dd^Edt, Hd, Hd, Dd, Dd, Qxv, Qxv, Tb^Tf, Re^Es, Cte, Dd, Dd, Dd, Dd, Dd, Rd^Es, Dd, Rd, Yhs^Xp, Yhs, Dd, Dd, Dd, Qxv, Dd, Dd, Rd, Rd^Edt, Dd, Yhs, Yhs, Yhs, Uh, Uzw, Dd, Qxv, Dd, Hd, Dd, Dd, Ds^Dr, Dd, Dd, Dd, Hd, Hd, Dd, Dd, Ds, Dd, Dd, Dd, Qxv, Qxv
Yhs, Yhs, Re, Re^Edt, Dd, Dd, Dd, Dd, Dd, Dd, Dd, Qxv, Re, Dd, Dd, Dd, Re^Esd, Rd, Rd^Esd, Dd, Re, Yhs, Yhs, Uzw, Uzw, Dd, Dd, Dd, Dd, Dd, Rd, Rd^Edt, Ds, Yhs^Xp, Yhs, Cte, Cte, Dd, Dd, Dd, Dd, Dd, Dd, Ds, Dd, Dd^Dr, Dd, Dd, Dd, Dd, Dd, Ds, Ds, Dd, Dd, Dd, Dd, Qxv
Ds, Yhs^Xp, Re, Ds, Qxv, Dd, Dd, Dd, Dd, Dd, Dd, Dd, Dd, Dd, Uzw, Dd, Yhs^Xp, Re, Rd, Rd, Re, Re, Uzw, Uzw, Dd, Dd, Dd, Dd, Dd, Dd, Dd, Dd, Dd, Ds, Ds, Cte, Dd, Ds, Ds, Dd, Tb^Tf, Dd, Ds, Dd, Hd, Dd, Dd^Dr, Uzw, Uzw, Qxv, Qxv, Dd, Dd, Dd, Hd, Hd, Qxv, Qxv
Dd, Re, Dd, Qxv, Qxv, Yhs^Xp, Yhs, Rd, Rd^Esd, Dd, Dd, Dd, Dd, Ds, Uzw, Yhs, Uzw, Yhs, Tb^Tf, Re^Tf, Re^Esd, Cte, Uzw, Uzw, Re, Dd, Rd^Esd, Re, Ds, Hd, Dd, Dd^Dc, Dd, Re, Re, Dd, Dd, Ds, Yhs^Yva, Yhs, Uu^Tf, Tb^Tf, Ds, Dd, Hd, Ds, Ds, Uzw, Yhs^Xp, Uzw^&A, Dd, Dd, Dd, Dd, Dd, Hd, Qxv, Qxv
Dd, Dd, Hd, Qxv, Qxv, Yhs^&A, Yhs^Xp, Rd, Rd, Cte, Yhs, Hd, Hd, Ds, Uzw, Uzw, Uzw, Uzw^&A, Qxv, Uu^Tf, Tb^Tf, Dd, Re, Re, Hd, Ds, Re^Esd, Dd, Dd, Hd, Dd, Dd, Dd, Rd^Esd, Re^Esd, Dd, Uzw, Uzw, Yhs, Yhs^Xp, Qxv, Qxv, Ds, Dd, Dd, Ds, Ds, Yhs, Yhs^Yva, Uu^Tf, Dd, Hd, Hd, Dd, Dd, Dd, Dd, Dd
Dd, Dd, Hd, Hd, Uzw, Uzw, Tb^Tf, Ds, Dd, Yhs^Xp, Yhs^Edt, Hd, Ds, Ds^Dr, Dd^Dr, Yhs, Ds, Qxv, Qxv, Uu^Tf, Yhs, Dd, Dd, Hd, Dd, Ds, Ds, Re, Yhs^Xp, Tb^Tf, Tb^Tf, Rd, Dd, Dd^Esd, Rd^Esd, Dd, Uzw, Uh, Qxv, Yhs^&A, Qxv, Qxv, Dd, Dd, Dd, Qxv, Qxv, Dd, Dd, Yhs^Yva, Ds, Hd, Dd, Dd, Dd, Dd, Yhs^Xp, Dd
Ds, Dd, Dd, Hd, Dd, Uzw, Tb^Tf, Ds, Dd, Dd^Edt, Dd^Edt, Dd^Edt, Dd, Ds^Dr, Dd^Dc, Dd, Dd, Qxv, Dd, Dd, Tb^Tf, Dd, Dd, Dd, Uu^Tf, Dd, Hd, Ds, Re^Esd, Yhs, Rd, Dd, Ds, Dd, Dd, Dd, Dd, Tb^Tf, Qxv, Qxv, Dd, Dd, Dd, Dd, Uu^Tf, Qxv, Yhs, Ds, Ds, Dd, Ds, Dd, Dd, Re^Tf, Re, Uu^Tf, Uu^Tf, Yhs^Yva
Yhs, Qxv, Dd, Dd, Dd, Re^Esd, Re^Esd, Dd, Dd, Dd, Dd^Edt, Dd^Edt, Dd, Dd, Dd, Dd, Dd, Dd, Ds, Ds, Dd, Dd, Dd, Tb^Tf, Qxv, Qxv, Hd, Ds, Ds, Yhs^Xp, Rd^Dr, Rd, Ds, Dd, Hd, Dd, Dd, Dd, Dd, Dd, Ds, Dd, Dd, Dd, Uu^Tf, Uzw, Yhs^Xp, Yhs^Vyv, Ds, Dd, Ds, Ds, Yhs^Xp, Re, Uzw, Re, Uu^Tf, Yhs
Yhs^Xp, Yhs, Hd, Hd, Dd, Tb^Tf, Dd, Dd, Hd, Hd, Yhs, Dd, Qxv, Qxv, Ds, Ds, Ds, Dd, Yhs, Yhs, Dd, Dd, Hd, Uh, Qxv, Qxv, Dd, Hd, Ds, Re, Ds^Dr, Rd, Tb^Tf, Dd, Dd, Hd, Dd, Re, Re^Esd, Dd, Ds, Ds, Ds, Dd, Dd, Uzw, Yhs, Yhs^Xp, Dd, Dd, Dd, Yhs, Yhs^&A, Tb^Tf, Uzw, Uzw, Dd, Dd
Tb^Tf, Dd, Dd, Hd, Dd, Dd, Ds, Hd, Hd, Hd, Tb^Tf, Yhs^Xp, Qxv, Qxv, Ds^Dr, Yhs, Ds, Ds, Yhs, Yhs^Xp, Ds, Hd, Ds, Hd, Ds, Ds, Yhs, Ds, Ds^Dr, Ds, Yhs^Xp, Re, Re^Tf, Dd, Dd, Hd, Dd, Rd, Rd^Esd, Rd, Uzw, Ds, Hd, Hd, Hd, Dd, Hd, Dd, Hd, Dd, Dd^Dc, Dd, Dd, Uzw, Yhs^Xp, Uzw, Re^Tf, Dd
Hd, Dd, Hd, Dd, Ds, Ds, Ds, Dd, Dd, Yhs, Uzw, Uzw, Ds, Qxv, Dd, Ds^Dr, Dd, Ds, Dd, Dd, Ds, Ds, Ds, Hd, Dd, Yhs^Xp, Dd, Ds, Ds^Dr, Yhs^Dr, Re^&A, Re, Tb^Tf, Dd, Ds, Dd, Ds, Dd, Ds, Uzw, Uzw, Dd, Uzw, Yhs^Xp, Re^Es, Hd, Hd, Hd, Hd, Dd, Dd, Dd, Dd, Yhs, Yhs, Yhs, Qxv, Qxv
Hd, Hd, Dd, Hd, Dd, Yhs^Edt, Dd^Edt, Dd, Uh, Tb^Tf, Uzw, Yhs, Ds^Dr, Dd, Dd, Ds, Dd, Dd, Hd, Hd, Dd^Esd, Ds, Re, Ds, Rd, Rd, Uzw, Dd, Ds, Yhs, Re, Tb^Tf, Ds, Ds, Hd, Hd, Hd, Hd, Dd, Yhs^Xp, Yhs, Cte, Uzw, Re^Es, Re^Tf, Yhs, Uh^Dr, Dd, Yhs^Xp, Dd, Qxv, Dd, Dd, Yhs^Xp, Yhs, Uh^Dr, Qxv, Qxv
Hd, Hd, Dd, Dd, Dd, Ds^Edt, Dd, Dd, Dd, Uzw, Dd, Dd, Ds, Ds, Hd, Dd, Hd, Hd, Uzw, Rd, Rd, Re, Ds, Ds, Yhs, Yhs^Xp, Dd, Uzw, Re, Ds, Ds, Ds, Ds, Ds, Uzw, Uzw, Dd, Uzw, Uzw, Yhs, Yhs^Xp, Yhs, Uzw, Uzw, Tb^Tf, Re^Tf, Yhs, Yhs, Yhs, Qxv, Qxv, Qxv, Dd, Dd, Dd, Uh, Tb^Tf, Tb^Tf
Dd, Dd, Dd, Dd, Yhs, Ds, Ds, Dd, Hd, Dd, Dd^Dc, Dd, Dd, Dd, Hd, Hd, Cte, Cte, Uzw, Uzw, Rd^Es, Re, Re, Re, Rd, Yhs, Yhs^Xp, Re, Rd, Rd, Dd, Dd^Dc, Uzw, Uzw, Uzw, Uzw, Yhs, Yhs^Xp, Uzw, Uzw, Yhs, Yhs^Yva, Dd, Dd, Tb^Tf, Uh, Yhs^Xp, Yhs^Vyv, Ds, Yhs^&A, Uzw, Qxv, Qxv, Dd, Dd, Re^Tf, Re^Tf, Tb^Tf
Qxv, Dd, Dd, Dd, Yhs^Xp, Cte, Cte, Dd, Dd, Dd, Dd, Dd, Dd, Dd, Dd, Hd, Hd, Cte, Rd, Rd, Hd, Yhs^Xp, Re, Dd, Dd, Rd, Rd, Rd, Dd, Hd, Dd, Uzw, Uh, Dd, Dd, Dd, Uh, Yhs, Yhs^Yva, Uzw, Dd, Yhs, Dd, Dd, Dd, Uu^Tf, Ds, Yhs, Ds, Yhs^Xp, Yhs, Uzw, Qxv, Dd, Dd, Dd, Re, Re
Hd, Dd, Dd, Dd, Yhs^&A, Yhs^Xp, Uzw, Ds, Qxv, Dd, Qxv, Dd, Dd, Dd, Uzw, Rd, Rd, Yhs^Xp, Yhs^&A, Rd, Hd, Dd, Ds, Dd, Rd^Esd, Re, Rd, Re, Dd, Uzw, Dd, Dd, Dd, Dd, Dd, Uh^Dr, Uh, Yhs^&A, Uzw, Dd, Dd, Dd, Dd, Dd, Uzw, Dd, Dd, Ds, Dd, Uzw, Yhs^Xp, Yhs, Dd, Dd, Dd, Re, Re, Re
Hd, Hd, Dd, Qxv, Qxv, Yhs, Uzw, Uzw, Uzw^&A, Qxv, Qxv, Dd, Dd, Dd, Qxv, Uzw, Rd, Yhs, Yhs^Xp, Hd, Hd, Uzw, Uzw, Ds, Rd, Rd, Rd, Re, Uzw, Uzw, Yhs^Vyv, Yhs^Xp, Dd, Dd, Ds, Uh, Uzw, Uzw, Yhs, Dd, Qxv, Qxv, Dd, Uzw, Uzw, Uzw, Dd, Dd, Hd, Uzw, Yhs, Hd, Hd, Dd, Dd, Dd, Dd, Dd
Hd, Hd, Dd, Dd, Qxv, Tb^Tf, Tb^Tf, Uzw, Uzw, Qxv, Qxv, Dd, Dd, Dd, Ds, Uzw, Dd, Dd, Ds, Hd, Hd, Hd^Dr, Dd, Uzw, Re, Ds^Dr, Uzw^Dr, Uzw, Dd, Yhs, Uzw, Dd, Dd, Ds, Dd, Ds, Qxv, Qxv, Yhs, Yhs^Xp, Qxv, Qxv, Uu^Tf, Dd, Dd, Uzw, Dd, Dd^Dc, Dd, Hd, Hd, Hd, Dd, Dd, Dd, Ds, Dd, Dd
Dd, Dd, Dd, Dd, Dd, Uu^Tf, Tb^Tf, Rd, Rd, Rd, Ds, Dd, Dd, Dd, Ds, Ds^Esd, Dd, Dd, Dd, Ds, Ds, Dd, Dd, Uzw, Re, Ds^Dr, Yhs^Xp, Uzw, Yhs, Yhs^Xp, Uzw, Uzw, Re, Uzw, Tb^Tf, Tb^Tf, Dd, Qxv, Rd, Dd, Qxv, Qxv, Dd, Dd, Dd^Esd, Dd, Dd, Ds, Ds, Hd, Hd, Dd, Ds, Dd, Dd^Dc, Dd, Dd, Dd
Dd, Dd, Yhs, Ds, Ds, Dd, Dd, Rd, Hd, Ds, Qxv, Ds^Esd, Yhs^Vyv, Dd, Dd, Dd, Dd, Dd, Uzw, Ds, Dd, Dd^Dc, Dd, Uzw, Uzw, Yhs, Yhs, Yhs, Dd, Dd, Dd, Dd, Dd, Uzw^Vyf, Uh, Tb^Tf, Dd, Rd, Qxv, Qxv, Dd, Qxv, Dd, Dd, Dd, Dd, Rd, Rd, Ds, Dd, Ds, Dd, Dd, Dd, Dd, Dd, Qxv, Dd
Uzw, Uzw, Uzw, Yhs^Xp, Ds, Dd, Dd, Dd, Hd, Hd, Qxv, Qxv, Tb^Tf, Yhs^Yva, Cte, Dd, Uzw, Uzw, Dd, Dd, Qxv, Dd, Re^Tf, Dd, Dd, Dd, Uzw, Uzw, Re^Edt, Dd, Dd, Dd, Dd, Dd, Dd, Dd, Rd^Edt, Rd, Rd, Dd, Dd, Dd, Dd, Dd, Tb^Tf, Uu^Tf, Qxv, Uzw, Ds, Re, Tb^Tf, Ds, Uzw, Uzw, Uzw, Qxv, Qxv, Dd
Qxv, Uzw, Uzw^&A, Yhs^Yva, Dd, Ds, Dd, Hd, Dd, Dd, Dd, Yhs, Ds, Dd, Dd, Dd, Uzw, Uzw, Yhs^Xp, Qxv, Qxv, Uu^Tf, Tb^Tf, Re^Tf, Dd, Dd, Uzw, Uzw^Edt, Re^Edt, Rd, Dd, Yhs, Qxv, Uu^Tf, Re^Tf, Dd, Dd^Edt, Rd^Edt, Dd, Dd^Es, Cte, Dd, Uzw, Re^Tf, Tb^Tf, Qxv, Qxv, Yhs^&A, Ds, Re^Tf, Ds, Uzw, Re^Tf, Uzw, Uzw, Dd, Dd, Dd
Dd, Tb^Tf, Tb^Tf, Qxv, Dd, Dd, Dd, Dd, Yhs, Ds, Dd, Dd, Dd, Dd, Uzw, Uzw, Uzw, Yhs^Yva, Yhs, Qxv, Qxv, Yhs, Tb^Tf, Tb^Tf, Dd, Uzw, Dd, Dd^Edt, Dd, Dd, Yhs^&A, Yhs^Xp, Qxv, Tb^Tf, Tb^Tf, Hd, Hd, Dd, Hd, Cte, Cte, Dd, Uzw, Re^Tf, Re^Tf, Qxv, Yhs, Yhs^Xp, Yhs^Vyv, Ds, Dd, Uzw, Tb^Tf, Uzw, Yhs^Xp, Uzw, Re^Tf, Dd
Dd, Tb^Tf, Qxv, Qxv, Dd, Uzw, Uzw, Yhs^Xp, Yhs, Ds, Ds, Dd, Dd, Dd, Uzw, Uzw, Ds, Yhs, Qxv, Qxv, Yhs, Cte, Cte, Cte, Dd, Dd, Hd^Esd, Hd, Dd, Dd, Qxv, Yhs, Qxv, Qxv, Tb^Tf, Re^Tf, Hd, Dd, Qxv, Qxv, Dd, Dd, Uzw, Uzw, Ds, Uzw, Uzw, Yhs^Vyv, Yhs^Xp, Dd, Yhs^Xp, Re^Tf, Tb^Tf, Re^Tf, Uzw, Tb^Tf, Yhs, Re^Tf
Dd, Dd, Dd, Dd, Ds, Uzw, Uzw, Uzw, Yhs^&A, Yhs^Xp, Tb^Tf, Ds, Dd, Dd, Ds, Dd, Hd, Dd, Ds, Qxv, Dd, Cte, Ds, Ds, Rd, Rd, Hd, Dd, Qxv, Qxv, Qxv, Qxv, Qxv, Qxv, Re^Tf, Uzw, Uzw, Qxv, Re, Re, Ds^Esd, Rd, Rd^Es, Uzw, Dd, Dd, Uzw, Uzw, Cte, Cte, Yhs^Xp, Uu^Tf, Yhs^Xp, Uu^Tf, Qxv, Uzw, Yhs^&A, Yhs
Dd, Dd, Hd, Dd, Dd, Uzw, Uzw, Uzw, Qxv, Tb^Tf, Qxv, Tb^Tf, Dd, Dd, Yhs, Dd, Hd, Hd, Ds, Ds, Dd, Uzw, Uzw, Dd, Re, Rd, Dd, Dd, Qxv, Qxv, Yhs^Xp, Yhs, Qxv, Qxv, Qxv, Uzw, Qxv, Qxv, Re^Tf, Uzw, Ds, Dd, Rd, Rd, Dd, Dd, Dd, Uzw, Uzw, Cte, Rd, Yhs^Yva, Yhs, Qxv, Qxv, Dd, Dd, Yhs
Dd, Dd, Dd, Dd, Dd, Dd, Ds, Ds, Qxv, Qxv, Dd, Dd, Dd, Yhs, Ds, Dd, Hd, Hd, Hd^Dr, Dd, Qxv, Uzw, Uzw, Uzw, Re, Re, Qxv, Qxv, Qxv, Yhs^&A, Yhs^Vyv, Yhs^Yva, Yhs^Vyv, Qxv, Dd, Qxv, Hd, Dd, Ds, Ds, Ds, Dd, Qxv, Qxv, Ds, Ds, Ds, Dd, Dd, Dd, Uzw, Uzw, Dd, Yhs^Xp, Dd, Dd, Dd^Dc, Dd
Dd, Dd, Hd, Hd, Dd, Dd, Dd, Dd, Dd, Dd, Dd, Dd, Re^Es, Uzw, Dd, Ds, Dd, Hd, Dd, Dd, Qxv, Yhs^&A, Yhs^Xp, Yhs^Yva, Re, Rd, Yhs^&A, Qxv, Dd, Ds, Uzw, Re, Re, Qxv, Dd, Hd, Hd, Dd, Ds, Ds, Re^Tf, Yhs^Yva, Yhs, Qxv, Yhs^Yva, Uzw, Uzw, Dd, Dd, Hd, Dd, Uzw, Rd^Es, Rd, Uzw, Dd, Dd, Dd
Dd, Hd, Hd, Qxv, Dd, Tb^Tf, Yhs^&A, Cte, Cte, Hd, Hd, Re^Es, Re, Dd, Dd, Uzw, Uzw, Dd, Uzw, Dd, Qxv, Qxv, Yhs, Yhs, Uzw^Vyf, Re, Yhs, Yhs, Re, Uzw, Uzw, Re, Yhs^Edt, Yhs^Edt, Dd^Edt, Dd^Edt, Ds^Edt, Ds, Yhs, Ds, Re^Tf, Yhs^Xp, Yhs, Qxv, Yhs, Yhs^Xp, Re^Tf, Uzw, Hd, Hd, Dd, Uzw, Rd, Uzw, Uzw, Qxv, Qxv, Dd
Dd, Dd, Dd, Dd, Dd, Yhs, Yhs^Vyv, Cte, Hd^Dr, Hd, Dd, Dd, Dd, Hd, Hd, Hd, Uzw, Uzw, Uzw, Dd, Dd^Edt, Dd, Dd, Hd, Dd, Uzw, Qxv, Cte, Cte^Edt, Uzw^Edt, Uzw, Uzw, Ds, Ds^Dr, Rd^Edt, Dd, Ds, Yhs, Cte, Cte, Cte, Re^Tf, Yhs, Yhs^Yva, Yhs^Xp, Re^Tf, Dd, Hd, Dd, Hd, Hd, Rd^Edt, Dd^Edt, Rd, Dd, Qxv, Qxv, Qxv
Dd, Dd, Tb^Tf, Dd, Uzw, Dd, Dd, Dd, Dd^Edt, Dd^Dr, Dd^Edt, Dd, Dd, Dd, Dd, Hd, Re^Tf, Uu^Tf, Tb^Tf, Uzw^Edt, Uzw^Edt, Dd^Edt, Dd, Dd, Dd, Dd, Qxv, Cte, Dd, Dd^Edt, Dd, Dd^Esd, Dd, Dd^Dr, Rd, Rd, Ds, Cte, 3 Kte, Cte, Qxv, Yhs, Yhs^Yva, Yhs^Vyv, Uzw, Uzw^Vyf, Dd^Dr, Hd, Dd, Dd, Hd, Rd^Edt, Uzw^Edt, Dd, Dd, Uzw, Qxv, Qxv
Dd, Uzw, Uzw, Uzw, Yhs, Tb^Tf, Ds, Dd, Re^Edt, Re^Edt, Uzw^Edt, Yhs, Yhs^Xp, Dd, Dd, Dd, Uu^Tf, Tb^Tf, Yhs^&A, Re^Tf, Dd^Edt, Dd^Edt, Dd^Dc, Dd, Qxv, Qxv, Qxv, Hd, Hd^Dr, Dd, Ds, Dd, Uzw, Qxv, Qxv, Dd, Dd, Cte, Cte, Qxv, Cte, Yhs, Yhs^Yva, Uzw^Vyf, Uzw^Edt, Dd^Dr, Dd^Dr, Dd, Uzw, Hd, Dd, Hd, Dd, Cte, Cte, Dd, Dd, Dd
Qxv, Qxv, Uzw, Tb^Tf, Yhs, Yhs^Xp, Re^Esd, Ds, Dd^Edt, Uzw^Edt, Uzw, Yhs^Yva, Dd, Dd, Dd, Dd, Qxv, Yhs, Yhs^Xp, Ds, Dd, Dd, Dd, Dd, Dd, Qxv, Qxv, Qxv, Hd, Hd, Yhs, Ds, Ds, Qxv, Uzw, Dd, Dd, Hd, Dd, Qxv, Yhs, Yhs, Uzw^Vyf, Uzw^Edt, Dd^Edt, Dd^Dr, Uzw, Uzw, Yhs^Vyv, Uzw, Dd, Dd, Dd, Dd, Uzw, Uzw, Rd, Dd
Qxv, Qxv, Qxv, Yhs, Dd, Re^Esd, Re^Edt, Ds, Dd, Uzw, Uzw, Dd, Dd^Edt, Dd, Qxv, Dd, Qxv, Ds, Ds, Ds, Uzw, Dd, Dd, Dd, Dd, Qxv, Qxv, Dd, Re^Tf, Hd, Yhs, Yhs^Xp, Ds, Uzw, Uzw, Uzw, Ds, Ds, Ds, Dd, Dd, Dd, Dd, Dd^Esd, Dd, Dd, Re^Tf, Uzw, Yhs^&A, Yhs^Xp, Dd, Dd, Dd, Dd, Uzw, Uzw, Re^Tf, Tb^Tf
Dd, Qxv, Ds, Ds, Hd, Dd, Dd, Dd, Dd, Dd, Dd, Dd^Edt, Dd^Edt, Dd, Qxv, Qxv, Dd, Dd, Ds, Uzw, Uzw, Uzw, Ds, Ds, Re^Tf, Dd, Dd, Re^Tf, Uu^Tf, Yhs^&A, Dd, Dd, Dd, Ds, Ds, Ds, Yhs, Yhs, Ds, Ds, Dd, Dd, Dd, Uzw, Uzw, Dd, Dd, Tb^Tf, Dd, Dd, Qxv, Dd, Dd, Qxv, Qxv, Yhs^Xp, Yhs^Xp, Re^Tf
Dd, Dd, Dd, Dd, Hd, Hd, Dd, Hd, Hd, Hd, Re, Re^Edt, Dd, Dd, Dd, Qxv, Hd, Hd, Hd, Uzw, Ds, Ds, Ds, Yhs^Xp, Tb^Tf, Re^Tf, Dd, Cte, Uu^Tf, Yhs, Re^Tf, Re^Tf, Qxv, Qxv, Ds, Yhs, Ds, Ds, Uzw, Uzw, Dd^Dr, Dd^Dr, Dd, Uzw, Yhs, Dd, Dd, Re^Tf, Dd, Dd, Qxv, Qxv, Qxv, Qxv, Qxv, Yhs, Qxv, Yhs
Hd, Dd, Dd, Hd, Hd, Dd, Dd, Dd, Dd, Hd, Dd, Re^Tf, Dd, Dd, Dd, Dd, Hd, Hd, Cte, Dd, Dd, Dd, Qxv, Tb^Tf, Yhs^Yva, Re^Tf, Re^Tf, Dd, Dd, Tb^Tf, Tb^Tf, Cte, Qxv, Qxv, Dd, Hd, Dd, Dd, Dd, Dd, Dd, Dd^Dr, Uzw, Dd, Dd, Yhs^Xp, Yhs, Cte, Cte, Dd, Dd, Qxv, Qxv, Qxv, Qxv, Qxv, Qxv, Qxv
Dd, Dd, Hd, Dd, Dd, Dd, Cte, Ds, Uzw, Dd, Dd, Dd, Dd, Dd, Ds, Dd, Hd, Cte, Dd, Dd, Dd, Dd, Qxv, Qxv, Dd, Dd, Dd, Uzw, Re^Tf, Tb^Tf, Cte, Cte, Dd^Dr, Qxv, Qxv, Hd, Hd, Dd, Dd, Dd, Dd, Uzw, Dd, Dd, Dd, Yhs, Dd, Cte, Uzw, Dd, Dd, Dd^Es, Qxv, Qxv, Dd, Qxv, Tb^Tf, Qxv
Dd, Dd, Dd, Dd, Dd, Uzw, Uzw, Uzw, Re^Tf, Re^Esd, Dd^Edt, Dd, Qxv, Dd, Uzw, Ds, Uzw, Hd, Dd, Dd, Yhs^Xp, Dd, Dd, Dd, Dd, Uzw, Uzw, Uzw, Uu^Tf, Uu^Tf, Uu^Tf, Dd, Dd, Qxv, Qxv, Qxv, Qxv, Cte, Cte, Dd, Yhs^&A, Uzw, Dd, Dd, Dd, Dd, Dd, Dd, Uh, Hd, Hd, Hd^Dr, Dd, Qxv, Hd, Hd, Tb^Tf, Tb^Tf
Dd, Dd^Edt, Dd^Edt, Dd, Qxv, Qxv, Uzw, Uzw, Re^Es, Dd^Edt, Dd^Edt, Dd, Qxv, Qxv, Yhs^Xp, Uzw, Uzw, Dd, Dd^Es, Dd, Yhs^Yva, Yhs^Vyv, Dd, Dd, Dd, Uzw, Uzw, Uzw, Re^Tf, Yhs^Xp, Yhs^Yva, Uu^Tf, Dd, Dd, Dd, Dd, Dd, Cte, Yhs^Xp, Uh, Yhs^Xp, Uzw, Dd, Dd, Dd, Dd, Uzw, Dd, Dd, Hd, Dd, Hd, Hd, Hd, Hd, Hd, Dd, Dd
Hd, Dd^Edt, Dd^Edt, Dd, Qxv, Qxv, Yhs^&A, Yhs^Xp, Yhs, Dd^Edt, Dd, Hd, Dd, Qxv, Yhs, Yhs^&A, Uzw, Dd, Ds, Ds, Uzw, Yhs^&A, Cte, Dd, Hd, Dd, Uzw, Uzw, Hd, Re^Tf, Yhs, Yhs^Xp, Hd, Hd, Dd, Dd, Dd, Yhs, Yhs^Vyv, Uzw, Yhs, Dd, Hd, Dd^Esd, Dd, Dd, Uzw, Uzw, Dd, Hd, Dd, Dd, Dd, Dd, Hd, Dd, Ds, Dd
Hd, Hd, Dd^Edt, Dd^Edt, Dd, Yhs^Vyv, Yhs^Xp, Yhs^Xp, Ds, Dd, Hd, Hd, Dd, Dd, Dd, Yhs^Yva, Yhs^Xp, Dd, Ds, Yhs, Yhs^Xp, Uzw, Uzw, Dd, Hd, Hd, Dd, Uzw, Hd, Yhs^Xp, Yhs^&A, Yhs^Yva, Hd, Uzw, Dd, Dd, Dd, Uzw, Uh^Dr, Yhs^Xp, Uzw, Hd, Uzw, Dd, Dd, Dd, Dd, Uzw, Dd, Hd, Dd, Qxv, Yhs, Dd, Dd, Dd, Ds, Ds
Dd, Dd, Dd^Edt, Dd^Edt, Dd, Dd, Dd, Ds, Dd, Dd, Hd, Hd, Dd, Dd, Uzw, Yhs, Yhs^&A, Dd, Ds, Yhs, Dd, Yhs, Uzw, Dd, Dd^Edt, Dd, Dd, Hd, Dd, Hd, Yhs, Hd, Yhs, Uzw, Dd, Dd, Hd, Uh, Uh, Uzw, Uzw, Uzw, Dd, Uzw, Dd, Dd, Dd, Dd, Hd, Hd, Dd, Uzw, Qxv, Yhs^&B, Yhs^Yva, Dd, Hd, Dd
Ds, Ds, Uzw, Uzw, Dd, Dd, Ds, Dd, Dd, Dd, Dd, Dd, Dd, Dd, Dd, Uzw, Dd, Yhs, Ds, Cte, Hd, Dd, Hd, Cte, Uzw^Edt, Dd^Edt, Dd, Dd, Dd^Es, Dd, Dd, Yhs^Xp, Yhs, Hd, Dd, Dd, Hd, Uh, Hd, Dd, Dd, Dd, Dd, Dd, Hd, Hd, Hd, Dd, Dd, Dd, Uzw, Qxv, Qxv, Yhs^&B, Tb^Tf, Ds, Hd, Hd
Uzw, Uzw, Uzw, Uzw, Yhs^Xp, Dd, Dd, Ds, Ds, Dd, Dd, Qxv, Qxv, Dd, Hd, Dd^Dc, Dd, Ds, Hd, Dd, Ds, Hd, Hd, Uzw, Uh, Uzw^Edt, Tb^Tf, Dd, Dd, Dd, Dd, Dd, Dd, Hd, Hd, Dd, Hd, Hd^Esd, Hd, Yhs^Xp, Dd, Dd, Dd, Hd, Qxv, Ds, Ds, Ds, Ds^Dr, Uzw, Uu^Tf, Qxv, Qxv, Qxv, Ds, Ds, Dd, Hd
Qxv, Qxv, Qxv, Qxv, Yhs, Yhs, Dd, Ds, Hd, Dd, Dd, Qxv, Yhs, Dd, Uzw, Hd, Hd, Dd, Hd, Ds, Yhs^Xp, Ds, Dd, Hd, Dd, Uh, Dd, Re^Tf, Dd, Dd, Dd, Dd, Dd, Hd, Yhs, Dd, Dd, Hd, Dd, Yhs^&A, Yhs^Xp, Dd, Hd, Qxv, Qxv, Uzw, Uzw, Ds, Hd, Tb^Tf, Re^Tf, Yhs, Hd, Dd, Dd^Dr, Dd, Dd^Dc, Hd
Dd, Qxv, Dd, Dd, Dd, Dd, Dd, Dd, Hd, Dd, Dd, Dd, Yhs, Yhs^Xp, Uzw, Uzw, Yhs^Xp, Hd, Yhs, Yhs, Ds, Ds, Dd, Dd, Dd, Dd, Hd, Hd, Hd, Hd, Hd, Dd, Dd, Dd, Yhs^&A, Yhs^Xp, Yhs^Xp, Yhs^&A, Yhs, Yhs, Hd, Hd, Qxv, Qxv, Yhs^Yva, Uzw, Dd, Dd, Dd, Ds, Dd, Hd, Dd, Dd, Dd, Dd^Dr, Ds, Ds
Dd, Dd, Dd, Dd, Dd, Dd, Dd, Hd, Hd, Dd, Dd, Dd, Dd, Uh, Yhs, Uzw, Dd, Yhs, Dd, Yhs, Tb^Tf, Dd, Dd, Qxv, Qxv, Hd, Hd, Hd, Hd, Hd, Hd, Dd, Dd, Dd, Uu^Tf, Uu^Tf, Yhs, Yhs, Uu^Tf, Hd, Hd, Hd, Hd, Qxv, Dd, Yhs, Hd, Hd, Dd, Dd, Qxv, Qxv, Qxv, Dd, Dd, Dd, Ds, Ds
