border_size=1
usage=map

Mm          , Mm          , Mm          , Mm          , Mm          , Mm          , Hh          , Hh          , Hh          , Gs          , Ds          , Gs          , Gs          , Gs          , Ds          , Ds          , Hh          , Mm          , Mm          , Mm          , Mm          , Mm          
Mm          , Mm          , Mm          , Mm          , Mm          , Mm          , Hh          , Hh          , Gs          , Gs          , Ds          , Gs          , Gs          , Gs          , Ds          , Ds          , Hh          , Mm          , Mm          , Mm          , Mm          , Mm          
Mm          , Mm          , Mm          , Mm          , Mm          , Mm          , Hh          , Hh          , Gs          , Gs          , Ds          , 1 Ds        , Gs          , Ds          , Gs          , Ds          , Hh          , Mm          , Mm          , Mm          , Mm          , Mm          
Mm          , Mm          , Mm          , Mm          , Mm          , Mm          , Mm          , Hh          , Gs          , Ds          , Ds          , Ds          , Gs          , Gs          , Gs          , Gs          , Gs          , Hh          , Mm          , Mm          , Mm          , Mm          
Mm          , Mm          , Mm          , Mm          , Mm          , Mm          , Hh          , Hh          , Hh          , Gs          , Gs          , Ds          , Gs          , Gs          , Ds          , Ds          , Gs          , Hh          , Hh          , Mm          , Mm          , Mm          
Mm          , Mm          , Mm          , Mm          , Hh          , Hh          , Ds          , Hh          , Hh          , Gs          , Gs          , Gs          , Ds          , Gs          , Ds          , Ds          , Gs          , Hh          , Hh          , Mm          , Mm          , Mm          
Mm          , Mm          , Mm          , Hh          , Gs          , Ds          , Ds          , Ds          , Gs          , Gs          , Gs          , Gs          , Gs          , Gs          , Gs          , Ds          , Gs          , Gs          , Hh          , Mm          , Mm          , Mm          
Mm          , Mm          , Mm          , Hh          , Hh          , Gs          , Gs          , Gs          , Ds          , Gs          , Gs          , Ds          , Ds          , Gs          , Gs          , Ds          , Hh          , Hh          , Mm          , Mm          , Mm          , Mm          
Mm^Xm       , Mm          , Mm          , Hh          , Hh          , Gs          , Ds          , Gs          , Gs          , Gs          , Gs          , Ds          , Ds          , Gs          , Gs          , Gs          , Hh          , Mm          , Mm          , Mm          , Mm          , Mm          
Md^Xm       , Mm^Xm       , Mm^Xm       , Hh          , Hh          , Ds          , Gs          , Gs          , Ds          , Gs          , Gs          , Ds          , Ds          , Ds          , Gs          , Gs          , Ds          , Hh          , Md^Xm       , Mm^Xm       , Mm^Xm       , Mm^Xm       
Md          , Md^Xm       , Md^Xm       , Mm^Xm       , Hh          , Ds          , Ys          , Gs          , Gs          , Ds          , Ds          , Gs          , Ds          , Ds          , Gs          , Gs          , Ds          , Hd          , Hd          , Md^Xm       , Md^Xm       , Md^Xm
Md          , Md          , Md          , Md^Xm       , Hd          , Ds          , Ys          , Ds          , Ys          , Ds          , Ys          , Ds          , Ds          , Gs          , Ys          , Ys^Xp         , Dd          , Hd          , Md          , Md          , Md          , Md
Md          , Md          , Md          , Md          , Hd          , Zw          , Ys^Xp         , Ys          , Ds          , Ys          , Ys          , Ys          , Dd          , Ys          , Ys          , Ds          , Ys          , Ds          , Hd          , Md          , Md          , Md
Md          , Md          , Md          , Hd          , Ys          , Zw          , Zw          , Ys          , Ds          , Ys          , Zw          , Ys          , Ys          , Ys          , Dd          , Dd          , Ys          , Ys          , Hd          , Md          , Md          , Md
Md          , Md          , Ys          , Hd          , Zw          , Dd          , Dd          , Ys          , Ys          , Ys          , Zw          , Zw          , Ys^Xp         , Ds          , Zw          , Zw          , Hd          , Ys          , Md          , Md          , Md          , Md
Md          , Md          , Md          , Ys          , Dd          , Zw          , Ys          , Dd          , Zw          , Dd          , Ys          , Zw          , Ys          , Zw          , Zw          , Ys          , Hd          , Hd          , Md          , Md          , Md          , Md
Md          , Md          , Md          , Ys          , Ys          , Zw          , Ys          , Ys          , Zw          , Zw          , Dd          , Dd          , Ys          , Ys          , Ys          , Hd          , Ys          , Md          , Md          , Md          , Md          , Md
Md          , Md          , Md          , Md          , Ys          , Dd          , Ys^Xp         , Ys          , Dd          , Zw          , Ys          , Zw          , Ys          , Dd          , Dd          , Zw          , Hd          , Hd          , Hd          , Md          , Md          , Md
Md          , Md          , Md          , Md          , Ys          , Hd          , Zw          , Ys          , Dd          , Zw          , Dd          , Zw          , Dd          , Ys          , Ys^Xp         , Ys          , Ys          , Hd          , Md          , Md          , Md          , Md
Md          , Md          , Md          , Md          , Ys          , Zw          , Ys          , Ys          , Ys^Xp         , Ys          , Ys          , Ys          , Zw          , Zw          , Zw          , Hd          , Ys          , Md          , Md          , Md          , Md          , Md
Md          , Md          , Ys          , Ys          , Ds          , Ys          , Dd          , Dd          , Zw          , Zw          , Ds          , Dd          , Ys          , Ys          , Dd          , Ys          , Ys          , Hd          , Hd          , Md          , Md          , Md
Md          , Md          , Ys          , Ys          , Ys          , Ds          , Dd          , Zw          , Ys          , Ys          , Ds          , Zw          , Ys          , Ys          , Ys          , Ys          , Ys          , Hd          , Hd          , Md          , Md          , Md
