border_size=1
usage=map

Mm^Xm       , Mm^Xm       , Mm^Xm       , Mm^Xm       , Mm^Xm       , Mm^Xm       , Mm^Xm       , Hh          , Hh          , Gs          , Gs          , Ds          , Ds          , Gs          , Gs          , Gs          , Gs          , Hh          , Hh          , Mm          , Mm          , Mm^Xm       , Mm          , Mm          , Mm          , Mm^Xm       , Mm^Xm       , Mm^Xm       , Mm^Xm       , Mm^Xm       , Mm^Xm       , Mm^Xm       
Mm^Xm       , Mm^Xm       , Mm          , Mm^Xm       , Mm          , Mm^Xm       , Mm^Xm       , Mm^Xm       , Hh          , Gs          , Gs          , Ds          , Gs          , Gs          , Ds          , Ds          , Gs          , Hh          , Hh          , Hh          , Hh          , Mm          , Mm^Xm       , Mm          , Mm          , Mm^Xm       , Mm^Xm       , Mm^Xm       , Mm^Xm       , Mm^Xm       , Mm^Xm       , Mm^Xm       
Mm^Xm       , Mm          , Mm          , Mm          , Mm          , Mm          , Mm          , Mm^Xm       , Hh          , Hh          , Hh          , Hh          , Hh          , Gs          , Ds          , Ds          , Ds          , Hh          , Ds          , Hh          , Hh          , Mm          , Mm          , Mm^Xm       , Mm^Xm       , Mm^Xm       , Mm          , Mm^Xm       , Mm^Xm       , Mm^Xm       , Mm^Xm       , Mm^Xm       
Mm          , Mm          , Mm^Xm       , Mm          , Mm          , Mm^Xm       , Mm          , Mm          , Mm          , Hh          , Hh          , Hh          , Ds          , Gs^Vht      , Gs          , Ds          , Gs          , Hh          , Ds          , Ds          , Hh          , Mm          , Mm          , Mm          , Mm          , Mm          , Mm^Xm       , Mm          , Mm^Xm       , Mm^Xm       , Mm^Xm       , Mm^Xm       
Mm          , Mm^Xm       , Mm          , Mm          , Mm          , Mm          , Mm          , Mm          , Mm          , Hh          , Ds          , Gs          , Ds          , Ds          , Ce          , Ce          , Ce          , Ds          , Gs          , Hh^Vhh      , Hh          , Hh          , Hh          , Mm          , Mm          , Mm          , Mm          , Mm          , Mm^Xm       , Mm^Xm       , Mm^Xm       , Mm^Xm       
Mm          , Mm          , Mm^Xm       , Mm^Xm       , Mm          , Mm          , Mm          , Mm          , Mm          , Hh          , Ds          , Ds          , Gs          , Ce          , Ce          , 3 Ke        , Ce          , Ce          , Gs          , Hh          , Hh          , Hh          , Hh          , Mm          , Mm          , Mm          , Mm^Xm       , Mm          , Mm^Xm       , Mm^Xm       , Mm^Xm       , Mm^Xm       
Mm^Xm       , Mm^Xm       , Mm^Xm       , Mm^Xm       , Mm          , Mm          , Mm          , Mm          , Hh          , Hh^Vhh      , Gs          , Ds          , Gs          , Ds          , Ds          , Ce          , Ds          , Ds          , Ds          , Gs          , Gs          , Hh          , Mm          , Mm          , Mm          , Mm          , Mm          , Mm^Xm       , Mm          , Mm^Xm       , Mm^Xm       , Mm^Xm       
Mm^Xm       , Mm^Xm       , Mm          , Mm^Xm       , Mm          , Mm          , Mm          , Mm          , Hh          , Hh          , Hh          , Hh          , Gs          , Gs          , Hh          , Ds          , Gs          , Gs          , Gs          , Gs          , Hh          , Hh          , Mm          , Mm^Xm       , Mm          , Mm          , Mm          , Mm          , Mm          , Mm^Xm       , Mm^Xm       , Mm^Xm       
Mm^Xm       , Mm^Xm       , Mm          , Mm          , Mm          , Mm          , Mm          , Mm          , Hh          , Ds          , Ds          , Gs          , Gs          , Hh          , Hh          , Ds          , Gs          , Gs          , Hh          , Hh          , Hh          , Mm          , Mm          , Mm          , Mm          , Mm          , Mm          , Mm          , Mm^Xm       , Mm^Xm       , Mm^Xm       , Mm^Xm       
Mm^Xm       , Mm^Xm       , Mm^Xm       , Mm          , Mm          , Mm          , Mm          , Mm          , Hh          , Ds          , Gs          , Ds          , Gs          , Gs          , Hh          , Hh          , Gs          , Hh          , Ds          , Gs          , Hh          , Hh          , Hh          , Mm          , Mm^Xm       , Mm          , Mm          , Mm^Xm       , Mm          , Mm^Xm       , Mm^Xm       , Mm^Xm       
Mm^Xm       , Mm^Xm       , Mm^Xm       , Mm^Xm       , Mm          , Mm          , Mm          , Mm          , Hh          , Gs          , Hh          , Gs          , Ds          , Gs          , Ds          , Gs          , Gs          , Gs          , Gs          , Gs          , Gs          , Hh          , Hh          , Mm          , Mm          , Mm          , Mm          , Mm          , Mm          , Mm          , Mm          , Mm^Xm       
Mm          , Mm^Xm       , Mm          , Mm          , Mm^Xm       , Mm          , Mm          , Hh          , Hh          , Hh          , Hh          , Hh          , Ds          , Gs          , Gs          , Ds          , Gs          , Gs          , Gs^Vht      , Gs          , Ds          , Ds          , Hh          , Hh          , Mm          , Mm          , Mm          , Mm          , Mm^Xm       , Mm          , Mm^Xm       , Mm^Xm       
Mm^Xm       , Mm^Xm       , Mm          , Mm          , Mm          , Mm          , Mm          , Hh          , Hh          , Hh          , Ds          , Gs          , Gs          , Gs^Vht      , Gs          , Gs          , Ds          , Gs          , Gs          , Ds          , Hh          , Hh          , Hh          , Hh          , Mm^Xm       , Mm          , Mm          , Mm^Xm       , Mm^Xm       , Mm^Xm       , Mm^Xm       , Mm^Xm       
Mm^Xm       , Mm          , Mm          , Mm          , Mm          , Mm          , Mm          , Mm          , Hh          , Hh          , Ds          , Gs          , Hh          , Gs          , Ce          , Ce          , Ce          , Ds          , Gs          , Hh          , Hh          , Hh          , Hh          , Mm          , Mm          , Mm          , Mm          , Mm          , Mm          , Mm          , Mm^Xm       , Mm^Xm       
Mm^Xm       , Mm          , Mm          , Mm          , Mm          , Mm          , Mm          , Mm^Xm       , Mm          , Hh          , Hh          , Hh          , Gs          , Ce          , Ce          , 1 Ke        , Ce          , Ce          , Gs          , Hh          , Gs          , Hh          , Hh          , Hh          , Mm^Xm       , Mm          , Mm          , Mm          , Mm          , Mm^Xm       , Mm^Xm       , Mm^Xm       
Mm^Xm       , Mm^Xm       , Mm          , Mm          , Mm          , Mm          , Mm          , Mm          , Mm          , Hh          , Hh^Vhh      , Hh          , Ds          , Gs          , Ds          , Ce          , Gs          , Gs          , Ds          , Gs          , Hd          , Ds          , Hd          , Hh          , Mm^Xm       , Mm^Xm       , Mm^Xm       , Mm          , Mm^Xm       , Mm^Xm       , Mm^Xm       , Mm^Xm       
Mm^Xm       , Mm^Xm       , Mm^Xm       , Mm          , Mm          , Mm          , Mm          , Mm^Xm       , Mm^Xm       , Hh          , Hh          , Hh          , Ds          , Ds          , Gs          , Gs          , Gs          , Ds          , Gs          , Zw          , Hd          , Hd          , Hd          , Hh          , Hd          , Mm^Xm       , Md^Xm       , Mm^Xm       , Mm^Xm       , Mm^Xm       , Mm^Xm       , Mm^Xm       
Md^Xm       , Mm^Xm       , Mm^Xm       , Mm^Xm       , Mm^Xm       , Mm^Xm       , Mm^Xm       , Mm^Xm       , Md^Xm       , Md^Xm       , Hd          , Hh          , Hd          , Gs          , Hd          , Gs          , Hd          , Ds          , Ds          , Zw          , Zw          , Hd          , Hd          , Hd          , Hd          , Md^Xm       , Md^Xm       , Md^Xm       , Md^Xm       , Mm^Xm       , Md^Xm       , Mm^Xm       
Md^Xm       , Md^Xm       , Md^Xm       , Mm^Xm       , Md^Xm       , Md^Xm       , Md^Xm       , Md^Xm       , Hd          , Hd          , Hd          , Hd          , Dd          , Dd          , Ds          , Ds          , Zw          , Ds          , Ys          , Ys          , Ys          , Hd          , Hd          , Hd          , Hd          , Md          , Md          , Md^Xm       , Md^Xm       , Md^Xm       , Md^Xm       , Md^Xm       
Md^Xm       , Md^Xm       , Md^Xm       , Md^Xm       , Md^Xm       , Md^Xm       , Md^Xm       , Md^Xm       , Hd          , Hd          , Zw          , Dd          , Ys^Xp       , Ys          , Ys^Xp       , Ds          , Zw          , Zw          , Ys          , Ys^Xp       , Ys          , Ys^Xp       , Dd          , Hd          , Hd          , Md          , Md          , Md          , Md          , Md^Xm       , Md^Xm       , Md^Xm       
Md^Xm       , Md^Xm       , Md^Xm       , Md^Xm       , Md          , Md          , Md          , Hd          , Uu^Cd       , Zw          , Ys^Xp       , Ys          , Ys          , Ys          , Ys          , Ys          , Zw          , Ys          , Ys^Xp       , Ys^Xp       , Zw          , Zw          , Ds          , Hd          , Hd          , Hd          , Md          , Md          , Md          , Md^Xm       , Md^Xm       , Md^Xm       
Md^Xm       , Md^Xm       , Md^Xm       , Md^Xm       , Md          , Md          , Hd          , Dd          , Uu^Cd       , Ys          , Ds          , Ds          , Dd^Vdt      , Ys^Xp       , Ys^Xp       , Ys          , Uu^Cd       , Uu^Cd       , Zw          , Zw          , Zw          , Zw          , Uu^Cd       , Ds          , Hd          , Hd          , Md          , Md          , Md^Xm       , Md          , Md          , Md^Xm       
Md^Xm       , Md^Xm       , Md^Xm       , Md^Xm       , Md          , Md          , Uu^Cd       , Uu^Cd       , Zw          , Ds          , Zw          , Zw          , Zw          , Dd          , Uu^Cd       , Uu^Cd       , Zw          , Zw          , Ys          , Ys          , Ys^Xp       , Dd^Vdt      , Uu^Cd       , Uu^Cd       , Hd          , Hd          , Md          , Md^Xm       , Md^Xm       , Md          , Md^Xm       , Md^Xm       
Md^Xm       , Md^Xm       , Md^Xm       , Md          , Md^Xm       , Md          , Hd          , Zw          , Zw          , Ds          , Ds          , Ys          , Ys^Xp       , Zw          , Ys          , Zw          , Zw          , Ys          , Ys^Xp       , Ys          , Ys          , Zw          , Dd          , Uu^Cd       , Hd          , Md          , Md          , Md          , Md          , Md^Xm       , Md^Xm       , Md^Xm       
Md^Xm       , Md^Xm       , Md^Xm       , Md^Xm       , Md^Xm       , Md          , Hd          , Ds          , Ys          , Ys          , Ys          , Uu^Cd       , Uu^Cd       , Ys          , Ys          , Ys          , Zw          , Uu^Cd       , Ys          , Ys          , Ys          , Zw          , Dd          , Ds          , Md          , Md          , Md^Xm       , Md          , Md^Xm       , Md^Xm       , Md^Xm       , Md^Xm       
Md^Xm       , Md^Xm       , Md^Xm       , Md^Xm       , Md          , Md          , Hd          , Ds          , Ys          , Ys^Xp       , Zw          , Zw          , Uu^Cd       , Ys^Xp       , Ys          , Uu^Cd       , Uu^Cd       , Uu^Cd       , Uu^Cd       , Uu^Cd       , Dd          , Ys          , Dd^Vdt      , Dd          , Hd          , Md          , Md^Xm       , Md^Xm       , Md^Xm       , Md^Xm       , Md^Xm       , Md^Xm       
Md^Xm       , Md^Xm       , Md^Xm       , Md^Xm       , Md          , Md          , Hd          , Hd          , Hd          , Ys          , Zw          , Zw          , Uu^Cd       , Zw          , Ys^Xp       , Ys          , Uu^Cd       , 2 Uu^Kd     , Uu^Cd       , Dd          , Ys          , Zw          , Hd          , Ds          , Hd          , Md          , Md          , Md^Xm       , Md^Xm       , Md^Xm       , Md^Xm       , Md^Xm       
Md^Xm       , Md^Xm       , Md          , Md^Xm       , Md^Xm       , Md          , Md          , Hd          , Hd          , Dd^Vdt      , Ds          , Ds          , Zw          , Zw          , Ys          , Uu^Cd       , Zw          , Uu^Cd       , Dd          , Uu^Cd       , Dd          , Hd          , Dd          , Hd          , Hd          , Md          , Md^Xm       , Md^Xm       , Md          , Md^Xm       , Md^Xm       , Md^Xm       
Md^Xm       , Md          , Md          , Md^Xm       , Md          , Md^Xm       , Md          , Md          , Uu^Cd       , Dd          , Zw          , Zw          , Ys          , Ys^Xp       , Zw          , Ys          , Dd^Vdt      , Uu^Cd       , Dd          , Dd          , Hd          , Hd          , Ds          , Uu^Cd       , Hd          , Hd          , Md          , Md          , Md^Xm       , Md^Xm       , Md^Xm       , Md^Xm       
Md^Xm       , Md          , Md          , Md          , Hd          , Md          , Hd          , Uu^Cd       , Uu^Cd       , Dd          , Ys          , Ys^Xp       , Ys          , Zw          , Zw          , Dd          , Dd          , Dd          , Ds          , Ds          , Zw          , Zw          , Zw          , Uu^Cd       , Uu^Cd       , Hd          , Md          , Md          , Md^Xm       , Md^Xm       , Md^Xm       , Md^Xm       
Md          , Md          , Hd          , Hd          , Hd          , Hd          , Zw          , Hd          , Uu^Cd       , Uu^Cd       , Uu^Cd       , Zw          , Ds          , Ys          , Ys          , Dd          , Uu^Cd       , Uu^Cd       , Zw          , Zw          , Zw          , Ys          , Ys^Xp       , Zw          , Ds          , Hd          , Hd          , Md          , Md^Xm       , Md^Xm       , Md^Xm       , Md^Xm       
Md          , Md          , Hd          , Hd          , Zw          , Zw          , Zw          , Zw          , Uu^Cd       , Ys          , Ys          , Ys          , Ys          , Ds          , Ds          , Uu^Cd       , Dd          , Ds          , Ys          , Ys^Xp       , Ys          , Ys          , Ds          , Ds          , Ds          , Hd          , Md^Xm       , Md^Xm       , Md^Xm       , Md^Xm       , Md^Xm       , Md^Xm       
