border_size=1
usage=map

Mm          , Mm          , Mm          , Mm          , Mm          , Mm          , Hh          , Hh          , Hh          , Gs          , Ds          , Gs          , Gs          , Gs          , Ds          , Ds          , Hh          , Mm          , Mm          , Mm          , Mm          , Mm          
Mm          , Mm          , Mm          , Mm          , Mm          , Mm          , Hh          , Hh          , Gs          , Gs          , Ds          , Gs          , Gs          , Gs          , Ds          , Ds          , Hh          , Mm          , Mm          , Mm          , Mm          , Mm          
Mm          , Mm          , Mm          , Mm          , Mm          , Mm          , Hh          , Hh          , Gs          , Gs          , Ds          , 1 Ds        , Gs          , Ds          , Gs          , Ds          , Hh          , Mm          , Mm          , Mm          , Mm          , Mm          
Mm          , Mm          , Mm          , Mm          , Mm          , Mm          , Mm          , Hh          , Gs          , Ds          , Ds          , Ds          , Gs          , Gs          , Gs          , Gs          , Gs          , Hh          , Mm          , Mm          , Mm          , Mm          
Mm          , Mm          , Mm          , Mm          , Mm          , Mm          , Hh          , Hh          , Hh          , Gs          , Gs          , Ds          , Gs          , Gs          , Ds          , Ds          , Gs          , Hh          , Hh          , Mm          , Mm          , Mm          
Mm          , Mm          , Mm          , Mm          , Hh          , Hh          , Ds          , Hh          , Hh          , Gs          , Gs          , Gs          , Ds          , Gs          , Ds          , Ds          , Gs          , Hh          , Hh          , Mm          , Mm          , Mm          
Mm          , Mm          , Mm          , Hh          , Gs          , Ds          , Ds          , Ds          , Gs          , Gs          , Gs          , Gs          , Gs          , Gs          , Gs          , Ds          , Gs          , Gs          , Hh          , Mm          , Mm          , Mm          
Mm          , Mm          , Mm          , Hh          , Hh          , Gs          , Gs          , Gs          , Ds          , Gs          , Gs          , Ds          , Ds          , Gs          , Gs          , Ds          , Hh          , Hh          , Mm          , Mm          , Mm          , Mm          
Mm^Xm       , Mm          , Mm          , Hh          , Hh          , Gs          , Ds          , Gs          , Gs          , Gs          , Gs          , Ds          , Ds          , Gs          , Gs          , Gs          , Hh          , Mm          , Mm          , Mm          , Mm          , Mm          
Md^Xm       , Mm^Xm       , Mm^Xm       , Hh          , Hh          , Ds          , Gs          , Gs          , Ds          , Gs          , Gs          , Ds          , Ds          , Ds          , Gs          , Gs          , Ds          , Hh          , Md^Xm       , Mm^Xm       , Mm^Xm       , Mm^Xm       
Md          , Md^Xm       , Md^Xm       , Mm^Xm       , Hh          , Ds          , Yr          , Gs          , Gs          , Ds          , Ds          , Gs          , Ds          , Ds          , Gs          , Gs          , Ds          , Hd          , Hd          , Md^Xm       , Md^Xm       , Md^Xm       
Md          , Md          , Md          , Md^Xm       , Hd          , Ds          , Yr          , Ds          , Yr          , Ds          , Yr          , Ds          , Ds          , Gs          , Yr          , Yrh         , Dd          , Hd          , Md          , Md          , Md          , Md          
Md          , Md          , Md          , Md          , Hd          , Zw          , Yrh         , Yr          , Ds          , Yr          , Yr          , Yr          , Dd          , Yr          , Yr          , Ds          , Yr          , Ds          , Hd          , Md          , Md          , Md          
Md          , Md          , Md          , Hd          , Yr          , Zw          , Zw          , Yr          , Ds          , Yr          , Zw          , Yr          , Yr          , Yr          , Dd          , Dd          , Yr          , Yr          , Hd          , Md          , Md          , Md          
Md          , Md          , Yr          , Hd          , Zw          , Dd          , Dd          , Yr          , Yr          , Yr          , Zw          , Zw          , Yrh         , Ds          , Zw          , Zw          , Hd          , Yr          , Md          , Md          , Md          , Md          
Md          , Md          , Md          , Yr          , Dd          , Zw          , Yr          , Dd          , Zw          , Dd          , Yr          , Zw          , Yr          , Zw          , Zw          , Yr          , Hd          , Hd          , Md          , Md          , Md          , Md          
Md          , Md          , Md          , Yr          , Yr          , Zw          , Yr          , Yr          , Zw          , Zw          , Dd          , Dd          , Yr          , Yr          , Yr          , Hd          , Yr          , Md          , Md          , Md          , Md          , Md          
Md          , Md          , Md          , Md          , Yr          , Dd          , Yrh         , Yr          , Dd          , Zw          , Yr          , Zw          , Yr          , Dd          , Dd          , Zw          , Hd          , Hd          , Hd          , Md          , Md          , Md          
Md          , Md          , Md          , Md          , Yr          , Hd          , Zw          , Yr          , Dd          , Zw          , Dd          , Zw          , Dd          , Yr          , Yrh         , Yr          , Yr          , Hd          , Md          , Md          , Md          , Md          
Md          , Md          , Md          , Md          , Yr          , Zw          , Yr          , Yr          , Yrh         , Yr          , Yr          , Yr          , Zw          , Zw          , Zw          , Hd          , Yr          , Md          , Md          , Md          , Md          , Md          
Md          , Md          , Yr          , Yr          , Ds          , Yr          , Dd          , Dd          , Zw          , Zw          , Ds          , Dd          , Yr          , Yr          , Dd          , Yr          , Yr          , Hd          , Hd          , Md          , Md          , Md          
Md          , Md          , Yr          , Yr          , Yr          , Ds          , Dd          , Zw          , Yr          , Yr          , Ds          , Zw          , Yr          , Yr          , Yr          , Yr          , Yr          , Hd          , Hd          , Md          , Md          , Md          
