border_size=1
usage=map

Mm^Xm       , Mm^Xm       , Mm^Xm       , Mm^Xm       , Mm^Xm       , Mm^Xm       , Mm^Xm       , Hh          , Hh          , Gs          , Gs          , Ds          , Ds          , Gs          , Gs          , Gs          , Gs          , Hh          , Hh          , Mm          , Mm          , Mm^Xm       , Mm          , Mm          , Mm          , Mm^Xm       , Mm^Xm       , Mm^Xm       , Mm^Xm       , Mm^Xm       , Mm^Xm       , Mm^Xm       
Mm^Xm       , Mm^Xm       , Mm          , Mm^Xm       , Mm          , Mm^Xm       , Mm^Xm       , Mm^Xm       , Hh          , Gs          , Gs          , Ds          , Gs          , Gs          , Ds          , Ds          , Gs          , Hh          , Hh          , Hh          , Hh          , Mm          , Mm^Xm       , Mm          , Mm          , Mm^Xm       , Mm^Xm       , Mm^Xm       , Mm^Xm       , Mm^Xm       , Mm^Xm       , Mm^Xm       
Mm^Xm       , Mm          , Mm          , Mm          , Mm          , Mm          , Mm          , Mm^Xm       , Hh          , Hh          , Hh          , Hh          , Hh          , Gs          , Ds          , Ds          , Ds          , Hh          , Ds          , Hh          , Hh          , Mm          , Mm          , Mm^Xm       , Mm^Xm       , Mm^Xm       , Mm          , Mm^Xm       , Mm^Xm       , Mm^Xm       , Mm^Xm       , Mm^Xm       
Mm          , Mm          , Mm^Xm       , Mm          , Mm          , Mm^Xm       , Mm          , Mm          , Mm          , Hh          , Hh          , Hh          , Ds          , Gs^Vht      , Gs          , Ds          , Gs          , Hh          , Ds          , Ds          , Hh          , Mm          , Mm          , Mm          , Mm          , Mm          , Mm^Xm       , Mm          , Mm^Xm       , Mm^Xm       , Mm^Xm       , Mm^Xm       
Mm          , Mm^Xm       , Mm          , Mm          , Mm          , Mm          , Mm          , Mm          , Mm          , Hh          , Ds          , Gs          , Ds          , Ds          , Ce          , Ce          , Ce          , Ds          , Gs          , Hh^Vhh      , Hh          , Hh          , Hh          , Mm          , Mm          , Mm          , Mm          , Mm          , Mm^Xm       , Mm^Xm       , Mm^Xm       , Mm^Xm       
Mm          , Mm          , Mm^Xm       , Mm^Xm       , Mm          , Mm          , Mm          , Mm          , Mm          , Hh          , Ds          , Ds          , Gs          , Ce          , Ce          , 3 Ke        , Ce          , Ce          , Gs          , Hh          , Hh          , Hh          , Hh          , Mm          , Mm          , Mm          , Mm^Xm       , Mm          , Mm^Xm       , Mm^Xm       , Mm^Xm       , Mm^Xm       
Mm^Xm       , Mm^Xm       , Mm^Xm       , Mm^Xm       , Mm          , Mm          , Mm          , Mm          , Hh          , Hh^Vhh      , Gs          , Ds          , Gs          , Ds          , Ds          , Ce          , Ds          , Ds          , Ds          , Gs          , Gs          , Hh          , Mm          , Mm          , Mm          , Mm          , Mm          , Mm^Xm       , Mm          , Mm^Xm       , Mm^Xm       , Mm^Xm       
Mm^Xm       , Mm^Xm       , Mm          , Mm^Xm       , Mm          , Mm          , Mm          , Mm          , Hh          , Hh          , Hh          , Hh          , Gs          , Gs          , Hh          , Ds          , Gs          , Gs          , Gs          , Gs          , Hh          , Hh          , Mm          , Mm^Xm       , Mm          , Mm          , Mm          , Mm          , Mm          , Mm^Xm       , Mm^Xm       , Mm^Xm       
Mm^Xm       , Mm^Xm       , Mm          , Mm          , Mm          , Mm          , Mm          , Mm          , Hh          , Ds          , Ds          , Gs          , Gs          , Hh          , Hh          , Ds          , Gs          , Gs          , Hh          , Hh          , Hh          , Mm          , Mm          , Mm          , Mm          , Mm          , Mm          , Mm          , Mm^Xm       , Mm^Xm       , Mm^Xm       , Mm^Xm       
Mm^Xm       , Mm^Xm       , Mm^Xm       , Mm          , Mm          , Mm          , Mm          , Mm          , Hh          , Ds          , Gs          , Ds          , Gs          , Gs          , Hh          , Hh          , Gs          , Hh          , Ds          , Gs          , Hh          , Hh          , Hh          , Mm          , Mm^Xm       , Mm          , Mm          , Mm^Xm       , Mm          , Mm^Xm       , Mm^Xm       , Mm^Xm       
Mm^Xm       , Mm^Xm       , Mm^Xm       , Mm^Xm       , Mm          , Mm          , Mm          , Mm          , Hh          , Gs          , Hh          , Gs          , Ds          , Gs          , Ds          , Gs          , Gs          , Gs          , Gs          , Gs          , Gs          , Hh          , Hh          , Mm          , Mm          , Mm          , Mm          , Mm          , Mm          , Mm          , Mm          , Mm^Xm       
Mm          , Mm^Xm       , Mm          , Mm          , Mm^Xm       , Mm          , Mm          , Hh          , Hh          , Hh          , Hh          , Hh          , Ds          , Gs          , Gs          , Ds          , Gs          , Gs          , Gs^Vht      , Gs          , Ds          , Ds          , Hh          , Hh          , Mm          , Mm          , Mm          , Mm          , Mm^Xm       , Mm          , Mm^Xm       , Mm^Xm       
Mm^Xm       , Mm^Xm       , Mm          , Mm          , Mm          , Mm          , Mm          , Hh          , Hh          , Hh          , Ds          , Gs          , Gs          , Gs^Vht      , Gs          , Gs          , Ds          , Gs          , Gs          , Ds          , Hh          , Hh          , Hh          , Hh          , Mm^Xm       , Mm          , Mm          , Mm^Xm       , Mm^Xm       , Mm^Xm       , Mm^Xm       , Mm^Xm       
Mm^Xm       , Mm          , Mm          , Mm          , Mm          , Mm          , Mm          , Mm          , Hh          , Hh          , Ds          , Gs          , Hh          , Gs          , Ce          , Ce          , Ce          , Ds          , Gs          , Hh          , Hh          , Hh          , Hh          , Mm          , Mm          , Mm          , Mm          , Mm          , Mm          , Mm          , Mm^Xm       , Mm^Xm       
Mm^Xm       , Mm          , Mm          , Mm          , Mm          , Mm          , Mm          , Mm^Xm       , Mm          , Hh          , Hh          , Hh          , Gs          , Ce          , Ce          , 1 Ke        , Ce          , Ce          , Gs          , Hh          , Gs          , Hh          , Hh          , Hh          , Mm^Xm       , Mm          , Mm          , Mm          , Mm          , Mm^Xm       , Mm^Xm       , Mm^Xm       
Mm^Xm       , Mm^Xm       , Mm          , Mm          , Mm          , Mm          , Mm          , Mm          , Mm          , Hh          , Hh^Vhh      , Hh          , Ds          , Gs          , Ds          , Ce          , Gs          , Gs          , Ds          , Gs          , Hd          , Ds          , Hd          , Hh          , Mm^Xm       , Mm^Xm       , Mm^Xm       , Mm          , Mm^Xm       , Mm^Xm       , Mm^Xm       , Mm^Xm       
Mm^Xm       , Mm^Xm       , Mm^Xm       , Mm          , Mm          , Mm          , Mm          , Mm^Xm       , Mm^Xm       , Hh          , Hh          , Hh          , Ds          , Ds          , Gs          , Gs          , Gs          , Ds          , Gs          , Zw          , Hd          , Hd          , Hd          , Hh          , Hd          , Mm^Xm       , Md^Xm       , Mm^Xm       , Mm^Xm       , Mm^Xm       , Mm^Xm       , Mm^Xm       
Md^Xm       , Mm^Xm       , Mm^Xm       , Mm^Xm       , Mm^Xm       , Mm^Xm       , Mm^Xm       , Mm^Xm       , Md^Xm       , Md^Xm       , Hd          , Hh          , Hd          , Gs          , Hd          , Gs          , Hd          , Ds          , Ds          , Zw          , Zw          , Hd          , Hd          , Hd          , Hd          , Md^Xm       , Md^Xm       , Md^Xm       , Md^Xm       , Mm^Xm       , Md^Xm       , Mm^Xm       
Md^Xm       , Md^Xm       , Md^Xm       , Mm^Xm       , Md^Xm       , Md^Xm       , Md^Xm       , Md^Xm       , Hd          , Hd          , Hd          , Hd          , Dd          , Dd          , Ds          , Ds          , Zw          , Ds          , Yhs          , Yhs          , Yhs          , Hd          , Hd          , Hd          , Hd          , Md          , Md          , Md^Xm       , Md^Xm       , Md^Xm       , Md^Xm       , Md^Xm
Md^Xm       , Md^Xm       , Md^Xm       , Md^Xm       , Md^Xm       , Md^Xm       , Md^Xm       , Md^Xm       , Hd          , Hd          , Zw          , Dd          , Yhs^Xp       , Yhs          , Yhs^Xp       , Ds          , Zw          , Zw          , Yhs          , Yhs^Xp       , Yhs          , Yhs^Xp       , Dd          , Hd          , Hd          , Md          , Md          , Md          , Md          , Md^Xm       , Md^Xm       , Md^Xm
Md^Xm       , Md^Xm       , Md^Xm       , Md^Xm       , Md          , Md          , Md          , Hd          , Uu^Cd       , Zw          , Yhs^Xp       , Yhs          , Yhs          , Yhs          , Yhs          , Yhs          , Zw          , Yhs          , Yhs^Xp       , Yhs^Xp       , Zw          , Zw          , Ds          , Hd          , Hd          , Hd          , Md          , Md          , Md          , Md^Xm       , Md^Xm       , Md^Xm
Md^Xm       , Md^Xm       , Md^Xm       , Md^Xm       , Md          , Md          , Hd          , Dd          , Uu^Cd       , Yhs          , Ds          , Ds          , Dd^Vdt      , Yhs^Xp       , Yhs^Xp       , Yhs          , Uu^Cd       , Uu^Cd       , Zw          , Zw          , Zw          , Zw          , Uu^Cd       , Ds          , Hd          , Hd          , Md          , Md          , Md^Xm       , Md          , Md          , Md^Xm
Md^Xm       , Md^Xm       , Md^Xm       , Md^Xm       , Md          , Md          , Uu^Cd       , Uu^Cd       , Zw          , Ds          , Zw          , Zw          , Zw          , Dd          , Uu^Cd       , Uu^Cd       , Zw          , Zw          , Yhs          , Yhs          , Yhs^Xp       , Dd^Vdt      , Uu^Cd       , Uu^Cd       , Hd          , Hd          , Md          , Md^Xm       , Md^Xm       , Md          , Md^Xm       , Md^Xm
Md^Xm       , Md^Xm       , Md^Xm       , Md          , Md^Xm       , Md          , Hd          , Zw          , Zw          , Ds          , Ds          , Yhs          , Yhs^Xp       , Zw          , Yhs          , Zw          , Zw          , Yhs          , Yhs^Xp       , Yhs          , Yhs          , Zw          , Dd          , Uu^Cd       , Hd          , Md          , Md          , Md          , Md          , Md^Xm       , Md^Xm       , Md^Xm
Md^Xm       , Md^Xm       , Md^Xm       , Md^Xm       , Md^Xm       , Md          , Hd          , Ds          , Yhs          , Yhs          , Yhs          , Uu^Cd       , Uu^Cd       , Yhs          , Yhs          , Yhs          , Zw          , Uu^Cd       , Yhs          , Yhs          , Yhs          , Zw          , Dd          , Ds          , Md          , Md          , Md^Xm       , Md          , Md^Xm       , Md^Xm       , Md^Xm       , Md^Xm
Md^Xm       , Md^Xm       , Md^Xm       , Md^Xm       , Md          , Md          , Hd          , Ds          , Yhs          , Yhs^Xp       , Zw          , Zw          , Uu^Cd       , Yhs^Xp       , Yhs          , Uu^Cd       , Uu^Cd       , Uu^Cd       , Uu^Cd       , Uu^Cd       , Dd          , Yhs          , Dd^Vdt      , Dd          , Hd          , Md          , Md^Xm       , Md^Xm       , Md^Xm       , Md^Xm       , Md^Xm       , Md^Xm
Md^Xm       , Md^Xm       , Md^Xm       , Md^Xm       , Md          , Md          , Hd          , Hd          , Hd          , Yhs          , Zw          , Zw          , Uu^Cd       , Zw          , Yhs^Xp       , Yhs          , Uu^Cd       , 2 Uu^Kd     , Uu^Cd       , Dd          , Yhs          , Zw          , Hd          , Ds          , Hd          , Md          , Md          , Md^Xm       , Md^Xm       , Md^Xm       , Md^Xm       , Md^Xm
Md^Xm       , Md^Xm       , Md          , Md^Xm       , Md^Xm       , Md          , Md          , Hd          , Hd          , Dd^Vdt      , Ds          , Ds          , Zw          , Zw          , Yhs          , Uu^Cd       , Zw          , Uu^Cd       , Dd          , Uu^Cd       , Dd          , Hd          , Dd          , Hd          , Hd          , Md          , Md^Xm       , Md^Xm       , Md          , Md^Xm       , Md^Xm       , Md^Xm
Md^Xm       , Md          , Md          , Md^Xm       , Md          , Md^Xm       , Md          , Md          , Uu^Cd       , Dd          , Zw          , Zw          , Yhs          , Yhs^Xp       , Zw          , Yhs          , Dd^Vdt      , Uu^Cd       , Dd          , Dd          , Hd          , Hd          , Ds          , Uu^Cd       , Hd          , Hd          , Md          , Md          , Md^Xm       , Md^Xm       , Md^Xm       , Md^Xm
Md^Xm       , Md          , Md          , Md          , Hd          , Md          , Hd          , Uu^Cd       , Uu^Cd       , Dd          , Yhs          , Yhs^Xp       , Yhs          , Zw          , Zw          , Dd          , Dd          , Dd          , Ds          , Ds          , Zw          , Zw          , Zw          , Uu^Cd       , Uu^Cd       , Hd          , Md          , Md          , Md^Xm       , Md^Xm       , Md^Xm       , Md^Xm
Md          , Md          , Hd          , Hd          , Hd          , Hd          , Zw          , Hd          , Uu^Cd       , Uu^Cd       , Uu^Cd       , Zw          , Ds          , Yhs          , Yhs          , Dd          , Uu^Cd       , Uu^Cd       , Zw          , Zw          , Zw          , Yhs          , Yhs^Xp       , Zw          , Ds          , Hd          , Hd          , Md          , Md^Xm       , Md^Xm       , Md^Xm       , Md^Xm
Md          , Md          , Hd          , Hd          , Zw          , Zw          , Zw          , Zw          , Uu^Cd       , Yhs          , Yhs          , Yhs          , Yhs          , Ds          , Ds          , Uu^Cd       , Dd          , Ds          , Yhs          , Yhs^Xp       , Yhs          , Yhs          , Ds          , Ds          , Ds          , Hd          , Md^Xm       , Md^Xm       , Md^Xm       , Md^Xm       , Md^Xm       , Md^Xm
