border_size=1
usage=map

Md^Xm       , Md^Xm       , Md^Xm       , Md^Xm       , Md^Xm       , Md^Xm       , Md^Xm       , Md^Xm       , Md^Xm       , Md^Xm       , Md^Xm       , Md^Xm       , Md^Xm       , Md^Xm       , Md^Xm       , Md          , Md          , Md          , Rd          , Md^Xm       , Md^Xm       , Md^Xm       , Md^Xm       , Md^Xm       , Md^Xm       , Md^Xm       , Md^Xm       , Md^Xm       , Md^Xm       , Md^Xm       , Md^Xm       , Md^Xm       , Md^Xm       , Md^Xm       , Md^Xm       , Md^Xm       , Md^Xm       , Md          , Md^Xm       , Md^Xm       , Md^Xm       , Md          
Md^Xm       , Md^Xm       , Md^Xm       , Md^Xm       , Md^Xm       , Md^Xm       , Md^Xm       , Md^Xm       , Md          , Md^Xm       , Md^Xm       , Md^Xm       , Md^Xm       , Md^Xm       , Md^Xm       , Md          , Hd          , Ds          , Rd          , Md          , Md^Xm       , Md^Xm       , Md^Xm       , Md^Xm       , Md^Xm       , Md^Xm       , Md^Xm       , Md^Xm       , Md^Xm       , Md^Xm       , Md^Xm       , Md^Xm       , Md^Xm       , Md^Xm       , Md^Xm       , Md^Xm       , Md^Xm       , Md^Xm       , Md^Xm       , Md^Xm       , Md^Xm       , Md^Xm       
Md^Xm       , Md^Xm       , Md^Xm       , Md^Xm       , Md^Xm       , Md^Xm       , Md^Xm       , Md          , Md          , Md          , Md          , Md          , Md          , Md^Xm       , Md          , Hd          , Hd          , Ds          , Rd          , Hd          , Md          , Md^Xm       , Md          , Md          , Md          , Md          , Hd          , Md          , Md          , Md          , Md          , Md^Xm       , Md          , Md^Xm       , Md^Xm       , Md^Xm       , Md^Xm       , Md^Xm       , Md^Xm       , Md^Xm       , Md^Xm       , Md^Xm       
Md          , Md^Xm       , Md          , Md^Xm       , Md^Xm       , Md^Xm       , Md          , Md          , Hd          , Hd          , Hd          , Md          , Hd          , Md          , Md          , Md          , Rd          , Rd          , Hd          , Hd          , Md          , Md          , Md          , Md          , Hd          , Hd          , Hd          , Md          , Md          , Md          , Md          , Md          , Md          , Md          , Md          , Md          , Md          , Md^Xm       , Md^Xm       , Md^Xm       , Md^Xm       , Md^Xm       
Md          , Md          , Md          , Md          , Md          , Md          , Md          , Hd          , Md          , Md          , Hd          , Hd          , Yhs          , Hd          , Ds          , Hd          , Rd          , Ds          , Md          , Md          , Md          , Md          , Hd          , Md          , Hd          , Hd          , Zw          , Hd          , Hd          , Hd          , Hd          , Hd          , Hd          , Md          , Hd          , Md          , Md          , Md          , Md^Xm       , Md^Xm       , Md^Xm       , Md^Xm
Md          , Md          , Md          , Md          , Md          , Md          , Md          , Hd          , Hd          , Hd          , Dd          , Yhs^Xp       , Dd          , Hd          , Ds          , Ds          , Ce          , Ce          , Ce          , Dd          , Hd          , Hd          , Hd          , Hd          , Hd          , Zw          , Zw          , Dd          , Zw          , Yhs^Xp       , Re          , Hd          , Hd          , Hd          , Hd          , Hd          , Md          , Md          , Md          , Md^Xm       , Md^Xm       , Md^Xm
Md          , Md          , Md          , Md          , Hd          , Hd          , Dd          , Hd          , Re          , Dd          , Rd          , Rd          , Zw          , Dd^Dc       , Ds          , Ds          , Ce          , 1 Ke        , Ce          , Hd          , Dd          , Yhs^Xp       , Dd          , Hd          , Dd          , Yhs^Xp       , Yhs          , Dd          , Zw          , Re          , Re^Uf       , Yhs          , Uh          , Dd          , Yhs^Xp       , Hd          , Hd          , Md          , Md          , Md^Xm       , Md^Xm       , Md^Xm
Hd          , Hd          , Hd          , Hd          , Zw          , Rd          , Rd          , Re          , Rd          , Rd          , Yhs          , Yhs^Xp       , Dd^Dc       , Zw          , Re          , Ds          , Ds          , Ce          , Ds          , Ds          , Zw          , Zw          , Dd          , Zw          , Zw          , Yhs          , Yhs^Xp       , Yhs          , Zw          , Zw          , Uu^Uf       , Re^Uf       , Yhs          , Yhs          , Yhs          , Dd          , Dd          , Hd          , Hd          , Md          , Md          , Md^Xm
Hd          , Hd          , Uu^Cd       , Uu^Cd       , Zw          , Zw          , Rd          , Re          , Re          , Re          , Rd          , Yhs          , Yhs^Xp       , Re          , Rd          , Rd          , Dd          , Dd^Dc       , Zw          , Zw          , Zw          , Zw          , Yhs          , Yhs^Xp       , Zw          , Zw          , Yhs          , Yhs          , Dd          , Dd          , Uu^Uf       , Uh          , Yhs^Xp       , Yhs          , Dd          , Yhs          , Zw          , Dd          , Hd          , Hd          , Md          , Md
Dd          , Hd          , Hd          , Uu^Cd       , Rd          , Rd          , Hd          , Yhs^Xp       , Re          , Dd          , Dd^Dc       , Rd          , Rd          , Rd          , Dd          , Dd          , Dd          , Zw          , Uh          , Dd          , Dd^Dc       , Dd          , Uh          , Yhs          , Yhs          , Zw          , Dd          , Yhs          , Dd          , Dd          , Dd          , Uu^Uf       , Dd          , Yhs          , Dd          , Yhs^Xp       , Yhs          , Zw          , Hd          , Hd          , Hd          , Md
Zw          , Rd          , Rd          , Yhs^Xp       , Yhs          , Rd          , Hd          , Dd^Dc       , Ds          , Dd          , Rd          , Re          , Rd          , Re          , Dd          , Zw          , Dd          , Dd          , Dd          , Dd          , Dd          , Uh          , Uh          , Yhs          , Zw          , Dd          , Dd          , Dd          , Dd          , Dd          , Zw          , Dd          , Dd          , Dd          , Dd          , Zw          , Yhs^Xp       , Yhs          , Hd          , Hd          , Hd          , Hd
Qxv         , Zw          , Rd          , Yhs          , Yhs^Xp       , Hd          , Hd          , Zw          , Zw          , Ds          , Rd          , Rd          , Rd          , Re          , Zw          , Zw          , Yhs          , Yhs^Xp       , Dd          , Dd          , Ds          , Uh          , Zw          , Zw          , Yhs          , Dd          , Qxv         , Qxv         , Dd          , Zw          , Zw          , Zw          , Dd          , Dd          , Hd          , Zw          , Yhs          , Hd          , Hd          , Hd          , Dd          , Dd
Ds          , Zw          , Dd          , Dd          , Ds          , Hd          , Hd          , Hd          , Dd          , Zw          , Ds          , Hd          , Zw          , Zw          , Dd          , Yhs          , Zw          , Dd          , Dd          , Ds          , Dd          , Ds          , Qxv         , Qxv         , Yhs          , Yhs^Xp       , Qxv         , Qxv         , Uu^Uf       , Dd          , Dd          , Zw          , Dd          , Dd          , Dd          , Hd          , Hd          , Hd          , Dd          , Dd          , Dd          , Dd
Ds          , Ds          , Dd          , Dd          , Dd          , Ds          , Ds          , Dd          , Dd          , Zw          , Ds          , Ds          , Yhs^Xp       , Zw          , Yhs          , Yhs^Xp       , Zw          , Zw          , Dd          , Zw          , Uu^Uf       , Uu^Uf       , Dd          , Qxv         , Dd          , Dd          , Qxv         , Qxv         , Dd          , Dd          , Dd          , Dd          , Dd          , Dd          , Dd          , Hd          , Hd          , Dd          , Dd          , Dd          , Dd          , Dd
Dd          , Dd          , Dd          , Dd          , Zw          , Ds          , Dd          , Dd          , Dd          , Zw          , Zw          , Yhs          , Yhs          , Yhs          , Dd          , Dd          , Dd          , Dd          , Dd          , Zw          , Uh          , Uu^Uf       , Dd          , Dd          , Qxv         , Qxv         , Dd          , Qxv         , Dd          , Dd          , Dd          , Dd          , Rd          , Rd          , Dd          , Dd          , Dd          , Dd          , Dd          , Dd          , Dd          , Dd
Dd          , Dd          , Zw          , Zw          , Dd          , Dd          , Qxv         , Dd          , Re^Uf       , Dd          , Dd          , Dd          , Zw          , Zw          , Dd          , Dd          , Dd          , Dd          , Dd          , Dd          , Dd          , Dd          , Dd          , Dd          , Dd          , Dd          , Dd          , Dd          , Dd          , Dd          , Uu^Uf       , Uu^Uf       , Qxv         , Zw          , Dd          , Dd          , Dd          , Dd          , Zw          , Zw          , Zw          , Dd          
Dd          , Dd          , Zw          , Zw          , Yhs^Xp       , Qxv         , Qxv         , Uu^Uf       , Re^Uf       , Re^Uf       , Dd          , Dd          , Zw          , Zw          , Dd          , Dd          , Dd          , Yhs          , Qxv         , Uu^Uf       , Re^Uf       , Dd          , Dd          , Dd          , Dd          , Dd          , Dd          , Dd          , Zw          , Re^Uf       , Uu^Uf       , Qxv         , Qxv         , Yhs          , Dd          , Dd          , Dd          , Zw          , Re^Uf       , Zw          , Zw          , Dd
Zw          , Zw          , Zw          , Yhs          , Yhs          , Qxv         , Qxv         , Yhs          , Uu^Uf       , Uu^Uf       , Dd          , Zw          , Hd          , Hd          , Dd          , Dd          , Yhs          , Yhs^Xp       , Qxv         , Uu^Uf       , Uu^Uf       , Hd          , Hd          , Dd          , Hd          , Dd          , Dd          , Dd          , Zw          , Re^Uf       , Re^Uf       , Qxv         , Yhs          , Yhs^Xp       , Yhs          , Dd          , Dd          , Zw          , Re^Uf       , Zw          , Yhs^Xp       , Dd
Zw          , Zw          , Ds          , Yhs          , Qxv         , Qxv         , Yhs          , Uu^Cd       , Uu^Cd       , Uu^Cd       , Dd          , Hd          , Hd          , Hd          , Dd          , Dd          , Qxv         , Yhs          , Qxv         , Qxv         , Re^Uf       , Re^Uf       , Hd          , Hd          , Dd          , Dd          , Dd          , Dd          , Zw          , Zw          , Ds          , Zw          , Zw          , Yhs          , Yhs^Xp       , Dd          , Yhs^Xp       , Re^Uf       , Uu^Uf       , Re^Uf       , Dd          , Dd
Ds          , Dd          , Hd          , Dd          , Ds          , Qxv         , Dd          , Uu^Cd       , Ds          , Ds          , Ds          , Hd          , Hd          , Dd          , Qxv         , Qxv         , Qxv         , Qxv         , Qxv         , Qxv         , Re^Uf       , Zw          , Zw          , Hd          , Zw          , Zw          , Ds          , Dd          , Dd          , Zw          , Dd          , Dd          , Zw          , Zw          , Uu^Cd       , Uu^Cd       , Yhs^Xp       , Uu^Uf       , Yhs^Xp       , Uu^Uf       , Qxv         , Dd
Dd          , Dd          , Hd          , Hd          , Ds          , Ds          , Dd          , Zw          , Zw          , Dd          , Ds          , Dd          , Dd          , Dd          , Qxv         , Qxv         , Yhs^Xp       , Yhs          , Qxv         , Qxv         , Dd          , Zw          , Zw          , Hd          , Zw          , Zw          , Ds          , Dd          , Dd          , Dd          , Dd          , Dd          , Dd          , Zw          , Zw          , Uu^Cd       , Rd          , Yhs          , Yhs          , Qxv         , Qxv         , Dd
Ds          , Dd          , Hd          , Hd          , Hd          , Dd          , Qxv         , Zw          , Zw          , Zw          , Ds          , Dd          , Qxv         , Qxv         , Qxv         , Yhs          , Yhs          , Yhs          , Yhs          , Qxv         , Dd          , Dd          , Hd          , Dd          , Ds          , Ds          , Dd          , Dd          , Qxv         , Qxv         , Ds          , Ds          , Ds          , Dd          , Dd          , Dd          , Zw          , Zw          , Dd          , Yhs^Xp       , Dd          , Dd
Dd          , Ds          , Dd          , Hd          , Dd          , Dd          , Qxv         , Yhs          , Yhs^Xp       , Yhs          , Hd          , Ds          , Dd          , Qxv         , Dd          , Ds          , Zw          , Ds          , Yhs          , Qxv         , Dd          , Hd          , Hd          , Dd          , Dd          , Dd          , Re^Uf       , Yhs          , Yhs          , Qxv         , Yhs          , Zw          , Zw          , Dd          , Dd          , Hd          , Dd          , Zw          , Rd          , Rd          , Zw          , Dd
Dd          , Zw          , Zw          , Dd          , Zw          , Dd          , Qxv         , Qxv         , Yhs          , Yhs          , Hd          , Hd          , Dd          , Dd          , Dd          , Zw          , Zw          , Ds          , Yhs          , Yhs          , Dd          , Dd          , Hd          , Hd          , Hd          , Dd          , Re^Uf       , Yhs^Xp       , Yhs          , Qxv         , Yhs          , Yhs^Xp       , Re^Uf       , Zw          , Hd          , Hd          , Dd          , Zw          , Rd          , Zw          , Zw          , Dd
Dd          , Dd          , Zw          , Zw          , Zw          , Dd          , Dd          , Dd          , Dd          , Hd          , Dd          , Zw          , Dd          , Uu^Cd       , Uu^Cd       , Zw          , Zw          , Zw          , Ds          , Ds          , Dd          , Dd          , Dd          , Hd          , Uu^Cd       , Uu^Cd       , Uu^Cd       , Re^Uf       , Yhs          , Yhs          , Yhs^Xp       , Re^Uf       , Dd          , Hd          , Dd          , Hd          , Hd          , Rd          , Dd          , Rd          , Dd          , Zw
Dd          , Dd          , Re^Uf       , Uu^Uf       , Re^Uf       , Zw          , Zw          , Dd          , Dd          , Dd          , Dd          , Dd          , Dd          , Uu^Cd       , Dd          , Dd          , Dd          , Dd          , Dd          , Dd          , Dd          , Dd          , Hd          , Uu^Cd       , Uu^Kd       , Uu^Cd       , Qxv         , Yhs          , Yhs          , Yhs          , Zw          , Dd          , Dd          , Hd          , Dd          , Dd          , Hd          , Rd          , Zw          , Dd          , Dd          , Dd
Dd          , Dd          , Uu^Uf       , Re^Uf       , Yhs          , Re^Uf       , Dd          , Dd          , Dd          , Dd          , Qxv         , Dd          , Qxv         , Hd          , Hd          , Dd          , Ds          , Dd          , Zw          , Dd          , Dd          , Dd          , Dd          , Uu^Cd       , Uu^Cd       , Qxv         , Uu^Cd       , Yhs          , Yhs          , Zw          , Zw          , Dd          , Dd          , Dd          , Zw          , Hd          , Dd          , Hd          , Dd          , Uu^Cd       , Uu^Cd       , Dd
Dd          , Dd          , Qxv         , Yhs          , Yhs^Xp       , Ds          , Dd          , Dd          , Dd          , Dd          , Dd          , Qxv         , Qxv         , Qxv         , Hd          , Hd          , Yhs          , Ds          , Ds          , Dd          , Zw          , Dd          , Dd          , Hd          , Dd          , Qxv         , Yhs          , Yhs          , Dd          , Dd          , Dd          , Dd          , Zw          , Zw          , Yhs          , Zw          , Dd          , Dd          , Dd          , Dd          , Zw          , Zw
Qxv         , Dd          , Qxv         , Ds          , Ds          , Ds          , Zw          , Dd          , Dd          , Dd          , Dd          , Qxv         , Qxv         , Dd          , Re^Uf       , Hd          , Yhs          , Yhs^Xp       , Ds          , Zw          , Zw          , Zw          , Ds          , Ds          , Ds          , Dd          , Dd          , Dd          , Dd          , Dd          , Dd          , Dd          , Re^Uf       , Zw          , Yhs          , Yhs^Xp       , Dd          , Dd          , Dd          , Dd          , Zw          , Zw
Qxv         , Qxv         , Dd          , Dd          , Ds          , Zw          , Zw          , Zw          , Ds          , Ds          , Re^Uf       , Dd          , Dd          , Re^Uf       , Uu^Uf       , Yhs          , Dd          , Dd          , Dd          , Ds          , Ds          , Ds          , Yhs          , Yhs          , Ds          , Ds          , Dd          , Dd          , Dd          , Zw          , Zw          , Dd          , Dd          , Re^Uf       , Dd          , Dd          , Qxv         , Dd          , Dd          , Qxv         , Dd          , Zw
Dd          , Qxv         , Hd          , Hd          , Hd          , Zw          , Ds          , Ds          , Ds          , Yhs^Xp       , Uu^Uf       , Re^Uf       , Dd          , Uu^Cd       , Uu^Uf       , Yhs          , Re^Uf       , Re^Uf       , Qxv         , Qxv         , Ds          , Yhs          , Ds          , Ds          , Zw          , Zw          , Dd          , Dd          , Dd          , Zw          , Yhs          , Dd          , Dd          , Re^Uf       , Dd          , Dd          , Qxv         , Qxv         , Qxv         , Qxv         , Rd          , Dd
Dd          , Dd          , Hd          , Hd          , Uu^Cd       , Dd          , Dd          , Dd          , Qxv         , Uu^Uf       , Yhs          , Re^Uf       , Re^Uf       , Dd          , Dd          , Uu^Uf       , Uu^Uf       , Uu^Cd       , Qxv         , Qxv         , Dd          , Hd          , Dd          , Dd          , Dd          , Dd          , Dd          , Dd          , Zw          , Dd          , Dd          , Yhs^Xp       , Yhs          , Uu^Cd       , Uu^Cd       , Dd          , Dd          , Qxv         , Qxv         , Qxv         , Rd          , Dd
Ds          , Dd          , Hd          , Uu^Cd       , Dd          , Dd          , Dd          , Dd          , Qxv         , Qxv         , Dd          , Dd          , Dd          , Zw          , Re^Uf       , Uu^Uf       , Uu^Cd       , Uu^Cd       , Dd          , Qxv         , Qxv         , Hd          , Hd          , Dd          , Dd          , Dd          , Dd          , Zw          , Dd          , Dd          , Dd          , Yhs          , Dd          , Uu^Cd       , Zw          , Dd          , Dd          , Dd          , Qxv         , Qxv         , Dd          , Dd
Zw          , Ds          , Zw          , Hd          , Dd          , Dd          , Yhs^Xp       , Dd          , Dd          , Dd          , Dd          , Zw          , Zw          , Zw          , Uu^Uf       , Uu^Uf       , Uu^Uf       , Dd          , Dd          , Qxv         , Qxv         , Qxv         , Qxv         , Uu^Cd       , Uu^Cd       , Dd          , Yhs          , Zw          , Dd          , Dd          , Dd          , Dd          , Dd          , Dd          , Uh          , Hd          , Hd          , Hd          , Dd          , Qxv         , Hd          , Hd
Yhs          , Zw          , Zw          , Dd          , Dd          , Dd          , Yhs          , Yhs          , Dd          , Dd          , Dd          , Zw          , Zw          , Zw          , Re^Uf       , Yhs^Xp       , Yhs          , Uu^Uf       , Dd          , Dd          , Dd          , Dd          , Dd          , Uu^Cd       , Yhs^Xp       , Uh          , Yhs^Xp       , Zw          , Dd          , Dd          , Dd          , Dd          , Zw          , Dd          , Dd          , Hd          , Md          , Hd          , Hd          , Hd          , Hd          , Md
Yhs          , Yhs          , Zw          , Dd          , Ds          , Ds          , Zw          , Yhs          , Uu^Cd       , Dd          , Hd          , Dd          , Zw          , Zw          , Hd          , Re^Uf       , Yhs          , Yhs^Xp       , Hd          , Hd          , Dd          , Dd          , Dd          , Yhs          , Yhs          , Zw          , Yhs          , Dd          , Hd          , Dd          , Dd          , Dd          , Zw          , Zw          , Dd          , Hd          , Hd          , Md          , Md          , Hd          , Md          , Md
Dd          , Yhs          , Yhs^Xp       , Dd          , Ds          , Yhs          , Yhs^Xp       , Zw          , Zw          , Dd          , Hd          , Hd          , Dd          , Zw          , Hd          , Yhs^Xp       , Yhs          , Yhs          , Hd          , Zw          , Dd          , Dd          , Dd          , Zw          , Uh          , Yhs^Xp       , Zw          , Hd          , Zw          , Dd          , Dd          , Dd          , Dd          , Zw          , Dd          , Hd          , Hd          , Md          , Md          , Md          , Xu          , Xu
Zw          , Yhs          , Yhs          , Dd          , Ds          , Yhs          , Dd          , Yhs          , Zw          , Dd          , Dd          , Dd          , Dd          , Hd          , Dd          , Hd          , Yhs          , Hd          , Yhs          , Zw          , Dd          , Dd          , Hd          , Uh          , Uh          , Zw          , Zw          , Zw          , Dd          , Zw          , Dd          , Dd          , Dd          , Hd          , Hd          , Hd          , Hd          , Md          , Xu          , Xu          , Xu          , Xu
Dd          , Zw          , Dd          , Yhs          , Ds          , Uu^Cd       , Hd          , Dd          , Hd          , Uu^Cd       , Zw          , Dd          , Dd          , Dd          , Dd          , Dd          , Dd          , Yhs^Xp       , Yhs          , Hd          , Dd          , Dd          , Hd          , Uh          , Hd          , Dd          , Dd          , Dd          , Dd          , Dd          , Hd          , Hd          , Hd          , Hd          , Md          , Hd          , Rd          , Xu          , Xu          , Xu          , Xu          , Xu
Hd          , Dd          , Dd          , Ds          , Hd          , Dd          , Ds          , Hd          , Hd          , Zw          , Uh          , Zw          , Re^Uf       , Dd          , Dd          , Dd          , Dd          , Dd          , Dd          , Hd          , Hd          , Dd          , Hd          , Hd          , Hd          , Yhs^Xp       , Dd          , Dd          , Dd          , Hd          , Md          , Md          , Md          , Md          , Xu          , Xu          , Uu          , Rd          , Rd          , Uu^Uf       , Uu^Uf       , Xu
Zw          , Hd          , Hd          , Dd          , Hd          , Ds          , Yhs^Xp       , Ds          , Dd          , Hd          , Dd          , Uh          , Dd          , Re^Uf       , Dd          , Dd          , Dd          , Dd          , Dd          , Hd          , Yhs          , Dd          , Dd          , Hd          , Dd          , Yhs          , Yhs^Xp       , Dd          , Hd          , Hd          , Md          , Md          , Xu          , Xu          , Xu          , Xu          , Uh          , Uu^Uf       , Uu          , Rd          , Rd          , Uh
Zw          , Zw          , Yhs^Xp       , Hd          , Yhs          , Yhs          , Ds          , Ds          , Dd          , Dd          , Dd          , Dd          , Hd          , Hd          , Hd          , Hd          , Hd          , Dd          , Dd          , Dd          , Yhs          , Yhs^Xp       , Yhs^Xp       , Yhs          , Yhs          , Yhs          , Hd          , Hd          , Md          , Md          , Xu          , Xu          , Xu          , Xu          , Xu          , Xu          , Xu          , Xu          , Xu          , Uh          , Uh          , Rd
