border_size=1
usage=map

Md^Xm       , Md^Xm       , Md^Xm       , Md^Xm       , Md^Xm       , Md^Xm       , Md^Xm       , Md^Xm       , Md^Xm       , Md^Xm       , Md^Xm       , Md^Xm       , Md^Xm       , Md^Xm       , Md^Xm       , Md          , Md          , Md          , Rd          , Md^Xm       , Md^Xm       , Md^Xm       , Md^Xm       , Md^Xm       , Md^Xm       , Md^Xm       , Md^Xm       , Md^Xm       , Md^Xm       , Md^Xm       , Md^Xm       , Md^Xm       , Md^Xm       , Md^Xm       , Md^Xm       , Md^Xm       , Md^Xm       , Md          , Md^Xm       , Md^Xm       , Md^Xm       , Md          
Md^Xm       , Md^Xm       , Md^Xm       , Md^Xm       , Md^Xm       , Md^Xm       , Md^Xm       , Md^Xm       , Md          , Md^Xm       , Md^Xm       , Md^Xm       , Md^Xm       , Md^Xm       , Md^Xm       , Md          , Hd          , Ds          , Rd          , Md          , Md^Xm       , Md^Xm       , Md^Xm       , Md^Xm       , Md^Xm       , Md^Xm       , Md^Xm       , Md^Xm       , Md^Xm       , Md^Xm       , Md^Xm       , Md^Xm       , Md^Xm       , Md^Xm       , Md^Xm       , Md^Xm       , Md^Xm       , Md^Xm       , Md^Xm       , Md^Xm       , Md^Xm       , Md^Xm       
Md^Xm       , Md^Xm       , Md^Xm       , Md^Xm       , Md^Xm       , Md^Xm       , Md^Xm       , Md          , Md          , Md          , Md          , Md          , Md          , Md^Xm       , Md          , Hd          , Hd          , Ds          , Rd          , Hd          , Md          , Md^Xm       , Md          , Md          , Md          , Md          , Hd          , Md          , Md          , Md          , Md          , Md^Xm       , Md          , Md^Xm       , Md^Xm       , Md^Xm       , Md^Xm       , Md^Xm       , Md^Xm       , Md^Xm       , Md^Xm       , Md^Xm       
Md          , Md^Xm       , Md          , Md^Xm       , Md^Xm       , Md^Xm       , Md          , Md          , Hd          , Hd          , Hd          , Md          , Hd          , Md          , Md          , Md          , Rd          , Rd          , Hd          , Hd          , Md          , Md          , Md          , Md          , Hd          , Hd          , Hd          , Md          , Md          , Md          , Md          , Md          , Md          , Md          , Md          , Md          , Md          , Md^Xm       , Md^Xm       , Md^Xm       , Md^Xm       , Md^Xm       
Md          , Md          , Md          , Md          , Md          , Md          , Md          , Hd          , Md          , Md          , Hd          , Hd          , Yhs         , Hd          , Ds          , Hd          , Rd          , Ds          , Md          , Md          , Md          , Md          , Hd          , Md          , Hd          , Hd          , Uzw         , Hd          , Hd          , Hd          , Hd          , Hd          , Hd          , Md          , Hd          , Md          , Md          , Md          , Md^Xm       , Md^Xm       , Md^Xm       , Md^Xm       
Md          , Md          , Md          , Md          , Md          , Md          , Md          , Hd          , Hd          , Hd          , Dd          , Yhs^Xp      , Dd          , Hd          , Ds          , Ds          , Ce          , Ce          , Ce          , Dd          , Hd          , Hd          , Hd          , Hd          , Hd          , Uzw         , Uzw         , Dd          , Uzw         , Yhs^Xp      , Re          , Hd          , Hd          , Hd          , Hd          , Hd          , Md          , Md          , Md          , Md^Xm       , Md^Xm       , Md^Xm       
Md          , Md          , Md          , Md          , Hd          , Hd          , Dd^Esd      , Hd          , Re          , Dd          , Rd          , Rd          , Uzw         , Dd^Dc       , Ds          , Ds          , Ce          , 1 Ke        , Ce          , Hd          , Dd          , Yhs^Xp      , Dd          , Hd          , Dd          , Yhs^Xp      , Yhs         , Dd          , Uzw         , Re          , Re^Uf       , Yhs         , Uh^Dr       , Dd          , Yhs^Xp      , Hd          , Hd          , Md          , Md          , Md^Xm       , Md^Xm       , Md^Xm       
Hd          , Hd          , Hd          , Hd          , Uzw         , Rd          , Rd          , Re          , Rd          , Rd          , Yhs         , Yhs^Xp      , Dd^Dc       , Uzw         , Re          , Ds          , Ds          , Ce          , Ds          , Ds          , Uzw         , Uzw         , Dd          , Uzw         , Uzw         , Yhs         , Yhs^Xp      , Yhs         , Uzw         , Uzw         , Uu^Uf       , Re^Uf       , Yhs         , Yhs         , Yhs         , Dd          , Dd          , Hd          , Hd          , Md          , Md          , Md^Xm       
Hd          , Hd          , Uu^Cd       , Uu^Cd       , Uzw         , Uzw         , Rd          , Re          , Re          , Re          , Rd          , Yhs         , Yhs^Xp      , Re          , Rd          , Rd          , Dd          , Dd^Dc       , Uzw         , Uzw         , Uzw         , Uzw         , Yhs         , Yhs^Xp      , Uzw         , Uzw         , Yhs         , Yhs         , Dd          , Dd          , Uu^Uf       , Uh          , Yhs^Xp      , Yhs         , Dd          , Yhs         , Uzw         , Dd          , Hd          , Hd          , Md          , Md          
Dd          , Hd          , Hd          , Uu^Cd       , Rd          , Rd          , Hd          , Yhs^Xp      , Re          , Dd          , Dd^Dc       , Rd          , Rd          , Rd          , Dd          , Dd          , Dd          , Uzw         , Uh          , Dd          , Dd^Dc       , Dd          , Uh          , Yhs         , Yhs         , Uzw         , Dd          , Yhs         , Dd          , Dd          , Dd          , Uu^Uf       , Dd          , Yhs         , Dd          , Yhs^Xp      , Yhs         , Uzw         , Hd          , Hd          , Hd          , Md          
Uzw         , Rd          , Rd          , Yhs^Xp      , Yhs         , Rd          , Hd          , Dd^Dc       , Ds          , Dd          , Rd^Esd      , Re          , Rd          , Re          , Dd          , Uzw         , Dd          , Dd          , Dd          , Dd          , Dd          , Uh^Dr       , Uh          , Yhs         , Uzw         , Dd          , Dd          , Dd          , Dd          , Dd          , Uzw         , Dd          , Dd          , Dd^Esd      , Dd          , Uzw         , Yhs^Xp      , Yhs         , Hd          , Hd          , Hd          , Hd          
Qxv         , Uzw         , Rd          , Yhs         , Yhs^Xp      , Hd          , Hd          , Uzw         , Uzw         , Ds          , Rd          , Rd          , Rd          , Re          , Uzw         , Uzw         , Yhs         , Yhs^Xp      , Dd          , Dd          , Ds          , Uh          , Uzw         , Uzw         , Yhs         , Dd          , Qxv         , Qxv         , Dd          , Uzw         , Uzw         , Uzw         , Dd          , Dd          , Hd          , Uzw         , Yhs         , Hd          , Hd          , Hd          , Dd          , Dd          
Ds          , Uzw         , Dd          , Dd          , Ds          , Hd          , Hd          , Hd^Dr       , Dd          , Uzw         , Ds          , Hd          , Uzw         , Uzw         , Dd          , Yhs         , Uzw         , Dd          , Dd          , Ds          , Dd          , Ds          , Qxv         , Qxv         , Yhs         , Yhs^Xp      , Qxv         , Qxv         , Uu^Uf       , Dd          , Dd          , Uzw         , Dd          , Dd          , Dd          , Hd          , Hd          , Hd          , Dd          , Dd          , Dd          , Dd          
Ds          , Ds^Esd      , Dd          , Dd          , Dd          , Ds          , Ds          , Dd          , Dd          , Uzw         , Ds          , Ds          , Yhs^Xp      , Uzw         , Yhs         , Yhs^Xp      , Uzw         , Uzw         , Dd          , Uzw         , Uu^Uf       , Uu^Uf       , Dd          , Qxv         , Dd          , Dd          , Qxv         , Qxv         , Dd          , Dd          , Dd^Esd      , Dd          , Dd          , Dd          , Dd          , Hd          , Hd          , Dd          , Dd          , Dd          , Dd          , Dd          
Dd          , Dd          , Dd          , Dd          , Uzw         , Ds          , Dd          , Dd          , Dd          , Uzw         , Uzw         , Yhs         , Yhs         , Yhs         , Dd          , Dd          , Dd          , Dd          , Dd          , Uzw         , Uh          , Uu^Uf       , Dd          , Dd          , Qxv         , Qxv         , Dd          , Qxv         , Dd          , Dd          , Dd          , Dd          , Rd          , Rd          , Dd          , Dd          , Dd          , Dd          , Dd          , Dd          , Dd          , Dd          
Dd          , Dd          , Uzw         , Uzw         , Dd          , Dd          , Qxv         , Dd          , Re^Uf       , Dd          , Dd          , Dd          , Uzw         , Uzw         , Dd^Es       , Dd          , Dd          , Dd          , Dd          , Dd          , Dd          , Dd          , Dd          , Dd          , Dd          , Dd          , Dd          , Dd          , Dd          , Dd          , Uu^Uf       , Uu^Uf       , Qxv         , Uzw         , Dd          , Dd          , Dd          , Dd          , Uzw         , Uzw         , Uzw         , Dd          
Dd          , Dd          , Uzw         , Uzw         , Yhs^Xp      , Qxv         , Qxv         , Uu^Uf       , Re^Uf       , Re^Uf       , Dd          , Dd          , Uzw         , Uzw         , Dd          , Dd          , Dd          , Yhs         , Qxv         , Uu^Uf       , Re^Uf       , Dd          , Dd          , Dd          , Dd          , Dd^Es       , Dd          , Dd          , Uzw         , Re^Uf       , Uu^Uf       , Qxv         , Qxv         , Yhs         , Dd          , Dd          , Dd          , Uzw         , Re^Uf       , Uzw         , Uzw         , Dd          
Uzw         , Uzw         , Uzw         , Yhs         , Yhs         , Qxv         , Qxv         , Yhs         , Uu^Uf       , Uu^Uf       , Dd          , Uzw         , Hd          , Hd          , Dd          , Dd          , Yhs         , Yhs^Xp      , Qxv         , Uu^Uf       , Uu^Uf       , Hd          , Hd          , Dd          , Hd          , Dd          , Dd          , Dd          , Uzw         , Re^Uf       , Re^Uf       , Qxv         , Yhs         , Yhs^Xp      , Yhs         , Dd          , Dd          , Uzw         , Re^Uf       , Uzw         , Yhs^Xp      , Dd          
Uzw         , Uzw         , Ds          , Yhs         , Qxv         , Qxv         , Yhs         , Uu^Cd       , Uu^Cd       , Uu^Cd       , Dd          , Hd          , Hd^Esd      , Hd          , Dd          , Dd          , Qxv         , Yhs         , Qxv         , Qxv         , Re^Uf       , Re^Uf       , Hd          , Hd          , Dd          , Dd          , Dd          , Dd          , Uzw         , Uzw         , Ds          , Uzw         , Uzw         , Yhs         , Yhs^Xp      , Dd          , Yhs^Xp      , Re^Uf       , Uu^Uf       , Re^Uf       , Dd          , Dd          
Ds          , Dd          , Hd          , Dd          , Ds          , Qxv         , Dd          , Uu^Cd       , Ds          , Ds          , Ds          , Hd          , Hd          , Dd          , Qxv         , Qxv         , Qxv         , Qxv         , Qxv         , Qxv         , Re^Uf       , Uzw         , Uzw         , Hd          , Uzw         , Uzw         , Ds^Esd      , Dd          , Dd          , Uzw         , Dd          , Dd          , Uzw         , Uzw         , Uu^Cd       , Uu^Cd       , Yhs^Xp      , Uu^Uf       , Yhs^Xp      , Uu^Uf       , Qxv         , Dd          
Dd          , Dd          , Hd          , Hd          , Ds          , Ds          , Dd          , Uzw         , Uzw         , Dd          , Ds          , Dd          , Dd          , Dd          , Qxv         , Qxv         , Yhs^Xp      , Yhs         , Qxv         , Qxv         , Dd          , Uzw         , Uzw         , Hd          , Uzw^Es      , Uzw         , Ds          , Dd          , Dd          , Dd          , Dd          , Dd          , Dd          , Uzw         , Uzw         , Uu^Cd       , Rd          , Yhs         , Yhs         , Qxv         , Qxv         , Dd          
Ds          , Dd          , Hd          , Hd          , Hd^Dr       , Dd          , Qxv         , Uzw         , Uzw         , Uzw         , Ds          , Dd          , Qxv         , Qxv         , Qxv         , Yhs         , Yhs         , Yhs         , Yhs         , Qxv         , Dd          , Dd          , Hd          , Dd          , Ds          , Ds          , Dd          , Dd          , Qxv         , Qxv         , Ds          , Ds          , Ds          , Dd          , Dd          , Dd          , Uzw         , Uzw         , Dd          , Yhs^Xp      , Dd          , Dd          
Dd          , Ds          , Dd          , Hd          , Dd          , Dd          , Qxv         , Yhs         , Yhs^Xp      , Yhs         , Hd          , Ds          , Dd          , Qxv         , Dd          , Ds          , Uzw         , Ds          , Yhs         , Qxv         , Dd          , Hd          , Hd          , Dd          , Dd          , Dd          , Re^Uf       , Yhs         , Yhs         , Qxv         , Yhs         , Uzw         , Uzw         , Dd          , Dd          , Hd          , Dd          , Uzw         , Rd^Es       , Rd          , Uzw         , Dd          
Dd          , Uzw         , Uzw         , Dd          , Uzw         , Dd          , Qxv         , Qxv         , Yhs         , Yhs         , Hd          , Hd          , Dd          , Dd          , Dd          , Uzw         , Uzw         , Ds          , Yhs         , Yhs         , Dd          , Dd          , Hd          , Hd          , Hd          , Dd          , Re^Uf       , Yhs^Xp      , Yhs         , Qxv         , Yhs         , Yhs^Xp      , Re^Uf       , Uzw         , Hd          , Hd          , Dd          , Uzw         , Rd          , Uzw         , Uzw         , Dd          
Dd          , Dd          , Uzw         , Uzw         , Uzw         , Dd          , Dd          , Dd          , Dd          , Hd          , Dd          , Uzw         , Dd          , Uu^Cd       , Uu^Cd       , Uzw         , Uzw         , Uzw         , Ds          , Ds^Dr       , Dd          , Dd          , Dd          , Hd          , Uu^Cd       , Uu^Cd       , Uu^Cd       , Re^Uf       , Yhs         , Yhs         , Yhs^Xp      , Re^Uf       , Dd          , Hd          , Dd          , Hd          , Hd          , Rd          , Dd          , Rd          , Dd          , Uzw         
Dd          , Dd          , Re^Uf       , Uu^Uf       , Re^Uf       , Uzw         , Uzw         , Dd          , Dd          , Dd          , Dd          , Dd          , Dd          , Uu^Cd       , Dd          , Dd          , Dd          , Dd^Esd      , Dd          , Dd          , Dd          , Dd          , Hd          , Uu^Cd       , Uu^Kd       , Uu^Cd       , Qxv         , Yhs         , Yhs         , Yhs         , Uzw         , Dd          , Dd          , Hd          , Dd          , Dd          , Hd          , Rd          , Uzw         , Dd          , Dd          , Dd          
Dd          , Dd          , Uu^Uf       , Re^Uf       , Yhs         , Re^Uf       , Dd          , Dd          , Dd          , Dd          , Qxv         , Dd          , Qxv         , Hd          , Hd^Dr       , Dd          , Ds          , Dd          , Uzw         , Dd          , Dd          , Dd          , Dd          , Uu^Cd       , Uu^Cd       , Qxv         , Uu^Cd       , Yhs         , Yhs         , Uzw         , Uzw         , Dd          , Dd          , Dd          , Uzw         , Hd          , Dd          , Hd          , Dd          , Uu^Cd       , Uu^Cd       , Dd          
Dd          , Dd          , Qxv         , Yhs         , Yhs^Xp      , Ds          , Dd          , Dd          , Dd          , Dd          , Dd          , Qxv         , Qxv         , Qxv         , Hd          , Hd          , Yhs         , Ds          , Ds          , Dd          , Uzw         , Dd          , Dd          , Hd          , Dd          , Qxv         , Yhs         , Yhs         , Dd          , Dd          , Dd          , Dd          , Uzw         , Uzw         , Yhs         , Uzw         , Dd          , Dd          , Dd          , Dd          , Uzw         , Uzw         
Qxv         , Dd          , Qxv         , Ds          , Ds          , Ds          , Uzw         , Dd          , Dd          , Dd          , Dd          , Qxv         , Qxv         , Dd          , Re^Uf       , Hd          , Yhs         , Yhs^Xp      , Ds          , Uzw         , Uzw         , Uzw         , Ds          , Ds          , Ds          , Dd          , Dd          , Dd          , Dd          , Dd^Esd      , Dd          , Dd          , Re^Uf       , Uzw         , Yhs         , Yhs^Xp      , Dd          , Dd          , Dd          , Dd          , Uzw         , Uzw         
Qxv         , Qxv         , Dd          , Dd          , Ds          , Uzw         , Uzw         , Uzw         , Ds          , Ds          , Re^Uf       , Dd          , Dd          , Re^Uf       , Uu^Uf       , Yhs         , Dd          , Dd          , Dd          , Ds          , Ds          , Ds          , Yhs         , Yhs         , Ds          , Ds          , Dd          , Dd          , Dd          , Uzw         , Uzw         , Dd          , Dd          , Re^Uf       , Dd          , Dd          , Qxv         , Dd          , Dd          , Qxv         , Dd          , Uzw         
Dd          , Qxv         , Hd          , Hd          , Hd          , Uzw         , Ds          , Ds          , Ds          , Yhs^Xp      , Uu^Uf       , Re^Uf       , Dd          , Uu^Cd       , Uu^Uf       , Yhs         , Re^Uf       , Re^Uf       , Qxv         , Qxv         , Ds          , Yhs         , Ds          , Ds          , Uzw         , Uzw         , Dd          , Dd^Dr       , Dd          , Uzw         , Yhs         , Dd          , Dd          , Re^Uf       , Dd          , Dd          , Qxv         , Qxv         , Qxv         , Qxv         , Rd          , Dd          
Dd          , Dd          , Hd          , Hd          , Uu^Cd       , Dd          , Dd          , Dd          , Qxv         , Uu^Uf       , Yhs         , Re^Uf       , Re^Uf       , Dd          , Dd          , Uu^Uf       , Uu^Uf       , Uu^Cd       , Qxv         , Qxv         , Dd          , Hd          , Dd          , Dd          , Dd          , Dd          , Dd          , Dd          , Uzw         , Dd          , Dd          , Yhs^Xp      , Yhs         , Uu^Cd       , Uu^Cd       , Dd          , Dd          , Qxv         , Qxv         , Qxv         , Rd          , Dd          
Ds          , Dd          , Hd          , Uu^Cd       , Dd          , Dd          , Dd          , Dd          , Qxv         , Qxv         , Dd          , Dd          , Dd          , Uzw         , Re^Uf       , Uu^Uf       , Uu^Cd       , Uu^Cd       , Dd^Dr       , Qxv         , Qxv         , Hd          , Hd          , Dd          , Dd          , Dd          , Dd          , Uzw         , Dd          , Dd          , Dd          , Yhs         , Dd          , Uu^Cd       , Uzw         , Dd          , Dd          , Dd^Es       , Qxv         , Qxv         , Dd          , Dd          
Uzw         , Ds          , Uzw         , Hd          , Dd          , Dd          , Yhs^Xp      , Dd          , Dd          , Dd          , Dd          , Uzw         , Uzw         , Uzw         , Uu^Uf       , Uu^Uf       , Uu^Uf       , Dd          , Dd          , Qxv         , Qxv         , Qxv         , Qxv         , Uu^Cd       , Uu^Cd       , Dd          , Yhs         , Uzw         , Dd          , Dd          , Dd          , Dd          , Dd          , Dd          , Uh          , Hd          , Hd          , Hd^Dr       , Dd          , Qxv         , Hd          , Hd          
Yhs         , Uzw         , Uzw         , Dd          , Dd^Es       , Dd          , Yhs         , Yhs         , Dd          , Dd          , Dd          , Uzw         , Uzw         , Uzw         , Re^Uf       , Yhs^Xp      , Yhs         , Uu^Uf       , Dd          , Dd          , Dd          , Dd          , Dd          , Uu^Cd       , Yhs^Xp      , Uh          , Yhs^Xp      , Uzw         , Dd          , Dd          , Dd          , Dd          , Uzw         , Dd          , Dd          , Hd          , Md          , Hd          , Hd          , Hd          , Hd          , Md          
Yhs         , Yhs         , Uzw         , Dd          , Ds          , Ds          , Uzw         , Yhs         , Uu^Cd       , Dd          , Hd          , Dd          , Uzw         , Uzw         , Hd          , Re^Uf       , Yhs         , Yhs^Xp      , Hd          , Hd          , Dd          , Dd          , Dd          , Yhs         , Yhs         , Uzw         , Yhs         , Dd          , Hd          , Dd^Esd      , Dd          , Dd          , Uzw         , Uzw         , Dd          , Hd          , Hd          , Md          , Md          , Hd          , Md          , Md          
Dd          , Yhs         , Yhs^Xp      , Dd          , Ds          , Yhs         , Yhs^Xp      , Uzw         , Uzw         , Dd          , Hd          , Hd          , Dd          , Uzw         , Hd          , Yhs^Xp      , Yhs         , Yhs         , Hd          , Uzw         , Dd          , Dd          , Dd          , Uzw         , Uh^Dr       , Yhs^Xp      , Uzw         , Hd          , Uzw         , Dd          , Dd          , Dd          , Dd          , Uzw         , Dd          , Hd          , Hd          , Md          , Md          , Md          , Xu          , Xu          
Uzw         , Yhs         , Yhs         , Dd          , Ds          , Yhs         , Dd          , Yhs         , Uzw         , Dd          , Dd          , Dd          , Dd          , Hd          , Dd          , Hd          , Yhs         , Hd          , Yhs         , Uzw         , Dd          , Dd          , Hd          , Uh          , Uh          , Uzw         , Uzw         , Uzw         , Dd          , Uzw         , Dd          , Dd          , Dd          , Hd          , Hd          , Hd          , Hd          , Md          , Xu          , Xu          , Xu          , Xu          
Dd          , Uzw         , Dd          , Yhs         , Ds          , Uu^Cd       , Hd          , Dd          , Hd          , Uu^Cd       , Uzw         , Dd          , Dd          , Dd          , Dd^Es       , Dd          , Dd          , Yhs^Xp      , Yhs         , Hd          , Dd          , Dd          , Hd          , Uh          , Hd          , Dd          , Dd          , Dd          , Dd          , Dd          , Hd          , Hd          , Hd          , Hd          , Md          , Hd          , Rd          , Xu          , Xu          , Xu          , Xu          , Xu          
Hd          , Dd          , Dd          , Ds          , Hd          , Dd          , Ds          , Hd          , Hd          , Uzw         , Uh          , Uzw         , Re^Uf       , Dd          , Dd          , Dd          , Dd          , Dd          , Dd          , Hd          , Hd          , Dd          , Hd          , Hd^Esd      , Hd          , Yhs^Xp      , Dd          , Dd          , Dd          , Hd          , Md          , Md          , Md          , Md          , Xu          , Xu          , Uu          , Rd          , Rd          , Uu^Uf       , Uu^Uf       , Xu          
Uzw         , Hd          , Hd          , Dd          , Hd          , Ds          , Yhs^Xp      , Ds          , Dd          , Hd          , Dd          , Uh          , Dd          , Re^Uf       , Dd          , Dd          , Dd          , Dd          , Dd          , Hd          , Yhs         , Dd          , Dd          , Hd          , Dd          , Yhs         , Yhs^Xp      , Dd          , Hd          , Hd          , Md          , Md          , Xu          , Xu          , Xu          , Xu          , Uh          , Uu^Uf       , Uu          , Rd          , Rd          , Uh          
Uzw         , Uzw         , Yhs^Xp      , Hd          , Yhs         , Yhs         , Ds          , Ds          , Dd          , Dd          , Dd          , Dd          , Hd          , Hd          , Hd          , Hd          , Hd          , Dd          , Dd          , Dd          , Yhs         , Yhs^Xp      , Yhs^Xp      , Yhs         , Yhs         , Yhs         , Hd          , Hd          , Md          , Md          , Xu          , Xu          , Xu          , Xu          , Xu          , Xu          , Xu          , Xu          , Xu          , Uh          , Uh          , Rd          
