border_size=1
usage=map

Xu, Xu, Xu, Xu, Uh^Ii, Uh^Ii, Uh^Ii, Xu, Xu, Xu, Xu, Xu, Xu, Xu, Yhl, Yhl, Ss, Ss, Yhl, Xu, Xu, Xu, Xu, Xu, Xu, Xu, Xu, Xu, Xu, Xu, Xu, Xu, Xu, Xu, Xu, Xu, Xu, Xu, Xu, Xu, Xu, Xu, Xu, Xu
Uh^Ii, Xu, Uu^Ufi, Uu^Ufi, Uh^Ii, Uu^Ufi, Uh^Ii, Xu, Yhr, Xu, Uu^Vud, Xu, Yhr^Xp, Ss, Khs, Chs, Yhr, Yhl^Xp, Xu, Xu, Xu, Xu, Qxv, Qxv, Qxv, Qxv, Qxv, Xu, Xu, Xu, Xu, Xu, Xu, Xu, Xu, Xu, Xu, Xu, Xu, Xu, Xu, Xu, Xu, Xu
Xu, Uh^Ii, Ur, Uh^Ii, Yhr, Yhr, Ce, Yhr^Xp, Yhr^Xp, Yhr, Yhr, Ds, Yhr, Chs, Chr, Yhr, Xu, Xu, Xu, Xu, Xu, Xu, Ur, Ur, Uu^Vu, Qxv, Qxv, Xu, Xu, Xu, Xu, Xu, Xu, Xu, Xu, Xu, Xu, Xu, Xu, Xu, Xu, Xu, Xu, Xu
Uu^Ii, Uu^Ii, Uu, Ur, Ur, Ce, 1 Ke, Ce, Ur, Ur, Ds, Ss, Ss, Ss, Yhr, Uh, Uh, Xu, Xu, Xu, Chr, Khr, Ur, Uu, Uu, Qxv, Qxv, Xu, Xu, Xu, Xu, Xu, Xu, Xu, Xu, Xu, Xu, Xu, Xu, Xu, Xu, Xu, Xu, Xu
Uu^Ii, Uu^Ii, Uu^Vud, Uu, Uu, Ce, Ce, Ce, Yhr, Uu^Vu, Chs, Yhr, Ds, Yhr, Uu, Uu^Uf, Uu^Vu, Xu, Xu, Xu, Chr, Uh, Uu, Uu, Qxv, Qxv, Qxv, Xu, Xu, Xu, Xu, Xu, Xu, Xu, Xu, Xu, Xu, Xu, Xu, Xu, Xu, Xu, Xu, Xu
Xos, Uh, Uh, Uh, Uh, Yhr, Ds, Yhr, Ds, Ds, Ss, Yhr^Xp, Yhr, Uu, Yhr^Xp, Re^Uf, Uh, Xu, Xu, Uu^Uf, Uh, Uu, Ur, Qxv, Qxv, Qxv, Xu, Xu, Xu, Xu, Xu, Xu, Xu, Xu, Xu, Xu, Xu, Xu, Xu, Xu, Xu, Xu, Xu, Xu
Xos, Xos, Xos, Xos, Uh, Ds, Yhr, Ds, Ss, Yhr, Ss, Yhr^Xp, Ds, Uh, Uh, Yhr, Ur, Uh, Uu, Uu, Uu, Uu, Uu^Vu, Qxv, Qxv, Xu, Xu, Xu, Xu, Xu, Qxv, Xu, Qxv, Xu, Xu, Xu, Xu, Xu, Xu, Xu, Xu, Xu, Xu, Xu
Yhl, Yhl, Ss, Chs, Yhr, Yhr^Xp, Ss, Ss, Ss, Chs, Xu, Ds, Xu, Xu, Yhr, Re^Uf, Uu^Uf, Ur, Uu, Ur, Ur, Uu, Uu, Qxv, Qxv, Xu, Xu, Xu, Rb, Uu, Qxv, Qxv, Qxv, Qxv, Uu, Xu, Xu, Xu, Xu, Xu, Xu, Xu, Xu, Xu
Ss, Yhl^Xp, Ss, Ss, Chs, Ss, Ds, Yhl, Xu, Xu, Xu, Xu, Xu, Xu, Qxv, Uh, Qxv, Uh, Qxv, Qxv, Uu, Ur, Uh, Uu, Uu, Uh, Xu, Uu^Vud, Rb, Uu, Xu, Qxv, Qxv, Uu^Ii, Qxv, Xu, Xu, Xu, Xu, Xu, Xu, Xu, Xu, Xu
Yhr, Ss, Xos, Ds, Xos, Chs, Xos, Xos, Xu, Xu, Xu, Xu, Xu, Qxv, Qxv, Qxv, Chr, Qxv, Qxv, Qxv, Qxv, Ur, Uu^Ii, Uh^Ii, Uu, Yhr, Yhr, Rb, Qxv, Xu, Xu, Xu, Qlf, Qxv, Qxv, Xu, Xu, Xu, Xu, Xu, Xu, Xu, Xu, Xu
Xos, Xos, Xu, Xos, Xu, Xos, Xu, Xu, Xu, Uu^Ufi, Re^Uf, Xu, Uu^Ufi, Qxv, Rb^Uf, Yhr, Uu^Vu, Khr, Qxv, Qxv, Uh, Ur, Uu, Uh^Ii, Yhr, Yhr^Xp, Uu^Uf, Uu^Ii, Qxv, Xu, Xu, Xu, Qlf, Qlf, Xu, Xu, Xu, Xu, Xu, Xu, Xu, Xu, Xu, Xu
Xu, Xu, Xu, Xu, Xu, Xu, Uu^Vud, Uh, Uh, Uu^Ufi, Uu^Uf, Re^Uf, Uu, Uu^Uf, Ur, Yhr^Xp, Yhr, Chr, Uu, Qxv, Ur, Uu, Uu, Uu^Ii, Yhr, Yhr^Xp, Uu^Ufi, Uu^Vu, Uh^Ii, Qxv, Xu, Qlf, Qlf, Xu, Xu, Xu, Xu, Xu, Xu, Xu, Xu, Xu, Xu, Xu
Xu, Xu, Xu, Xu, Uu^Uf, Uh, Uh, Uu, Ur, Ur, Qxv, Re^Uf, Qxv, Ur, Uu^Uf, Yhr, Yhr, Uu, Uu^Uf, Ur, Uu, Uu^Ii, Uu^Vud, Uu, Yhr^Xp, Yhr, Cud, Uu^Ufi, Yhr, Qxv, Qxv, Qlf, Qlf, Xu, Xu, Xu, Xu, Xu, Xu, Xu, Xu, Xu, Xu, Xu
Xu, Xu, Xu, Xu, Re^Uf, Uu^Ufi, Uu, Yhr, Uu, Qxv, Qxv, Qxv, Qxv, Qxv, Qxv, Qxv, Chr, Qxv, Qxv, Uu^Ufi, Uu, Yhr, Qxv, Uu^Ufi, Yhr, Cud, 4 Kud, Cud, Yhr^Xp, Uu^Ufi, Qxv, Qxv, Qxv, Xu, Xu, Xu, Xu, Xu, Xu, Xu, Xu, Xu, Xu, Xu
Xos, Xu, Xu, Xu, Uh, Re^Uf, Uu, Yhr^Xp, Ur, Uu, Uh, Qxv, Re^Uf, Qxv, Uu^Ufi, Qxv, Qxv, Qxv, Uh, Uu^Ii, Uh, Qxv, Uu^Uf, Uu^Ufi, Uu^Uf, Cud, Cud, Cud, Uu^Uf, Uu^Ufi, Uh^Ii, Qxv, Qxv, Xu, Xu, Xu, Xu, Xu, Xu, Xu, Xu, Xu, Xu, Xu
Xos, Xos, Xos, Xu, Uh, Yhr, Uu^Vu, Ur, Ur, Uu^Ufi, Uu, Uh, Uu, Uu^Vud, Uu, Uu^Uf, Uu^Uf, Qxv, Uh, Uu, Xu, Qxv, Uh^Ii, Uu^Uf, Uu^Ufi, Uu^Uf, Yhr, Yhr, Uu^Ufi, Uu^Uf, Qxv, Qxv, Qxv, Xu, Xu, Xu, Xu, Xu, Xu, Xu, Xu, Xu, Xu, Xu
Xos, Xos, Xos, Xos, Uh, Uh, Re^Uf, Uu, Yhr, Yhr, Uu, Uu, Re^Uf, Re^Uf, Uh, Yhr, Yhr^Xp, Qxv, Qxv, Xu, Xu, Qxv, Qxv, Qxv, Qxv, Uu^Ufi, Qxv, Uu^Ufi, Qxv, Qxv, Qxv, Qxv, Qxv, Xu, Xu, Xu, Xu, Xu, Xu, Xu, Xu, Xu, Xu, Xu
Xos, Xos, Xos, Xos, Uh, Re^Uf, Uh, Uu, Yhr, Yhr^Xp, Yhr, Re^Uf, Uh, Uu^Ufi, Uh, Uu, Yhr, Uu, Uu^Uf, Xu, Xu, Xu, Xu, Qxv, Qxv, Qxv, Qxv, Qxv, Qlf, Qxv, Qxv, Qxv, Xu, Xu, Xu, Xu, Xu, Xu, Xu, Xu, Xu, Xu, Xu, Xu
Xos, Yhl^Xp, Uzw, Xos, Uu, Uu^Uf, Uu^Ufi, Uh, Uu^Vud, Ur, Ur, Uh, Yhr, Uh, Qxv, Uu^Uf, Uu^Uf, Uu, Yhr, Xu, Xu, Xu, Yhr^Xp, Xu, Xu, Xu, Xu, Xu, Xu, Qlf, Xu, Xu, Xu, Xu, Xu, Xu, Xu, Xu, Xu, Xu, Xu, Xu, Xu, Xu
Xos, Xos, Yhl, Yhl, Uu, Uu, Xu, Uu, Yhl, Uu^Uf, Yhr, Yhr^Xp, Ur, Ur, Urb, Qxv, Rb, Yhr, Yhr^Xp, Xu, Yhr, Ql, Ql, Xu, Xu, Xu, Ql, Xu, Qlf, Qlf, Xu, Xu, Xu, Xu, Xu, Xu, Xu, Xu, Xu, Xu, Xu, Xu, Xu, Xu
Yhl, Yhl^Xp, Yhl, Yhl, Xu, Xu, Xu, Yhl, Yhl, Xu, Xu, Yhr, Uu^Uf, Uu, Uu, Urb, Urb, Yhr, Yhr, Yhr, Ql, Yhr, Uu, Ql, Ql, Ql, Ql, Ql, Ql, Qlf, Qlf, Xu, Qlf, Xu, Xu, Xu, Xu, Xu, Xu, Xu, Xu, Xu, Xu, Xu
Yhl, Yhl, Uzw, Xu, Xu, Xu, Xu, Yhl, Yhl^Xp, Xu, Xu, Xu, Xu, Uu^Uf, Ql, Rb, Urb, Ql, Ql, Yhr, Ql, Urb, Urb, Ql, Ql, Ql, Ql, Ql, Ql, Qlf, Xu, Qlf, Xu, Qlf, Qlf, Xu, Xu, Xu, Xu, Xu, Xu, Xu, Xu, Xu
Yhl, Xu, Xu, Yhl^Xp, Xu, Xu, Yhl, Yhl, Yhl, Xu, Ql, Ql, Ql, Ql, Ql, Urb, Urb, Ql, Ql, Urb, Urb, Ql, Urb, Urb, Ql, Ql, Ql, Ql, Ql, Xu, Xu, Xu, Xu, Xu, Qlf, Qlf, Xu, Xu, Xu, Xu, Xu, Xu, Xu, Xu
Yhl, Yhl, Yhl, Xu, Xu, Yhl^Xp, Yhl, Yhl, Ql, Ql, Ql, Ql, Ql, Ql, Ql, Uu, Uu, Ql, Ql, Urb, Uu, Ql, Ql, Uu, Urb, Ql, Ql, Ql, Ql, Xu, Qlf, Xu, Xu, Xu, Qlf, Qlf, Xu, Xu, Xu, Xu, Xu, Xu, Xu, Xu
Xos, Yhl, Yhl, Yhl^Xp, Yhl, Yhl, Yhl, Xu, Ql, Ql, Ql, Ql, Ql, Ql, Ql, Urb, Rb, Ql, Ql, Ql, Urb, Urb, Ql, Urb, Urb, Ql, Ql, Ql, Qlf, Qlf, Qlf, Qlf, Qlf, Qlf, Qlf, Xu, Xu, Xu, Xu, Xu, Xu, Xu, Xu, Xu
Yhl^Xp, Yhl, Yhl, Yhl, Yhl, Yhl, Yhl, Xu, Ql, Ql, Ql, Ql, Ql, Ql, Ql, Uu, Urb, Rb, Uu, Ql, Ql, Urb, Uu, Urb, Uu, Ql, Ql, Xu, Xu, Xu, Xu, Xu, Xu, Xu, Xu, Qlf, Qlf, Xu, Xos, Xu, Xu, Xu, Xu, Xu
Yhl, Yhl, Xu, Xu, Yhl, Xu, Ql, Ql, Ql, Ql, Ql, Ql, Ql, Ql, Ql, Ql, Urb, Rb, Urb, Ql, Ql, Ql, Ql, Uu, Rb, Uu, Xu, Xu, Xu, Xu, Xu, Xu, Xu, Xu, Xu, Xu, Xos, Xos, Xos, Xos, Xu, Xu, Xu, Xu
Xu, Xu, Xu, Xu, Yhl, Xu, Ql, Ql, Ql, Ql, Ql, Ql, Ql, Ql, Qlf, Ql, Ql, Uu, Urb, Ql, Ql, Ql, Uu, Uu, Rb, Uu, Xu, Xu, Xu, Xu, Xu, Xu, Qxv, Xu, Xu, Xu, Xu, Xos, Xu, Xu, Xu, Xu, Xu, Xu
Yhl, Xu, Xu, Xu, Yhl^Xp, Xu, Ql, Ql, Ql, Qlf, Qlf, Ql, Xu, Qlf, Xu, Xu, Xu, Uu, Rb, Uu, Xu, Xu, Rb, Uu, Cud, Xu, Xu, Xu, Uu^Uf, Xu, Uu^Uf, Qxv, Xu, Xu, Xu, Xu, Xu, Xu, Xu, Xu, Xu, Xu, Xu, Xu
Xu, Yhl, Yhl, Xu, Uh, Ql, Qlf, Qlf, Ql, Qlf, Xu, Xu, Qlf, Qlf, Xu, Xu, Cud, Uu, Uu, Urb, Urb, Uu, Urb, Cud, Xu, Xu, Uu^Uf, Uu^Ufi, Uu^Uf, Uu^Uf, Uu^Emf, Xu, Xu, Xu, Xu, Xu, Xu, Xu, Xu, Xu, Xu, Xu, Xu, Xu
Yhl^Xp, Xu, Xu, Yhl^Xp, Uh, Ql, Qlf, Qlf, Qlf, Ql, Xu, Xu, Xu, Xu, Xu, Xu, Xu, Uu, Uu, Uu, Uu, Rb, Urb, Cud, Uu^Uf, Uu^Uf, Uu^Uf, Cud, Uu^Ufi, Uu^Uf, Uu^Ufi, Uu^Uf, Xu, Xu, Xu, Xu, Xu, Xu, Xu, Xu, Xu, Xu, Xu, Xu
Yhl, Xu, Xu, Xu, Ql, Ql, Qlf, Qlf, Qlf, Xu, Xu, Xu, Xu, Xu, Xu, Xu, Uh, Uh, Qxv, Uu, Qxv, Uu, Uu, Yhr^Xp, Yhr, Cud, Kud, Uu^Uf, Yhr, Cud, Cud, Uu^Uf, Xu, Xu, Xu, Xu, Xu, Xu, Xu, Xu, Xu, Xu, Xu, Xu
Yhl^Xp, Uu^Uf, Uu^Uf, Xu, Uh, Qlf, Qlf, Qlf, Xu, Xu, Xu, Uu^Vud, Uu^Uf, Xu, Xu, Xu, Uh, Xu, Qxv, Qxv, Qxv, Uh, Cud, Yhr, Yhr^Xp, Cud, Uu^Uf, Cud, Yhr, Cud, Uu^Ufi, Uu^Uf, Xu, Xu, Xu, Xu, Xu, Xu, Xu, Xu, Xu, Xu, Xu, Xu
Xos, Uu, Uu, Yhl^Xp, Xu, Xu, Xu, Xu, Xu, Xu, Xu, Cud, Cud, Uu^Vu, Uh, Uh, Uh, Xu, Xu, Qxv, Uu, Uh, Uu, Yhr, Yhr, Uh, Cud, Uu^Ufi, Uu^Ufi, Uu^Uf, Xu, Xu, Xu, Xu, Xu, Xu, Xu, Xu, Xu, Xu, Xu, Xu, Xu, Xu
Xu, Xos, Uu^Uf, Uu, Uu, Uu^Uf, Uu^Uf, Uu^Uf, Uu, Xu, Cud, 2 Kud, Cud, Uu^Ufi, Yhr^Xp, Yhr, Uu, Uu, Yhr^Xp, Uu, Yhr, Uu, Rb, Rb^Em, Uh, Uh, Xu, Uu^Ufi, Xu, Xu, Qxv, Xu, Xu, Xu, Xu, Xu, Xu, Xu, Xu, Xu, Xu, Xu, Xu, Xu
Xu, Xos, Xos, Uu^Uf, Uu, Uu, Uu, Uu, Uu, Uu^Vud, Uu, Cud, Uu^Vu, Yhr, Yhr, Yhr^Xp, Uu, Yhr, Uu^Ufi, Uu^Ii, Uh, Uu, Uh, Uh, Xu, Xu, Xu, Xu, Yhr, Yhr^Xp, Yhr, Qxv, Qxv, Xu, Xu, Xu, Xu, Xu, Xu, Xu, Xu, Xu, Xu, Xu
Xu, Xu, Xu, Xos, Xos, Uu, Qxv, Uu, Uh, Ur, Ur, Uu^Ii, Ur, Uu, Uh, Yhr^Xp, Uu^Uf, Uh, Qxv, Uh^Ii, Xu, Uh, Xu, Xu, Xu, Xu, Xu, Xu, Xu, Yhr, Yhr, Yhr, Yhr, Qxv, Qxv, Xu, Xu, Xu, Xu, Xu, Xu, Xu, Xu, Xu
Xu, Xu, Xu, Xu, Xos, Qxv, Qxv, Qxv, Uh, Uu^Uf, Ur, Ur, Uh^Ii, Uu^Ufi, Qxv, Qxv, Qxv, Qxv, Qxv, Xu, Xu, Xu, Xu, Xu, Xu, Xu, Yhr^Xp, Xu, Yhr^Xp, Yhr, Yhr, Yhr, Yhr, Xu, Xu, Qxv, Qxv, Xu, Xu, Xu, Xu, Xu, Xu, Xu
Xu, Xu, Xu, Xu, Xos, Qxv, Qxv, Uh^Ii, Uu^Ii, Ur, Uu, Uu^Ii, Uh^Ii, Uu^Uf, Xu, Qxv, Xu, Qxv, Xu, Xu, Xu, Xu, Xu, Xu, Yhr, Yhr^Xp, Yhr, Yhr, Yhr, Yhr, Xu, Xu, Yhl, Yhr^Xp, Xu, Xu, Xu, Xu, Xu, Xu, Xu, Xu, Xu, Xu
Xu, Xu, Xu, Xu, Xos, Qxv, Qxv, Uu^Ufi, Uu, Ur, Uu^Vud, Uu^Uf, Xu, Xu, Xu, Xu, Xu, Xu, Xu, Xu, Uh, Uu^Uf, Yhr^Xp, Yhr, Yhr, Yhr, Xu, Yhr, Yhr, Xu, Xu, Xu, Yhl, Yhl, Yhl, Xu, Qxv, Qxv, Xu, Xu, Xu, Xu, Xu, Xu
Xu, Xu, Xu, Xu, Xos, Xos, Uh, Uu^Uf, Ur, Ur, Uu^Uf, Uu^Ufi, Xu, Xu, Xu, Xu, Xu, Xu, Xu, Xu, Uu^Uf, Uu, Yhr, Yhr, Yhr, Xu, Xu, Yhr^Xp, Yhr, Xu, Xu, Xu, Yhl, Yhl, Yhl, Yhl, Yhr^Xp, Xu, Qxv, Xu, Xu, Xu, Xu, Xu
Xu, Xu, Xu, Xu, Yhl, Uh, Uu^Uf, Yhr^Xp, Ur, Ur, Uu, Xu, Yhl^Xp, Xu, Xu, Xu, Xu, Xu, Xu, Xu, Uh, Uu, Yhr, Yhr, Xu, Yhl, Yhl, Xu, Yhl, Xu, Yhr^Xp, Xu, Yhl, Xu, Xu, Yhl, Yhr, Qxv, Xu, Xu, Xu, Xu, Xu, Xu
Xu, Xu, Xu, Yhl^Xp, Yhl^Xp, Yhr, Rb^Em, Uu^Uf, Ur, Uu, Uu^Uf, Yhr, Yhl, Yhl, Xu, Xu, Uzw, Yhr^Xp, Xu, Xu, Uu^Uf, Uu, Yhr^Xp, Yhr, Yhr, Xu, Yhl, Xu, Yhl, Xu, Yhr, Xu, Yhr, Xu, Xu, Yhr, Yhr, Xu, Xu, Xu, Xu, Xu, Xu, Xu
Xu, Xu, Xu, Yhl, Ss, Ss, Ss, Rb^Em, Uu, Uu^Uf, Uu^Emf, Yhr, Sm, Yhl^Xp, Yhl, Uzw, Xu, Xu, Yhr^Xp, Xu, Uu^Uf, Uu, Yhr, Yhr, Yhr^Xp, Xu, Yhl, Yhl, Xu, Xu, Yhr, Yhr, Yhr, Xu, Xu, Yhr, Xu, Xu, Yhr^Xp, Xu, Xu, Xu, Xu, Xu
Xu, Xu, Xu, Xu, Ss, Ss, Sm, Rb, Uu, Uu^Uf, Rb^Em, Sm, Sm, Yhl, Ss, Yhl, Yhl, Uzw, Xu, Xu, Xu, Xu, Yhr, Yhr, Xu, Xu, Xu, Yhr, Yhr, Yhr^Xp, Yhr, Xu, Xu, Yhr, Yhr^Xp, Yhr, Yhr, Uzw, Xu, Xu, Yhr^Xp, Xu, Xu, Xu
Xu, Xu, Xu, Xu, Ss, Ss, Sm, Sm, Sm, Rb^Em, Sm, Sm, Sm, Sm, Ss, Yhl^Xp, Yhl, Xu, Xu, Xu, Xu, Xu, Yhr, Yhr, Xu, Xu, Yhl, Yhl, Yhl^Xp, Yhr, Yhr, Yhr, Yhr^Xp, Yhr, Xu, Xu, Yhr, Yhr, Yhr, Uzw, Xu, Xu, Xu, Xu
Xu, Xu, Xu, Xu, Xu, Sm, Sm, Sm, Rb, Sm, Sm, Sm, Ss, Ss, Ss, Yhl, Yhl^Xp, Yhr, Yhr, Yhr, Yhr, Yhr^Xp, Yhr, Yhr, Xu, Xu, Yhl, Xu, Yhl, Xu, Yhl, Yhr, Yhr, Xu, Yhr, Yhr^Xp, Xu, Xu, Yhl, Yhl, Xu, Xu, Xos, Xos
Xu, Xu, Xu, Xu, Xu, Sm, Sm, Sm, Sm, Rb, Rb, Sm, Yhl, Ss, Yhl^Xp, Yhl, Yhl, Yhr, Yhr, Yhr, Yhr, Yhr^Xp, Xu, Xu, Xu, Xu, Yhl, Yhl, Xu, Yhl, Yhl, Xu, Yhl, Yhr, Yhr, Xu, Yhl^Xp, Yhl^Xp, Yhl, Yhl, Xos, Xos, Xos, Xos
Uzw, Yhr^Xp, Xu, Xu, Xu, Xu, Xu, Rb, Sm, Rb, Sm, Uu^Uf, Uh, Yhl, Yhl, Yhl, Xu, Xu, Xu, Xu, Xu, Xu, Xu, Xu, Xu, Xu, Cud, Yhl, Yhl, Yhl, Xu, Yhl, Yhl, Xu, Yhl, Yhl^Xp, Yhl, Yhl, Yhl, Xos, Xos, Xos, Xos, Xos
Xu, Xu, Uzw, Yhr^Xp, Xu, Xu, Xu, Xu, Uh, Sm, Rb, Uu^Uf, Uh, Uh, Xu, Xu, Xu, Xu, Xu, Xu, Yhl^Xp, Xu, Uu^Uf, Uu^Uf, Uu, Urb, Urb, Cud, Cud, Yhl, Yhl, Yhl, Xu, Yhl, Xu, Yhl, Xos, Xos, Xos, Yhl, Xos, Xos, Xos, Xos
Yhl, Uzw, Xu, Xu, Uzw, Yhr^Xp, Xu, Xu, Xu, Uh, Rb, Uu^Uf, Uu, Uh, Xu, Xu, Xu, Xu, Yhl^Xp, Uu^Uf, Uu, Uu, Yhl, Uu, Urb, Urb, Urb, Urb, Urb, Cud, Xu, Yhl, Yhl, Yhl, Yhl, Yhl, Xu, Xu, Yhl^Xp, Yhl, Xos, Xos, Xos, Xos
Yhl^Xp, Yhl, Yhl, Uzw, Xu, Xu, Uzw, Yhr^Xp, Xu, Uh, Uh, Rb, Uu, Uh, Uu^Ufi, Xu, Xu, Uh, Uu, Uu, Urb, Yhl^Xp, Cud, Urb, Urb, Urb, Urb, Urb, Urb, Urb, Xu, Xu, Xu, Xu, Xu, Xu, Yhl, Yhl^Xp, Xos, Yhl^Xp, Xos, Xos, Xos, Xos
Uzw, Yhl, Yhl, Yhl, Yhl, Uzw, Xu, Xu, Xu, Uu^Vu, Uu, Uu, Uu, Uu, Uu, Xu, Xu, Uh, Uu, Uu, Urb, Cud, 3 Kud, Cud, Urb, Urb, Urb, Urb, Re, Xu, Uu^Vu, Xu, Xu, Xu, Uu, Cud, Yhl, Yhl^Xp, Xos, Yhl, Xos, Xos, Xos, Xos
Xu, Xu, Uzw, Yhl, Yhl^Xp, Yhr, Yhr^Xp, Xu, Xu, Uh, Rb, Ur, Uh^Ii, Uu, Uh, Xu, Xu, Xu, Xu, Yhl^Xp, Yhl, Cud, Cud, Cud, Urb, Xu, Xu, Xu, Uu, Re, Re, Uu^Uf, Uu^Uf, Uu^Vud, Uu, Cud, Yhl, Yhl, Xos, Wwg, Xos, Xos, Wog, Wog
Yhr^Xp, Uzw, Xu, Xu, Uzw, Yhr, Yhr, Uh^Ii, Uh, Xu, Rb, Ur, Uh^Ii, Uu^Uf, Uh, Xu, Xu, Xu, Xu, Uu, Uu^Uf, Urb, Urb, Urb, Uu, Uh, Xu, Uu^Vu, Uu, Uu^Uf, Re, Re, Re, Re, Uu, Cud, Xu, Xos, Xos, Wog, Wog, Wog, Xos, Xos
Xu, Xu, Yhr^Xp, Uzw, Xu, Xu, Xu, Uh^Ii, Uh, Xu, Uu, Uu, Uu^Uf, Uh, Uh, Uh, Urb, Xu, Xu, Xu, Yhl^Xp, Uu, Uu, Uu, Uu, Uu^Uf, Xu, Xu, Xu, Uu^Vud, Uu^Uf, Re, Uu^Vu, Uu^Uf, Xu, Xu, Xos, Xos, Wog, Wog, Wwg, Xos, Xos, Xos
Xu, Xu, Xu, Xu, Xu, Xu, Xu, Uh^Ii, Uu, Uh, Rb, Uu^Ufi, Uu^Ufi, Uu^Uf, Uh, Urb, Uh, Uh, Xu, Xu, Uh, Yhl, Uu^Uf, Uh, Uh, Uu, Xos, Xos, Xos, Xu, Xu, Xu, Xu, Xu, Xos, Xos, Wog, Wog, Wwg, Wwg, Xos, Xos, Xos, Xos
Xu, Xu, Xu, Xu, Xu, Xu, Xu, Uh^Ii, Uu^Ii, Uu, Rb, Uu^Ufi, Uu^Ii, Uh^Ii, Uu^Uf, Uu^Uf, Uh, Xu, Xu, Xu, Xu, Uh, Wwg, Uu^Uf, Wwg, Xos, Xos, Xos, Xos, Xos, Xos, Xos, Xos, Xos, Wwg, Wog, Wwg, Wwg, Xos, Uzw, Yhl^Xp, Xos, Xos, Xos
Xu, Xu, Xu, Xu, Xu, Xu, Uh^Ii, Uh^Ii, Uu^Ufi, Uu^Uf, Uu, Rb, Uu, Uh, Uh, Uu^Uf, Xu, Xu, Xu, Xu, Xu, Xu, Xu, Wwg, Wog, Wwg, Wog, Xos, Wog, Wog, Wog, Wog, Wog, Wwg, Uzw, Wwg, Xu, Wwg, Wog, Xos, Xos, Xos, Xos, Xos
Xu, Xu, Xu, Xu, Xu, Xu, Uu^Uf, Uh^Ii, Uu^Ufi, Uu^Uf, Uu^Uf, Uu, Wwf, Uh, Uu^Uf, Wwf, Wwg, Xu, Wwf, Xu, Wwg, Xu, Xu, Xu, Xu, Wog, Xu, Wog, Wog, Wog, Xu, Wog, Xu, Xu, Yhl^Xp, Xu, Uzw, Wwg, Wwg, Xos, Wog, Xos, Xos, Xos
Xu, Xu, Xu, Xu, Xu, Uu^Uf, Uu^Uf, Uh, Uu^Uf, Uu^Ii, Uu, Uu^Uf, Uu^Uf, Wwf, Wwg, Wwg, Wwg, Wwg, Wwg, Wwg, Wwf, Wwg, Xu, Xu, Xu, Xu, Xu, Xu, Xu, Xu, Xu, Xu, Xu, Xu, Xu, Xu, Yhl^Xp, Xu, Uzw, Wwg, Xu, Wog, Xu, Xos
Wwg, Wwg, Wwg, Xu, Wwg, Xu, Uu^Uf, Wwf, Wwg, Wwf, Wwf, Wwg, Wwf, Wwf, Wwg, Wwg, Xos, Xos, Xos, Xos, Xos, Xos, Xu, Xu, Xu, Xu, Xu, Xu, Xu, Xu, Xu, Xu, Xu, Xu, Xu, Xu, Xu, Xu, Yhl^Xp, Xu, Xu, Xu, Xu, Xu
Wwg, Wwg, Wwg, Wwg, Wwg, Wwg, Wwf, Wwf, Wwg, Wwf, Wwg, Wwf, Wwg, Wwf, Xos, Xos, Xu, Xu, Xu, Xu, Xu, Xos, Xu, Xu, Xu, Xu, Xu, Xu, Xu, Xu, Xu, Xu, Xu, Xu, Xu, Xu, Xu, Xu, Xu, Xu, Xu, Xu, Xu, Xu
Xu, Xu, Xu, Wwg, Uh, Wwf, Uh^Ii, Wwg, Ur, Uu, Uh^Ii, Wwg, Uh^Ii, Xos, Xu, Xu, Xu, Xu, Xu, Xu, Xu, Xu, Xu, Xu, Xu, Xu, Xu, Xu, Xu, Xu, Xu, Xu, Xu, Xu, Xu, Xu, Xu, Xu, Xu, Xu, Xu, Xu, Xu, Xu
Xu, Xu, Xu, Xu, Uh, Uu^Uf, Uh^Ii, Uu^Ii, Rb, Uu^Ii, Uh^Ii, Uh^Ii, Uh, Xu, Xu, Xu, Xu, Xu, Xu, Xu, Xu, Xu, Xu, Xu, Xu, Xu, Xu, Xu, Xu, Xu, Xu, Xu, Xu, Xu, Xu, Xu, Xu, Xu, Xu, Xu, Xu, Xu, Xu, Xu
Xu, Xu, Md^Xm, Md^Xm, Md^Xm, Uh, Uu, Rb, Re, Uu, Uh, Uu^Uf, Uh, Xu, Xu, Xu, Xu, Xu, Xu, Xu, Xu, Xu, Xu, Xu, Xu, Xu, Xu, Xu, Xu, Xu, Xu, Xu, Xu, Xu, Xu, Xu, Xu, Xu, Xu, Xu, Xu, Xu, Xu, Xu
Xu, Md^Xm, Md, Hd, Hd, Hd, Rd, Re, Dd, Ds, Hd, Uh, Md, Md^Xm, Md^Xm, Xu, Xu, Xu, Xu, Xu, Xu, Xu, Xu, Xu, Xu, Xu, Xu, Xu, Xu, Xu, Xu, Xu, Xu, Xu, Xu, Xu, Xu, Xu, Xu, Xu, Xu, Xu, Xu, Xu
Xu, Md^Xm, Md, Hd, Rd, Rd, Ds, Dd, Hd, Hd, Hd, Hd, Md, Md, Md, Md^Xm, Md^Xm, Xu, Xu, Xu, Xu, Xu, Xu, Xu, Xu, Xu, Xu, Xu, Xu, Xu, Xu, Xu, Xu, Xu, Xu, Xu, Xu, Xu, Xu, Xu, Xu, Xu, Xu, Xu
Md^Xm, Md^Xm, Md, Hd, Rd, Ds, Dd, Dd, Hd, Hd, Hd, Dd, Yhs^Xp, Md, Md, Md^Xm, Md^Xm, Md^Xm, Md^Xm, Xu, Xu, Xu, Xu, Xu, Xu, Xu, Xu, Xu, Xu, Xu, Xu, Xu, Xu, Xu, Xu, Xu, Xu, Xu, Xu, Xu, Xu, Xu, Xu, Xu
Hd, Md, Hd, Ds, Rd, Ds, Ds, Dd, Hd, Hd, Dd, Hd, Yhs, Yhs^Xp, Md, Md^Xm, Md^Xm, Md^Xm, Md^Xm, Md^Xm, Md^Xm, Xu, Xu, Xu, Xu, Xu, Xu, Xu, Xu, Xu, Xu, Xu, Xu, Xu, Xu, Xu, Xu, Xu, Xu, Xu, Xu, Xu, Xu, Xu
Hd, Yhs, Yhs^Xp, Ds, Rd, Rd, Ds, Yhs^Xp, Yhs, Yhs^Xp, Dd, Dd, Dd, Yhs^Xp, Md, Md, Md, Md^Xm, Md, Md^Xm, Md^Xm, Md^Xm, Md^Xm, Xu, Xu, Xu, Xu, Xu, Xu, Xu, Xu, Xu, Xu, Xu, Xu, Xu, Xu, Xu, Xu, Xu, Xu, Xu, Xu, Xu
Hd, Yhs, Yhs, Ds, Rd, Rd, Rd, Ds, Ds, Ds, Ds, Dd, Dd, Hd, Hd, Hd, Md, Md, Hd, Md, Md, Md^Xm, Md^Xm, Md^Xm, Md^Xm, Xu, Xu, Xu, Xu, Xu, Xu, Xu, Xu, Xu, Xu, Xu, Xu, Xu, Xu, Xu, Xu, Xu, Xu, Xu
Dd, Ds, Dd, Ds, Dd, Dd, Rd, Dd, Dd, Dd, Ce, Ce, Ce, Dd, Ds, Dd, Dd, Hd, Hd, Md, Md, Md^Xm, Md, Md, Md, Md^Xm, Md^Xm, Xu, Xu, Xu, Xu, Xu, Xu, Xu, Xu, Xu, Xu, Xu, Xu, Xu, Xu, Xu, Xu, Xu
Dd, Ds, Dd, Dd, Dd, Cdr, Dd, Rd, Dd, Dd, Ce, Ke, Ce, Ds, Yhs, Ds, Ds, Hd, Dd, Md, Hd, Hd, Md, Md, Md, Md, Md^Xm, Xu, Xu, Xu, Xu, Xu, Xu, Xu, Xu, Xu, Xu, Xu, Xu, Xu, Xu, Xu, Xu, Xu
Hd, Dd, Dd, Yhs^Xp, Yhs, Dd, Hd, Dd, Dd, Rd, Re, Ce, Dd, Yhs^Xp, Yhs, Yhs^Xp, Yhs, Ds, Ds, Dd, Dd, Hd, Hd, Hhd, Hhd, Md, Md, Md^Xm, Xu, Xu, Xu, Xu, Xu, Xu, Xu, Xu, Xu, Xu, Xu, Xu, Xu, Xu, Xu, Xu
Hd, Hd, Dd, Yhs, Yhs^Xp, Dd, Dd, Dd, Dd, Dd, Dd, Re, Rd, Dd, Dd, Yhs, Ds, Ds^Edpp, Ds, Dd, Dd, Hd, Hd, Md, Hhd, Hhd, Md, Md^Xm, Md^Xm, Xu, Xu, Xu, Xu, Xu, Xu, Xu, Xu, Xu, Xu, Xu, Xu, Xu, Xu, Xu
Hd, Hd, Hd, Yhs, Dd, Dd, Dd, Yhs^Xp, Yhs^Xp, Dd, Dd, Re, Re, Dd, Dd, Dd, Ds^Edpp, Ds^Edpp, Dd, Dd^Edpp, Dd, Hd, Hd, Hd, Hd, Hd, Hd, Md, Md^Xm, Xu, Xu, Xu, Xu, Xu, Xu, Xu, Xu, Xu, Xu, Xu, Xu, Xu, Xu, Xu
Dd, Hd, Dd, Dd, Dd, Hd, Dd, Dd, Dd, Yhs, Dd, Dd, Re, Dd, Dd, Rd, Dd, Dd, Ds^Edp, Dd, Dd, Dd, Dd, Hd, Dd, Hd, Hd, Md, Md, Md^Xm, Md^Xm, Xu, Xu, Xu, Xu, Xu, Xu, Xu, Xu, Xu, Xu, Xu, Xu, Xu
Dd, Dd, Dd, Hd, Hd, Dd, Dd, Cdr, Dd, Dd, Dd, Ds, Ds, Re, Dd, Dd, Dd, Dd, Ds, Cdr, Dd, Dd, Hd, Dd, Hd, Hd, Hd, Hd, Md, Md^Xm, Md^Xm, Xu, Xu, Xu, Xu, Xu, Xu, Xu, Xu, Xu, Xu, Xu, Xu, Xu
Hd, Dd, Dd, Hd, Hd, Hd, Dd, Dd, Hd, Hd, Dd, Dd, Dd^Edpp, Ds, Dd, Rd, Rd, Ds^Edpp, Ds^Edp, Dd, Dd^Dc, Dd, Dd, Hd, Hd, Hd, Hd, Hd, Md, Md, Hhd, Md^Xm, Md^Xm, Xu, Xu, Xu, Xu, Xu, Xu, Xu, Xu, Xu, Xu, Xu
Dd, Hd, Dd, Hd, Dd, Hd, Dd, Dd, Dd, Hd, Hd, Dd, Dd, Dd, Dd^Dr, Dd, Ds, Rd, Ds, Dd, Dd, Dd, Hd, Hd, Dd, Hd, Hd, Hd, Hd, Hhd, Hhd, Md, Md^Xm, Xu, Xu, Xu, Xu, Xu, Xu, Xu, Xu, Xu, Xu, Xu
Dd, Hd, Hd, Hd, Hd, Dd, Dd, Hd, Hd, Hd, Hd, Hd, Hd, Ds, Ds, Ds, Ds, Ds, Ds, Dd, Dd, Dd, Hd, Hd, Dd, Hd, Hd, Hd, Hhd, Hhd, Md, Md, Md^Xm, Md^Xm, Md^Xm, Xu, Xu, Xu, Xu, Xu, Xu, Xu, Xu, Xu
Dd, Dd, Dd, Hd, Hd, Hd, Dd, Dd, Dd, Hd, Hd, Hd, Hd, Hd, Dd, Ds^Edp, Ds, Ds, Dd, Rd, Rd, Dd, Dd, Hd, Hd, Dd, Hd, Hd, Hhd, Md, Md, Md, Md^Xm, Md^Xm, Md^Xm, Xu, Xu, Xu, Xu, Xu, Xu, Xu, Xu, Xu
Hd, Hd, Hd, Hd, Hd, Hd, Hd, Hd, Dd, Dd, Dd, Dd, Dd, Hd, Dd, Dd, Dd, Ds, Dd, Dd, Dd, Dd, Dd, Dd, Hd, Hd, Hd, Hd, Md, Hhd, Md, Md, Md, Md, Md^Xm, Md^Xm, Xu, Xu, Xu, Xu, Xu, Xu, Xu, Xu
