Xu, Xu, Xu, Xu, Uh^Ii, Uh^Ii, Uh^Ii, Xu, Xu, Xu, Xuc, Xu, Xu, Xu, Yhl, Yhl, Ss, Ss, Yhl, Xu, Xu, Xu, Xu, Xu, Xu, Xu, Xu, Xu, Xu, Xu, Xu, Xu, Xu, Xu, Xu, Xu, Xu, Xu, Xu, Xu, Xu, Xu, Xu, Xu
Uh^Ii, Xu, Uu^Tfi, Tb^Tfi, Uh^Ii, Tb^Tfi, Uh^Ii, Xu, Yhr, Xuc, Uu^Vud, Xuc, Yhr^Xp, Ss^Tf, Khs, Chs, Yhr, Yhl^Xp, Xu, Xu, Xu, Xu, Qxv, Qxv, Qxv, Qxv, Qxv, Xu, Xu, Xu, Xu, Xu, Xu, Xu, Xu, Xu, Xu, Xu, Xu, Xu, Xu, Xu, Xu, Xu
Uu^Ii, Uh^Ii, Ur, Uh^Ii, Yhr, Yhr, Ce, Yhr^Xp, Yhr^Xp, Yhr, Yhr, Ds^Esd, Yhr^Esd, Chs, Chr, Yhr, Xuc, Xu, Xu, Xu, Xu, Xu, Ur^Edt, Ur, Uu^Vu, Qxv, Qxv, Xu, Xu, Xu, Xu, Xu, Xu, Xu, Xu, Xu, Xu, Xu, Xu, Xu, Xu, Xu, Xu, Xu
Uu^Ii, Uu^Ii, Uu, Ur, Ur, Ce, 1 Ke, Ce, Ur, Ur, Ds^Esd, Ss, Ss, Ss, Yhr, Uh, Uh, Xuc, Xu, Xu, Chr, Khr, Ur^Edt, Uu^Edt, Uu, Qxv, Qxv, Xu, Xu, Xu, Xu, Xu, Xu, Xu, Xu, Xu, Xu, Xu, Xu, Xu, Xu, Xu, Xu, Xu
Uu^Ii, Uu^Ii, Uu^Vud, Uu, Uu, Ce, Ce, Ce, Yhr, Uu^Vu, Chs, Yhr, Ds^Esd, Yhr, Uu^Emf, Tb^Tf, Uu^Vu, Xuc, Xu, Xu, Chr, Uh, Uu^Edt, Uu^Edt, Qxv, Qxv, Qxv, Xu, Xu, Xu, Xu, Xu, Xu, Xu, Xu, Xu, Xu, Xu, Xu, Xu, Xu, Xu, Xu, Xu
Xos, Uh, Uh, Uh, Uh, Yhr, Ds^Esd, Yhr, Ds, Ds, Ss, Yhr^Xp, Yhr, Uu, Yhr^Xp, Re^Tf, Uh, Xuc, Xu, Uu^Tf, Uh, Uu, Ur, Qxv, Qxv, Qxv, Xu, Xu, Xu, Xu, Xuc, Xu, Xu, Xu, Xu, Xu, Xu, Xu, Xu, Xu, Xu, Xu, Xu, Xu
Xos, Xos, Xos^Xzm/, Xos, Uh, Ds, Yhr, Ds^Esd, Ss^Emf, Yhr, Ss, Yhr^Xp, Ds, Uh, Uh, Yhr, Ur, Uh, Uu, Uu, Uu^Edt, Uu, Uu^Vu, Qxv, Qxv, Xu, Xu, Xu, Xuc, Xuc, Qxv, Xu, Qxv, Xu, Xu, Xu, Xu, Xu, Xu, Xu, Xu, Xu, Xu, Xu
Yhl, Yhl, Ss^Tf, Chs, Yhr, Yhr^Xp, Ss^Emf, Ss^Tf, Ss^Tf, Chs, Xu, Ds, Xu, Xuc, Yhr, Re^Tf, Tb^Tf, Ur, Uu, Ur^Edt, Ur^Edt, Uu^Edt, Uu, Qxv, Qxv, Xuc, Xuc, Xu, Rb, Uu, Qxv, Qxv, Qxv, Qxv, Uu, Xu, Xu, Xu, Xu, Xu, Xu, Xu, Xu, Xu
Ss, Yhl^Xp, Ss, Ss, Chs, Ss^Tf, Ds, Yhl, Xu, Xu, Xu, Xu, Xu, Xuc, Qxv, Uh, Qxv, Uh, Qxv, Qxv, Uu^Edt, Ur^Edt, Uh, Uu, Uu, Uh, Xu, Uu^Vud, Rb, Uu, Xu, Qxv, Qxv, Uu^Ii, Qxv, Xu, Xu, Xu, Xu, Xu, Xu, Xu, Xu, Xu
Yhr, Ss, Xos, Ds, Xos, Chs, Xos, Xos, Xu, Xu, Xu, Xu, Xu, Qxv, Qxv, Qxv, Chr, Qxv, Qxv, Qxv, Qxv, Ur, Uu^Ii, Uh^Ii, Uu^Edt, Yhr^Edt, Yhr^Edt, Rb, Qxv, Xuc, Xu, Xu, Qlf, Qxv, Qxv, Xu, Xu, Xu, Xu, Xu, Xu, Xu, Xu, Xu
Xos, Xos, Xu, Xos, Xu, Xos, Xuc, Xuc, Xu, Uu^Tfi, Re^Tf, Xuc, Uu^Tfi, Qxv, Rb^Tf, Yhr, Uu^Vu, Khr, Qxv, Qxv, Uh, Ur, Uu, Uh^Ii, Yhr^Edt, Yhr^Xp, Uu^Tf, Uu^Ii, Qxv, Xu, Xu, Xu, Qlf, Qlf, Xu, Xu, Xu, Xu, Xu, Xu, Xu, Xu, Xu, Xu
Xu, Xu, Xu, Xu, Xuc, Xuc, Uu^Vud, Uh, Uh, Uu^Tfi, Uu^Tf, Re^Tf, Uu, Uu^Tf, Ur, Yhr^Xp, Yhr, Chr, Uu, Qxv, Ur^Edt, Uu, Uu, Uu^Ii, Yhr^Edt, Yhr^Xp, Uu^Tfi, Uu^Vu, Uh^Ii, Qxv, Xu, Qlf, Qlf, Xu, Xu, Xu, Xu, Xu, Xu, Xu, Xu, Xu, Xu, Xu
Xu, Xu, Xu, Xuc, Uu^Tf, Uh, Uh, Uu, Ur, Ur, Qxv, Re^Tf, Qxv, Ur, Uu^Tf, Yhr, Yhr, Uu, Uu^Tf, Ur^Edt, Uu^Edt, Uu^Ii, Uu^Vud, Uu, Yhr^Xp, Yhr^Edt, Cte, Uu^Tfi, Yhr, Qxv, Qxv, Qlf, Qlf, Xu, Xu, Xu, Xu, Xu, Xu, Xu, Xu, Xu, Xu, Xu
Xu, Xu, Xu, Xu, Re^Tf, Uu^Tfi, Uu, Yhr, Uu, Qxv, Qxv, Qxv, Qxv, Qxv, Qxv, Qxv, Chr, Qxv, Qxv, Uu^Tfi, Uu, Yhr, Qxv, Uu^Tfi, Yhr, Cte, 4 Kte, Cte, Yhr^Xp, Uu^Tfi, Qxv, Qxv, Qxv, Xu, Xu, Xu, Xu, Xu, Xu, Xu, Xu, Xu, Xu, Xu
Xos, Xu, Xu, Xu, Uh, Re^Tf, Uu, Yhr^Xp, Ur, Uu, Uh, Qxv, Re^Tf, Qxv, Uu^Tfi, Qxv, Qxv, Qxv, Uh, Uu^Ii, Uh, Qxv, Uu^Tf, Uu^Tfi, Uu^Tf, Cte, Cte, Cte, Uu^Tf, Uu^Tfi, Uh^Ii, Qxv, Qxv, Xu, Xu, Xu, Xu, Xu, Xu, Xu, Xu, Xu, Xu, Xu
Xos, Xos, Xos, Xu, Uh, Yhr, Uu^Vu, Ur, Ur, Uu^Tfi, Uu, Uh, Uu, Uu^Vud, Uu, Uu^Tf, Uu^Tf, Qxv, Uh, Uu, Xuc, Qxv, Uh^Ii, Uu^Tf, Uu^Tfi, Uu^Tf, Yhr, Yhr, Uu^Tfi, Uu^Tf, Qxv, Qxv, Qxv, Xu, Xu, Xu, Xu, Xu, Xu, Xu, Xu, Xu, Xu, Xu
Xos, Xos, Xos, Xos, Uh, Uh, Re^Tf, Uu, Yhr, Yhr, Uu, Uu, Re^Tf, Re^Tf, Uh, Yhr, Yhr^Xp, Qxv, Qxv, Xuc, Xuc, Qxv, Qxv, Qxv, Qxv, Uu^Tfi, Qxv, Uu^Tfi, Qxv, Qxv, Qxv, Qxv, Qxv, Xu, Xu, Xu, Xu, Xu, Xu, Xu, Xu, Xu, Xu, Xu
Xos, Xos, Xos, Xos, Uh, Re^Tf, Uh, Uu, Yhr, Yhr^Xp, Yhr^Edt, Re^Tf, Uh, Uu^Tfi, Uh, Uu, Yhr, Uu, Uu^Tf, Xuc, Xu, Xuc, Xu, Qxv, Qxv, Qxv, Qxv, Qxv, Qlf, Qxv, Qxv, Qxv, Xu, Xu, Xu, Xu, Xu, Xu, Xu, Xu, Xu, Xu, Xu, Xu
Xos, Yhl^Xp, Uzw, Xos, Uu, Uu^Tf, Uu^Tfi, Uh, Uu^Vud, Ur^Edt, Ur^Edt, Uh, Yhr, Uh, Qxv, Uu^Tf, Uu^Tf, Uu, Yhr, Xu, Xu, Xu, Yhr^Xp, Xu, Xu, Xu, Xu, Xu, Xu, Qlf, Xu, Xu, Xu, Xu, Xu, Xu, Xu, Xu, Xu, Xu, Xu, Xu, Xu, Xu
Xos, Xos, Yhl, Yhl, Uu, Uu, Xuc, Uu, Yhl, Uu^Tf, Yhr, Yhr^Xp, Ur, Ur, Urb, Qxv, Rb^Edt, Yhr, Yhr^Xp, Xu, Yhr, Ql, Ql, Xu, Xu, Xu, Ql, Xu, Qlf, Qlf, Xu, Xu, Xu, Xu, Xu, Xu, Xu, Xu, Xu, Xu, Xu, Xu, Xu, Xu
Yhl, Yhl^Xp, Yhl, Yhl, Xu, Xuc, Xuc, Yhl, Yhl, Xu, Xu, Yhr, Uu^Tf, Uu, Uu, Urb^Edt, Urb^Edt, Yhr, Yhr, Yhr, Ql, Yhr, Uu, Ql, Ql, Ql, Ql, Ql, Ql, Qlf, Qlf, Xu, Qlf, Xu, Xu, Xu, Xu, Xu, Xu, Xu, Xu, Xu, Xu, Xu
Yhl, Yhl, Uzw, Xu, Xu, Xu, Xu, Yhl, Yhl^Xp, Xu, Xu, Xu, Xu, Uu^Tf, Ql, Rb, Urb, Ql, Ql, Yhr, Ql, Urb, Urb, Ql, Ql, Ql, Ql, Ql, Ql, Qlf, Xu, Qlf, Xu, Qlf, Qlf, Xu, Xu, Xu, Xu, Xu, Xu, Xu, Xu, Xu
Yhl, Xu, Xuc, Yhl^Xp, Xu, Xu, Yhl, Yhl, Yhl, Xu, Ql, Ql, Ql, Ql, Ql, Urb, Urb, Ql, Ql, Urb, Urb, Ql, Urb, Urb, Ql, Ql, Ql, Ql, Ql, Xu, Xu, Xu, Xu, Xu, Qlf, Qlf, Xu, Xu, Xu, Xu, Xu, Xu, Xu, Xu
Yhl, Yhl, Yhl, Xuc, Xu, Yhl^Xp, Yhl, Yhl, Ql, Ql, Ql, Ql, Ql, Ql, Ql, Uu, Uu, Ql, Ql, Urb, Uu, Ql, Ql, Uu, Urb, Ql, Ql, Ql, Ql, Xu, Qlf, Xu, Xu, Xu, Qlf, Qlf, Xu, Xu, Xu, Xu, Xu, Xu, Xu, Xu
Xos, Yhl, Yhl, Yhl^Xp, Yhl, Yhl, Yhl, Xu, Ql, Ql, Ql, Ql, Ql, Ql, Ql, Urb, Rb, Ql, Ql, Ql, Urb, Urb, Ql, Urb, Urb, Ql, Ql, Ql, Qlf, Qlf, Qlf, Qlf, Qlf, Qlf, Qlf, Xu, Xu, Xu, Xu, Xu, Xu, Xu, Xu, Xu
Yhl^Xp, Yhl, Yhl, Yhl, Yhl, Yhl, Yhl, Xu, Ql, Ql, Ql, Ql, Ql, Ql, Ql, Uu, Urb, Rb, Uu, Ql, Ql, Urb, Uu, Urb, Uu, Ql, Ql, Xu, Xu, Xu, Xu, Xu, Xu, Xu, Xu, Qlf, Qlf, Xu, Xos, Xu, Xu, Xu, Xu, Xu
Yhl, Yhl, Xu, Xu, Yhl, Xu, Ql, Ql, Ql, Ql, Ql, Ql, Ql, Ql, Ql, Ql, Urb, Rb, Urb, Ql, Ql, Ql, Ql, Uu, Rb, Uu, Xu, Xu, Xu, Xu, Xu, Xu, Xu, Xu, Xu, Xu, Xos, Xos, Xos, Xos, Xu, Xu, Xu, Xu
Xu, Xu, Xu, Xu, Yhl, Xu, Ql, Ql, Ql, Ql, Ql, Ql, Ql, Ql, Qlf, Ql, Ql, Uu, Urb, Ql, Ql, Ql, Uu, Uu, Rb, Uu, Xu, Xu, Xu, Xu, Xu, Xu, Qxv, Xu, Xu, Xu, Xu, Xos, Xu, Xu, Xu, Xu, Xu, Xu
Yhl, Xu, Xu, Xu, Yhl^Xp, Xu, Ql, Ql, Ql, Qlf, Qlf, Ql, Xu, Qlf, Xu, Xu, Xu, Uu, Rb, Uu, Xu, Xu, Rb, Uu, Cte, Xu, Xu, Xu, Uu^Tf, Xu, Uu^Tf, Qxv, Xu, Xu, Xu, Xu, Xu, Xu, Xu, Xu, Xu, Xu, Xu, Xu
Xu, Yhl, Yhl, Xu, Uh, Ql, Qlf, Qlf, Ql, Qlf, Xu, Xu, Qlf, Qlf, Xu, Xu, Cte, Uu, Uu^Edt, Urb^Edt, Urb, Uu, Urb, Cte, Xu, Xu, Uu^Tf, Uu^Tfi, Tb^Tf, Tb^Tf, Uu^Emf, Xu, Xu, Xu, Xu, Xu, Xu, Xu, Xu, Xu, Xu, Xu, Xu, Xu
Yhl^Xp, Xu, Xu, Yhl^Xp, Uh, Ql, Qlf, Qlf, Qlf, Ql, Xu, Xu, Xu, Xu, Xu, Xu, Xu, Uu, Uu, Uu^Edt, Uu, Rb^Edt, Urb^Edt, Cte, Uu^Tf, Uu^Tf, Uu^Tf, Cte, Tb^Tfi, Tb^Tf, Uu^Tfi, Uu^Tf, Xu, Xu, Xu, Xu, Xu, Xu, Xu, Xu, Xu, Xu, Xu, Xu
Yhl, Xu, Xu, Xu, Ql, Ql, Qlf, Qlf, Qlf, Xu, Xu, Xu, Xu, Xu, Xu, Xu, Uh, Uh, Qxv, Uu, Qxv, Uu^Edt, Uu, Yhr^Xp, Yhr, Cte, Kte, Uu^Tf, Yhr, Cte, Cte, Uu^Tf, Xu, Xu, Xu, Xu, Xu, Xu, Xu, Xu, Xu, Xu, Xu, Xu
Yhl^Xp, Uu^Tf, Uu^Tf, Xu, Uh, Qlf, Qlf, Qlf, Xu, Xu, Xu, Uu^Vud, Tb^Tf, Xu, Xu, Xu, Uh, Xu, Qxv, Qxv, Qxv, Uh, Cte, Yhr, Yhr^Xp, Cte, Tb^Tf, Cte, Yhr, Cte, Tb^Tfi, Tb^Tf, Xu, Xu, Xu, Xu, Xu, Xu, Xu, Xu, Xu, Xu, Xu, Xu
Xos, Uu, Uu, Yhl^Xp, Xu, Xu, Xu, Xu, Xu, Xu, Xu, Cud, Cud, Uu^Vu, Uh, Uh, Uh, Xu, Xu, Qxv, Uu, Uh, Uu, Yhr, Yhr, Uh, Cte, Tb^Tfi, Tb^Tfi, Uu^Tf, Xu, Xu, Xu, Xu, Xu, Xu, Xu, Xu, Xu, Xu, Xu, Xu, Xu, Xu
Xu, Xos, Uu^Tf, Uu, Uu, Uu^Tf, Uu^Tf, Uu^Tf, Uu, Xu, Cud, 2 Kud, Cud, Tb^Tfi, Yhr^Xp, Yhr, Uu, Uu, Yhr^Xp, Uu, Yhr, Uu, Rb, Rb^Em, Uh, Uh, Xu, Tb^Tfi, Xu, Xu, Qxv, Xu, Xu, Xu, Xu, Xu, Xu, Xu, Xu, Xu, Xu, Xu, Xu, Xu
Xu, Xos, Xos, Uu^Tf, Uu, Uu, Uu, Uu, Uu, Uu^Vud, Uu, Cud, Uu^Vu, Yhr^Edt, Yhr^Edt, Yhr^Xp, Uu, Yhr, Tb^Tfi, Uu^Ii, Uh, Uu, Uh, Uh, Xu, Xu, Xu, Xu, Yhr, Yhr^Xp, Yhr, Qxv, Qxv, Xu, Xu, Xu, Xu, Xu, Xu, Xu, Xu, Xu, Xu, Xu
Xu, Xu, Xu, Xos, Xos, Uu, Qxv, Uu, Uh, Ur, Ur^Edt, Uu^Ii, Ur^Edt, Uu^Edt, Uh^Edt, Yhr^Xp, Uu^Tf, Uh, Qxv, Uh^Ii, Xu, Uh, Xu, Xu, Xu, Xu, Xu, Xu, Xu, Yhr, Yhr, Yhr, Yhr, Qxv, Qxv, Xu, Xu, Xu, Xu, Xu, Xu, Xu, Xu, Xu
Xu, Xu, Xu, Xu, Xos, Qxv, Qxv, Qxv, Uh, Uu^Tf, Ur^Edt, Ur^Edt, Uh^Ii, Tb^Tfi, Qxv, Qxv, Qxv, Qxv, Qxv, Xu, Xu, Xu, Xu, Xu, Xuc, Xu, Yhr^Xp, Xuc, Yhr^Xp, Yhr, Yhr, Yhr, Yhr, Xu, Xu, Qxv, Qxv, Xu, Xu, Xu, Xu, Xu, Xu, Xu
Xu, Xu, Xu, Xu, Xos, Qxv, Qxv, Uh^Ii, Uu^Ii, Ur, Uu, Uu^Ii, Uh^Ii, Tb^Tf, Xu, Qxv, Xu, Qxv, Xu, Xu, Xu, Xu, Xu, Xuc, Yhr, Yhr^Xp, Yhr, Yhr, Yhr, Yhr, Xuc, Xu, Yhl, Yhr^Xp, Xuc, Xu, Xu, Xu, Xu, Xu, Xu, Xu, Xu, Xu
Xu, Xu, Xu, Xu, Xos, Qxv, Qxv, Tb^Tfi, Uu, Ur, Uu^Vud, Tb^Tf, Xu, Xu, Xu, Xu, Xu, Xu, Xu, Xu, Uh, Uu^Tf, Yhr^Xp, Yhr, Yhr, Yhr, Xu, Yhr, Yhr, Xuc, Xu, Xu, Yhl, Yhl, Yhl, Xuc, Qxv, Qxv, Xu, Xu, Xu, Xu, Xu, Xu
Xu, Xu, Xu, Xu, Xos^Xzm/, Xos, Uh, Tb^Tf, Ur^Edt, Ur^Edt, Tb^Tf, Tb^Tfi, Xu, Xu, Xu, Xu, Xu, Xu, Xu, Xuc, Uu^Tf, Uu, Yhr, Yhr, Yhr, Xuc, Xuc, Yhr^Xp, Yhr, Xu, Xuc, Xuc, Yhl, Yhl, Yhl, Yhl, Yhr^Xp, Xu, Qxv, Xu, Xu, Xu, Xu, Xu
Xu, Xu, Xu, Xu, Yhl, Uh, Tb^Tf, Yhr^Xp, Ur, Ur^Edt, Uu, Xu, Yhl^Xp, Xuc, Xuc, Xu, Xuc, Xu, Xu, Xuc, Uh, Uu, Yhr, Yhr, Xuc, Yhl, Yhl, Xu, Yhl, Xuc, Yhr^Xp, Xuc, Yhl, Xu, Xu, Yhl, Yhr, Qxv, Xu, Xu, Xu, Xu, Xu, Xu
Xu, Xu, Xuc, Yhl^Xp, Yhl^Xp, Yhr, Rb^Em, Tb^Tf, Ur, Uu, Tb^Tf, Yhr, Yhl, Yhl, Xu, Xuc, Uzw, Yhr^Xp, Xu, Xu, Uu^Tf, Uu, Yhr^Xp, Yhr, Yhr, Xuc, Yhl, Xu, Yhl, Xuc, Yhr, Xuc, Yhr, Xu, Xu, Yhr, Yhr, Xuc, Xu, Xu, Xu, Xu, Xu, Xu
Xu, Xu, Xuc, Yhl, Ss, Ss^Emf, Ss^Tf, Rb^Em, Uu, Tb^Tf, Tb^Emf, Yhr, Sm, Yhl^Xp, Yhl, Uzw, Xuc, Xu, Yhr^Xp, Xu, Uu^Tf, Uu, Yhr, Yhr, Yhr^Xp, Xuc, Yhl, Yhl, Xuc, Xuc, Yhr, Yhr, Yhr, Xuc, Xuc, Yhr, Xu, Xuc, Yhr^Xp, Xu, Xuc, Xu, Xu, Xu
Xu, Xu, Xu, Xuc, Ss, Ss^Emf, Sm, Rb^Em, Uu, Tb^Tf, Rb^Em, Sm, Sm, Yhl, Ss, Yhl, Yhl, Uzw, Xu, Xu, Xu, Xu, Yhr, Yhr, Xuc, Xuc, Xuc, Yhr, Yhr, Yhr^Xp, Yhr, Xuc, Xuc, Yhr, Yhr^Xp, Yhr, Yhr, Uzw, Xu, Xu, Yhr^Xp, Xuc, Xu, Xu
Xu, Xu, Xu, Xuc, Ss, Ss, Sm, Sm, Sm, Rb^Em, Sm, Sm, Sm^Em, Sm, Ss^Em, Yhl^Xp, Yhl, Xuc, Xuc, Xu, Xu, Xu, Yhr, Yhr, Xuc, Xuc, Yhl, Yhl, Yhl^Xp, Yhr, Yhr, Yhr, Yhr^Xp, Yhr, Xu, Xu, Yhr, Yhr, Yhr, Uzw, Xu, Xu, Xu, Xu
Xu, Xu, Xu, Xu, Xu, Sm, Sm, Sm, Rb, Sm, Sm, Sm, Ss^Emf, Ss^Tf, Ss^Em, Yhl, Yhl^Xp, Yhr, Yhr, Yhr, Yhr, Yhr^Xp, Yhr, Yhr, Xu, Xu, Yhl, Xuc, Yhl, Xuc, Yhl, Yhr, Yhr, Xuc, Yhr, Yhr^Xp, Xuc, Xuc, Yhl, Yhl, Xu, Xu, Xos, Xos
Xu, Xu, Xu, Xu, Xu, Sm, Sm, Sm, Sm, Rb, Rb, Sm, Yhl, Ss^Em, Yhl^Xp, Yhl, Yhl, Yhr, Yhr, Yhr, Yhr, Yhr^Xp, Xu, Xu, Xu, Xu, Yhl, Yhl, Xuc, Yhl, Yhl, Xuc, Yhl, Yhr, Yhr, Xu, Yhl^Xp, Yhl^Xp, Yhl, Yhl, Xos, Xos, Xos, Xos
Uzw, Yhr^Xp, Xu, Xu, Xu, Xu, Xu, Rb, Sm, Rb, Sm, Tb^Tf, Uh, Yhl, Yhl, Yhl, Xu, Xu, Xu, Xu, Xu, Xu, Xuc, Xuc, Xuc, Xu, Cud, Yhl, Yhl, Yhl, Xuc, Yhl, Yhl, Xuc, Yhl, Yhl^Xp, Yhl, Yhl, Yhl, Xos, Xos^Xzm\, Xos, Xos, Xos
Xu, Xu, Uzw, Yhr^Xp, Xu, Xu, Xu, Xu, Uh, Sm, Rb, Tb^Tf, Uh, Uh, Xu, Xu, Xu, Xu, Xuc, Xu, Yhl^Xp, Xu, Tb^Tf, Uu^Tf, Uu^Edt, Urb^Edt, Urb^Edt, Cud, Cud, Yhl, Yhl, Yhl, Xuc, Yhl, Xuc, Yhl, Xos, Xos, Xos, Yhl, Xos, Xos, Xos, Xos
Yhl, Uzw, Xu, Xu, Uzw, Yhr^Xp, Xu, Xu, Xu, Uh, Rb, Tb^Tf, Uu, Uh, Xu, Xu, Xu, Xuc, Yhl^Xp, Uu^Tf, Uu, Uu, Yhl, Uu, Urb^Edt, Urb^Edt, Urb, Urb, Urb, Cud, Xu, Yhl, Yhl, Yhl, Yhl, Yhl, Xu, Xu, Yhl^Xp, Yhl, Xos, Xos, Xos, Xos
Yhl^Xp, Yhl, Yhl, Uzw, Xu, Xu, Uzw, Yhr^Xp, Xu, Uh, Uh, Rb, Uu, Uh, Tb^Tfi, Xu, Xu, Uh, Uu, Uu, Urb, Yhl^Xp, Cud, Urb, Urb, Urb, Urb^Edt, Urb, Urb, Urb, Xuc, Xu, Xu, Xu, Xu, Xu, Yhl, Yhl^Xp, Xos, Yhl^Xp, Xos, Xos, Xos, Xos
Uzw, Yhl, Yhl, Yhl, Yhl, Uzw, Xuc, Xu, Xu, Uu^Vu, Uu, Uu, Uu, Uu, Uu, Xu, Xu, Uh, Uu, Uu, Urb, Cud, 3 Kud, Cud, Urb, Urb, Urb^Edt, Urb^Edt, Re, Xu, Uu^Vu, Xuc, Xuc, Xuc, Uu, Cud, Yhl, Yhl^Xp, Xos, Yhl, Xos, Xos, Xos, Xos
Xu, Xu, Uzw, Yhl, Yhl^Xp, Yhr, Yhr^Xp, Xu, Xuc, Uh, Rb, Ur, Uh^Ii, Uu, Uh, Xuc, Xu, Xu, Xuc, Yhl^Xp, Yhl, Cud, Cud, Cud, Urb, Xu, Xu, Xu, Uu, Re, Re, Tb^Tf, Uu^Tf, Uu^Vud, Uu, Cud, Yhl, Yhl, Xos, Wwg, Xos, Xot, Wog, Wog
Yhr^Xp, Uzw, Xu, Xu, Uzw, Yhr, Yhr, Uh^Ii, Uh, Xuc, Rb, Ur, Uh^Ii, Tb^Tf, Uh, Xuc, Xuc, Xu, Xu, Uu, Uu^Tf, Urb, Urb, Urb, Uu, Uh, Xu, Uu^Vu, Uu, Uu^Tf, Re, Re, Re, Re, Uu, Cud, Xu, Xos, Xos, Wog, Wog, Wog, Xos, Xos
Xu, Xu, Yhr^Xp, Uzw, Xu, Xuc, Xuc, Uh^Ii, Uh, Xu, Uu, Uu, Tb^Tf, Uh, Uh, Uh, Urb, Xuc, Xuc, Xu, Yhl^Xp, Uu, Uu, Uu, Uu, Uu^Tf, Xu, Xuc, Xu, Uu^Vud, Tb^Tf, Re, Uu^Vu, Uu^Tf, Xu, Xu, Xos^Xzm/, Xos, Wog, Wog, Wwg, Xos, Xos, Xos
Xu, Xu, Xu, Xu, Xu, Xu, Xuc, Uh^Ii, Uu, Uh, Rb, Tb^Tfi, Tb^Tfi, Uu^Tf, Uh, Urb, Uh, Uh, Xuc, Xu, Uh, Yhl, Uu^Tf, Uh, Uh, Uu, Xos, Xos, Xos, Xu, Xu, Xu, Xu, Xu, Xot, Xos^Xzm/, Wog, Wog, Wwg, Wwg, Xot, Xos, Xos, Xos
Xu, Xu, Xu, Xu, Xu, Xu, Xuc, Uh^Ii, Uu^Ii, Uu, Rb, Uu^Tfi, Uu^Ii, Uh^Ii, Uu^Tf, Tb^Tf, Uh, Xuc, Xu, Xu, Xu, Uh, Wwrg, Uu^Tf, Wwg, Xos, Xot^Xzm\, Xos, Xos, Xos, Xos, Xos, Xos, Xos^Xzm/, Wwg, Wog, Wwg, Wwg, Xos, Uzw, Yhl^Xp, Xos, Xos, Xos
Xu, Xu, Xu, Xu, Xu, Xu, Uh^Ii, Uh^Ii, Tb^Tfi, Uu^Tf, Uu, Rb, Uu, Uh, Uh, Uu^Tf, Xu, Xu, Xu, Xu, Xu, Xu, Xu, Wwg, Wog, Wwg, Wog, Xos^Xzm/, Wog, Wog, Wog, Wog, Wog, Wwg, Uzw, Wwg, Xu, Wwg, Wog, Xos, Xos, Xos, Xos, Xos
Xu, Xu, Xu, Xu, Xu, Xuc, Tb^Tf, Uh^Ii, Tb^Tfi, Tb^Tf, Uu^Tf, Uu, Wwf, Uh, Uu^Tf, Wwf, Wwg, Xu, Wwf, Xu, Wwg, Xu, Xu, Xu, Xu, Wog, Xu, Wog, Wog, Wog, Xu, Wog, Xu, Xu, Yhl^Xp, Xu, Uzw, Wwg, Wwg, Xos, Wog, Xot, Xot, Xos
Xu, Xu, Xu, Xu, Xu, Tb^Tf, Tb^Tf, Uh, Uu^Tf, Uu^Ii, Uu, Tb^Tf, Uu^Tf, Wwf, Wwg, Wwrg, Wwg, Wwg, Wwg, Wwg, Wwf, Wwg, Xu, Xu, Xu, Xu, Xu, Xu, Xu, Xu, Xu, Xu, Xu, Xu, Xu, Xu, Yhl^Xp, Xu, Uzw, Wwg, Xu, Wog, Xu, Xos
Wwg, Wwg, Wwg, Xu, Wwg, Xu, Uu^Tf, Wwf, Wwg, Wwrg, Wwf, Wwg, Wwrg, Wwf, Wwg, Wwg, Xos, Xos, Xos, Xos, Xos, Xos, Xu, Xu, Xu, Xu, Xu, Xu, Xu, Xu, Xu, Xu, Xu, Xu, Xu, Xu, Xu, Xu, Yhl^Xp, Xu, Xu, Xu, Xu, Xu
Wwg, Wwg, Wwg, Wwg, Wwg, Wwg, Wwrg, Wwf, Wwg, Wwf, Wwrg, Wwf, Wwrg, Wwrg, Xos, Xos, Xu, Xu, Xu, Xu, Xu, Xos, Xu, Xu, Xu, Xu, Xu, Xu, Xu, Xu, Xu, Xu, Xu, Xu, Xu, Xu, Xu, Xu, Xu, Xu, Xu, Xu, Xu, Xu
Xu, Xu, Xu, Wwg, Uh, Wwf, Uh^Ii, Wwrg, Ur, Uu, Uh^Ii, Wwg, Uh^Ii, Xos, Xu, Xu, Xu, Xu, Xu, Xu, Xu, Xu, Xu, Xu, Xu, Xu, Xu, Xu, Xu, Xu, Xu, Xu, Xu, Xu, Xu, Xu, Xu, Xu, Xu, Xu, Xu, Xu, Xu, Xu
Xu, Xu, Xu, Xu, Uh, Uu^Tf, Uh^Ii, Uu^Ii, Rb, Uu^Ii, Uh^Ii, Uh^Ii, Uh, Xu, Xu, Xu, Xu, Xu, Xu, Xu, Xu, Xu, Xu, Xu, Xu, Xu, Xu, Xu, Xu, Xu, Xu, Xu, Xu, Xu, Xu, Xu, Xu, Xu, Xu, Xu, Xu, Xu, Xu, Xu
Xu, Xu, Md^Xm, Md^Xm, Md^Xm, Uh, Uu, Rb, Re, Uu, Uh, Tb^Tf, Uh, Xu, Xu, Xu, Xu, Xu, Xu, Xu, Xu, Xu, Xu, Xu, Xu, Xu, Xu, Xu, Xu, Xu, Xu, Xu, Xu, Xu, Xu, Xu, Xu, Xu, Xu, Xu, Xu, Xu, Xu, Xu
Xu, Md^Xm, Md, Hd, Hd, Hd, Rd, Re, Dd, Ds, Hd, Uh, Md, Md^Xm, Md^Xm, Xu, Xu, Xu, Xu, Xu, Xu, Xu, Xu, Xu, Xu, Xu, Xu, Xu, Xu, Xu, Xu, Xu, Xu, Xu, Xu, Xu, Xu, Xu, Xu, Xu, Xu, Xu, Xu, Xu
Xu, Md^Xm, Md, Hd, Rd, Rd, Ds^Esd, Dd, Hd, Hd, Hd, Hd, Md, Md, Md, Md^Xm, Md^Xm, Xu, Xu, Xu, Xu, Xu, Xu, Xu, Xu, Xu, Xu, Xu, Xu, Xu, Xu, Xu, Xu, Xu, Xu, Xu, Xu, Xu, Xu, Xu, Xu, Xu, Xu, Xu
Md^Xm, Md^Xm, Md, Hd, Rd, Ds, Dd, Dd, Hd, Hd, Hd, Dd, Yhs^Xp, Md, Md, Md^Xm, Md^Xm, Md^Xm, Md^Xm, Xu, Xu, Xu, Xu, Xu, Xu, Xu, Xu, Xu, Xu, Xu, Xu, Xu, Xu, Xu, Xu, Xu, Xu, Xu, Xu, Xu, Xu, Xu, Xu, Xu
Hd, Md, Hd, Ds, Rd, Ds, Ds, Dd, Hd, Hd, Dd, Hd, Yhs, Yhs^Xp, Md, Md^Xm, Md^Xm, Md^Xm, Md^Xm, Md^Xm, Md^Xm, Xu, Xu, Xu, Xu, Xu, Xu, Xu, Xu, Xu, Xu, Xu, Xu, Xu, Xu, Xu, Xu, Xu, Xu, Xu, Xu, Xu, Xu, Xu
Hd, Yhs, Yhs^Xp, Ds, Rd, Rd^Esd, Ds, Yhs^Xp, Yhs, Yhs^Xp, Dd, Dd, Dd, Yhs^Xp, Md, Md, Md, Md^Xm, Md, Md^Xm, Md^Xm, Md^Xm, Md^Xm, Xu, Xu, Xu, Xu, Xu, Xu, Xu, Xu, Xu, Xu, Xu, Xu, Xu, Xu, Xu, Xu, Xu, Xu, Xu, Xu, Xu
Hd, Yhs, Yhs, Ds, Rd^Esd, Rd, Rd, Ds, Ds, Ds, Ds, Dd, Dd, Hd, Hd, Hd, Md, Md, Hd, Md, Md, Md^Xm, Md^Xm, Md^Xm, Md^Xm, Xu, Xu, Xu, Xu, Xu, Xu, Xu, Xu, Xu, Xu, Xu, Xu, Xu, Xu, Xu, Xu, Xu, Xu, Xu
Dd, Ds, Dd, Ds, Dd, Dd, Rd, Dd, Dd, Dd, Ce, Ce, Ce, Dd, Ds, Dd, Dd, Hd, Hd, Md, Md, Md^Xm, Md, Md, Md, Md^Xm, Md^Xm, Xu, Xu, Xu, Xu, Xu, Xu, Xu, Xu, Xu, Xu, Xu, Xu, Xu, Xu, Xu, Xu, Xu
Dd, Ds, Dd, Dd, Dd, Cdr, Dd, Rd^Esd, Dd, Dd, Ce, Ke, Ce, Ds, Yhs, Ds, Ds, Hd, Dd, Md, Hd, Hd, Md, Md, Md, Md, Md^Xm, Xu, Xu, Xu, Xu, Xu, Xu, Xu, Xu, Xu, Xu, Xu, Xu, Xu, Xu, Xu, Xu, Xu
Hd, Dd, Dd, Yhs^Xp, Yhs, Dd, Hd, Dd, Dd, Rd, Re, Ce, Dd, Yhs^Xp, Yhs, Yhs^Xp, Yhs, Ds, Ds, Dd, Dd, Hd, Hd, Hhd, Hhd, Md, Md, Md^Xm, Xu, Xu, Xu, Xu, Xu, Xu, Xu, Xu, Xu, Xu, Xu, Xu, Xu, Xu, Xu, Xu
Hd, Hd, Dd, Yhs, Yhs^Xp, Dd, Dd, Dd, Dd, Dd, Dd, Re, Rd, Dd, Dd, Yhs, Ds, Ds^Edpp, Ds, Dd, Dd, Hd, Hd, Md, Hhd, Hhd, Md, Md^Xm, Md^Xm, Xu, Xu, Xu, Xu, Xu, Xu, Xu, Xu, Xu, Xu, Xu, Xu, Xu, Xu, Xu
Hd, Hd, Hd, Yhs, Dd, Dd, Dd, Yhs^Xp, Yhs^Xp, Dd, Dd, Re, Re, Dd, Dd, Dd, Ds^Edpp, Ds^Edpp, Dd, Dd^Edpp, Dd, Hd, Hd, Hd, Hd, Hd, Hd, Md, Md^Xm, Xu, Xu, Xu, Xu, Xu, Xu, Xu, Xu, Xu, Xu, Xu, Xu, Xu, Xu, Xu
Dd, Hd, Dd, Dd, Dd, Hd, Dd, Dd, Dd, Yhs, Dd, Dd, Re, Dd, Dd, Rd^Esd, Dd, Dd^Esd, Ds^Edp, Dd, Dd, Dd, Dd, Hd, Dd, Hd, Hd, Md, Md, Md^Xm, Md^Xm, Xu, Xu, Xu, Xu, Xu, Xu, Xu, Xu, Xu, Xu, Xu, Xu, Xu
Dd, Dd, Dd, Hd, Hd, Dd, Dd, Cdr, Dd, Dd, Dd, Ds, Ds, Re^Esd, Dd, Dd, Dd, Dd, Ds, Cdr, Dd, Dd, Hd, Dd, Hd, Hd, Hd, Hd, Md, Md^Xm, Md^Xm, Xu, Xu, Xu, Xu, Xu, Xu, Xu, Xu, Xu, Xu, Xu, Xu, Xu
Hd, Dd, Dd, Hd, Hd, Hd, Dd, Dd, Hd, Hd, Dd, Dd, Dd^Edpp, Ds, Dd, Rd^Esd, Rd, Ds^Edpp, Ds^Edp, Dd, Dd^Dc, Dd, Dd, Hd, Hd, Hd, Hd, Hd, Md, Md, Hhd, Md^Xm, Md^Xm, Xu, Xu, Xu, Xu, Xu, Xu, Xu, Xu, Xu, Xu, Xu
Dd, Hd, Dd, Hd, Dd, Hd, Dd, Dd, Dd, Hd, Hd, Dd, Dd, Dd, Dd^Dr, Dd, Ds, Rd^Esd, Ds, Dd, Dd, Dd, Hd, Hd, Dd, Hd, Hd, Hd, Hd, Hhd, Hhd, Md, Md^Xm, Xu, Xu, Xu, Xu, Xu, Xu, Xu, Xu, Xu, Xu, Xu
Dd, Hd, Hd, Hd, Hd, Dd, Dd, Hd, Hd, Hd, Hd, Hd, Hd, Ds, Ds, Ds, Ds, Ds, Ds, Dd, Dd, Dd, Hd, Hd, Dd, Hd, Hd, Hd, Hhd, Hhd, Md, Md, Md^Xm, Md^Xm, Md^Xm, Xu, Xu, Xu, Xu, Xu, Xu, Xu, Xu, Xu
Dd, Dd, Dd, Hd, Hd, Hd, Dd, Dd, Dd, Hd, Hd, Hd, Hd, Hd, Dd, Ds^Edp, Ds, Ds, Dd, Rd^Esd, Rd, Dd, Dd, Hd, Hd, Dd, Hd, Hd, Hhd, Md, Md, Md, Md^Xm, Md^Xm, Md^Xm, Xu, Xu, Xu, Xu, Xu, Xu, Xu, Xu, Xu
Hd, Hd, Hd, Hd, Hd, Hd, Hd, Hd, Dd, Dd, Dd, Dd, Dd, Hd, Dd, Dd, Dd, Ds, Dd, Dd, Dd, Dd, Dd, Dd, Hd, Hd, Hd, Hd, Md, Hhd, Md, Md, Md, Md, Md^Xm, Md^Xm, Xu, Xu, Xu, Xu, Xu, Xu, Xu, Xu
