border_size=1
usage=map

Md^Xm       , Md^Xm       , Md^Xm       , Md^Xm       , Md^Xm       , Md^Xm       , Md^Xm       , Md^Xm       , Md^Xm       , Md^Xm       , Md^Xm       , Md^Xm       , Md^Xm       , Md^Xm       , Md^Xm       , Md          , Md          , Md          , Rd          , Md^Xm       , Md^Xm       , Md^Xm       , Md^Xm       , Md^Xm       , Md^Xm       , Md^Xm       , Md^Xm       , Md^Xm       , Md^Xm       , Md^Xm       , Md^Xm       , Md^Xm       , Md^Xm       , Md^Xm       , Md^Xm       , Md^Xm       , Md^Xm       , Md          , Md^Xm       , Md^Xm       , Md^Xm       , Md          
Md^Xm       , Md^Xm       , Md^Xm       , Md^Xm       , Md^Xm       , Md^Xm       , Md^Xm       , Md^Xm       , Md          , Md^Xm       , Md^Xm       , Md^Xm       , Md^Xm       , Md^Xm       , Md^Xm       , Md          , Hd          , Ds          , Rd          , Md          , Md^Xm       , Md^Xm       , Md^Xm       , Md^Xm       , Md^Xm       , Md^Xm       , Md^Xm       , Md^Xm       , Md^Xm       , Md^Xm       , Md^Xm       , Md^Xm       , Md^Xm       , Md^Xm       , Md^Xm       , Md^Xm       , Md^Xm       , Md^Xm       , Md^Xm       , Md^Xm       , Md^Xm       , Md^Xm       
Md^Xm       , Md^Xm       , Md^Xm       , Md^Xm       , Md^Xm       , Md^Xm       , Md^Xm       , Md          , Md          , Md          , Md          , Md          , Md          , Md^Xm       , Md          , Hd          , Hd          , Ds          , Rd          , Hd          , Md          , Md^Xm       , Md          , Md          , Md          , Md          , Hd          , Md          , Md          , Md          , Md          , Md^Xm       , Md          , Md^Xm       , Md^Xm       , Md^Xm       , Md^Xm       , Md^Xm       , Md^Xm       , Md^Xm       , Md^Xm       , Md^Xm       
Md          , Md^Xm       , Md          , Md^Xm       , Md^Xm       , Md^Xm       , Md          , Md          , Hd          , Hd          , Hd          , Md          , Hd          , Md          , Md          , Md          , Rd          , Rd          , Hd          , Hd          , Md          , Md          , Md          , Md          , Hd          , Hd          , Hd          , Md          , Md          , Md          , Md          , Md          , Md          , Md          , Md          , Md          , Md          , Md^Xm       , Md^Xm       , Md^Xm       , Md^Xm       , Md^Xm       
Md          , Md          , Md          , Md          , Md          , Md          , Md          , Hd          , Md          , Md          , Hd          , Hd          , Ys          , Hd          , Ds          , Hd          , Rd          , Ds          , Md          , Md          , Md          , Md          , Hd          , Md          , Hd          , Hd          , Zw          , Hd          , Hd          , Hd          , Hd          , Hd          , Hd          , Md          , Hd          , Md          , Md          , Md          , Md^Xm       , Md^Xm       , Md^Xm       , Md^Xm
Md          , Md          , Md          , Md          , Md          , Md          , Md          , Hd          , Hd          , Hd          , Dd          , Ys^Xp         , Dd          , Hd          , Ds          , Ds          , Ce          , Ce          , Ce          , Dd          , Hd          , Hd          , Hd          , Hd          , Hd          , Zw          , Zw          , Dd          , Zw          , Ys^Xp         , Re          , Hd          , Hd          , Hd          , Hd          , Hd          , Md          , Md          , Md          , Md^Xm       , Md^Xm       , Md^Xm
Md          , Md          , Md          , Md          , Hd          , Hd          , Dd          , Hd          , Re          , Dd          , Rd          , Rd          , Zw          , Dd^Dc       , Ds          , Ds          , Ce          , 1 Ke        , Ce          , Hd          , Dd          , Ys^Xp         , Dd          , Hd          , Dd          , Ys^Xp         , Ys          , Dd          , Zw          , Re          , Re^Uf       , Ys          , Uh          , Dd          , Ys^Xp         , Hd          , Hd          , Md          , Md          , Md^Xm       , Md^Xm       , Md^Xm
Hd          , Hd          , Hd          , Hd          , Zw          , Rd          , Rd          , Re          , Rd          , Rd          , Ys          , Ys^Xp         , Dd^Dc       , Zw          , Re          , Ds          , Ds          , Ce          , Ds          , Ds          , Zw          , Zw          , Dd          , Zw          , Zw          , Ys          , Ys^Xp         , Ys          , Zw          , Zw          , Uu^Uf       , Re^Uf       , Ys          , Ys          , Ys          , Dd          , Dd          , Hd          , Hd          , Md          , Md          , Md^Xm
Hd          , Hd          , Hd          , Dd          , Zw          , Zw          , Rd          , Re          , Re          , Re          , Rd          , Ys          , Ys^Xp         , Re          , Rd          , Rd          , Dd          , Dd^Dc       , Zw          , Zw          , Zw          , Zw          , Ys          , Ys^Xp         , Zw          , Zw          , Ys          , Ys          , Dd          , Dd          , Uu^Uf       , Uh          , Ys^Xp         , Ys          , Dd          , Ys          , Zw          , Dd          , Hd          , Hd          , Md          , Md
Dd          , Hd          , Hd          , Dd          , Rd          , Rd          , Hd          , Ys^Xp         , Re          , Dd          , Dd^Dc       , Rd          , Rd          , Rd          , Dd          , Dd          , Dd          , Zw          , Uh          , Dd          , Dd^Dc       , Dd          , Uh          , Ys          , Ys          , Zw          , Dd          , Ys          , Dd          , Dd          , Dd          , Uu^Uf       , Dd          , Ys          , Dd          , Ys^Xp         , Ys          , Zw          , Hd          , Hd          , Hd          , Md
Zw          , Rd          , Rd          , Ys^Xp         , Ys          , Rd          , Hd          , Dd^Dc       , Ds          , Dd          , Rd          , Re          , Rd          , Re          , Dd          , Zw          , Dd          , Dd          , Dd          , Dd          , Dd          , Uh          , Uh          , Ys          , Zw          , Dd          , Dd          , Dd          , Dd          , Dd          , Zw          , Dd          , Dd          , Dd          , Dd          , Zw          , Ys^Xp         , Ys          , Hd          , Hd          , Hd          , Hd
Qxv         , Zw          , Rd          , Ys          , Ys^Xp         , Hd          , Hd          , Zw          , Zw          , Ds          , Rd          , Rd          , Rd          , Re          , Zw          , Zw          , Ys          , Ys^Xp         , Dd          , Dd          , Ds          , Uh          , Zw          , Zw          , Ys          , Dd          , Qxv         , Qxv         , Dd          , Zw          , Zw          , Zw          , Dd          , Dd          , Hd          , Zw          , Ys          , Hd          , Hd          , Hd          , Dd          , Dd
Ds          , Zw          , Dd          , Dd          , Ds          , Hd          , Hd          , Hd          , Dd          , Zw          , Ds          , Hd          , Zw          , Zw          , Dd          , Ys          , Zw          , Dd          , Dd          , Ds          , Dd          , Ds          , Qxv         , Qxv         , Ys          , Ys^Xp         , Qxv         , Qxv         , Uu^Uf       , Dd          , Dd          , Zw          , Dd          , Dd          , Dd          , Hd          , Hd          , Hd          , Dd          , Dd          , Dd          , Dd
Ds          , Ds          , Dd          , Dd          , Dd          , Ds          , Ds          , Dd          , Dd          , Zw          , Ds          , Ds          , Ys^Xp         , Zw          , Ys          , Ys^Xp         , Zw          , Zw          , Dd          , Zw          , Uu^Uf       , Uu^Uf       , Dd          , Qxv         , Dd          , Dd          , Qxv         , Qxv         , Dd          , Dd          , Dd          , Dd          , Dd          , Dd          , Dd          , Hd          , Hd          , Dd          , Dd          , Dd          , Dd          , Dd
Dd          , Dd          , Dd          , Dd          , Zw          , Ds          , Dd          , Dd          , Dd          , Zw          , Zw          , Ys          , Ys          , Ys          , Dd          , Dd          , Dd          , Dd          , Dd          , Zw          , Uh          , Uu^Uf       , Dd          , Dd          , Qxv         , Qxv         , Dd          , Qxv         , Dd          , Dd          , Dd          , Dd          , Rd          , Rd          , Dd          , Dd          , Dd          , Dd          , Dd          , Dd          , Dd          , Dd
Dd          , Dd          , Zw          , Zw          , Dd          , Dd          , Qxv         , Dd          , Re^Uf       , Dd          , Dd          , Dd          , Zw          , Zw          , Dd          , Dd          , Dd          , Dd          , Dd          , Dd          , Dd          , Dd          , Dd          , Dd          , Dd          , Dd          , Dd          , Dd          , Dd          , Dd          , Uu^Uf       , Uu^Uf       , Qxv         , Zw          , Dd          , Dd          , Dd          , Dd          , Zw          , Zw          , Zw          , Dd          
Dd          , Dd          , Zw          , Zw          , Ys^Xp         , Qxv         , Qxv         , Uu^Uf       , Re^Uf       , Re^Uf       , Dd          , Dd          , Zw          , Zw          , Dd          , Dd          , Dd          , Ys          , Qxv         , Uu^Uf       , Re^Uf       , Dd          , Dd          , Dd          , Dd          , Dd          , Dd          , Dd          , Zw          , Re^Uf       , Uu^Uf       , Qxv         , Qxv         , Ys          , Dd          , Dd          , Dd          , Zw          , Re^Uf       , Zw          , Zw          , Dd
Zw          , Zw          , Zw          , Ys          , Ys          , Qxv         , Qxv         , Ys          , Uu^Uf       , Uu^Uf       , Dd          , Zw          , Hd          , Hd          , Dd          , Dd          , Ys          , Ys^Xp         , Qxv         , Uu^Uf       , Uu^Uf       , Hd          , Hd          , Dd          , Hd          , Dd          , Dd          , Dd          , Zw          , Re^Uf       , Re^Uf       , Qxv         , Ys          , Ys^Xp         , Ys          , Dd          , Dd          , Zw          , Re^Uf       , Zw          , Ys^Xp         , Dd
Zw          , Zw          , Ds          , Ys          , Qxv         , Qxv         , Ys          , Ys          , Ds          , Dd          , Dd          , Hd          , Hd          , Hd          , Dd          , Dd          , Qxv         , Ys          , Qxv         , Qxv         , Re^Uf       , Re^Uf       , Hd          , Hd          , Dd          , Dd          , Dd          , Dd          , Zw          , Zw          , Dd          , Zw          , Zw          , Ys          , Ys^Xp         , Dd          , Ys^Xp         , Re^Uf       , Uu^Uf       , Re^Uf       , Dd          , Dd
Ds          , Dd          , Hd          , Dd          , Ds          , Qxv         , Dd          , Ds          , Ds          , Ds          , Ds          , Hd          , Hd          , Dd          , Qxv         , Qxv         , Qxv         , Qxv         , Qxv         , Qxv         , Re^Uf       , Zw          , Zw          , Hd          , Zw          , Zw          , Dd          , Dd          , Dd          , Zw          , Dd          , Dd          , Zw          , Zw          , Zw          , Zw          , Ys^Xp         , Uu^Uf       , Ys^Xp         , Uu^Uf       , Qxv         , Dd
Dd          , Dd          , Hd          , Hd          , Ds          , Ds          , Dd          , Zw          , Zw          , Dd          , Ds          , Dd          , Dd          , Dd          , Qxv         , Qxv         , Ys^Xp         , Ys          , Qxv         , Qxv         , Dd          , Zw          , Zw          , Hd          , Zw          , Zw          , Dd          , Dd          , Dd          , Dd          , Dd          , Dd          , Dd          , Zw          , Zw          , Zw          , Rd          , Ys          , Ys          , Qxv         , Qxv         , Dd
Ds          , Dd          , Hd          , Hd          , Hd          , Dd          , Qxv         , Zw          , Zw          , Zw          , Ds          , Dd          , Qxv         , Qxv         , Qxv         , Ys          , Ys          , Ys          , Ys          , Qxv         , Dd          , Dd          , Hd          , Dd          , Dd          , Dd          , Dd          , Dd          , Qxv         , Qxv         , Dd          , Dd          , Dd          , Dd          , Dd          , Dd          , Zw          , Zw          , Dd          , Ys^Xp         , Dd          , Dd
Dd          , Ds          , Dd          , Hd          , Dd          , Dd          , Qxv         , Ys          , Ys^Xp         , Ys          , Hd          , Ds          , Dd          , Qxv         , Dd          , Dd          , Zw          , Dd          , Ys          , Qxv         , Dd          , Hd          , Hd          , Dd          , Dd          , Dd          , Re^Uf       , Ys          , Ys          , Qxv         , Ys          , Zw          , Zw          , Dd          , Dd          , Hd          , Dd          , Zw          , Rd          , Rd          , Zw          , Dd
Dd          , Zw          , Zw          , Dd          , Zw          , Dd          , Qxv         , Qxv         , Ys          , Ys          , Hd          , Hd          , Dd          , Dd          , Dd          , Zw          , Zw          , Dd          , Ys          , Ys          , Dd          , Dd          , Hd          , Hd          , Hd          , Dd          , Re^Uf       , Ys^Xp         , Ys          , Qxv         , Ys          , Ys^Xp         , Re^Uf       , Zw          , Hd          , Hd          , Dd          , Zw          , Rd          , Zw          , Zw          , Dd
Dd          , Dd          , Zw          , Zw          , Zw          , Dd          , Dd          , Dd          , Dd          , Hd          , Dd          , Zw          , Dd          , Dd          , Dd          , Zw          , Zw          , Zw          , Dd          , Dd          , Dd          , Dd          , Dd          , Hd          , Uu^Cd       , Uu^Cd       , Uu^Cd       , Re^Uf       , Ys          , Ys          , Ys^Xp         , Re^Uf       , Dd          , Hd          , Dd          , Hd          , Hd          , Rd          , Dd          , Rd          , Dd          , Zw
Dd          , Dd          , Re^Uf       , Uu^Uf       , Re^Uf       , Zw          , Zw          , Dd          , Dd          , Dd          , Dd          , Dd          , Dd          , Dd          , Dd          , Dd          , Dd          , Dd          , Dd          , Dd          , Dd          , Dd          , Hd          , Uu^Cd       , Uu^Kd       , Uu^Cd       , Qxv         , Ys          , Ys          , Ys          , Zw          , Dd          , Dd          , Hd          , Dd          , Dd          , Hd          , Rd          , Zw          , Dd          , Dd          , Dd
Dd          , Dd          , Uu^Uf       , Re^Uf       , Ys          , Re^Uf       , Dd          , Dd          , Dd          , Dd          , Qxv         , Dd          , Qxv         , Hd          , Hd          , Dd          , Dd          , Dd          , Zw          , Dd          , Dd          , Dd          , Dd          , Uu^Cd       , Uu^Cd       , Qxv         , Uu^Cd       , Ys          , Ys          , Zw          , Zw          , Dd          , Dd          , Dd          , Zw          , Hd          , Dd          , Hd          , Dd          , Uu^Cd       , Uu^Cd       , Dd
Dd          , Dd          , Qxv         , Ys          , Ys^Xp         , Dd          , Dd          , Dd          , Dd          , Dd          , Dd          , Qxv         , Qxv         , Qxv         , Hd          , Hd          , Ys          , Dd          , Dd          , Dd          , Zw          , Dd          , Dd          , Hd          , Dd          , Qxv         , Ys          , Ys          , Dd          , Dd          , Dd          , Dd          , Zw          , Zw          , Ys          , Zw          , Dd          , Dd          , Dd          , Dd          , Zw          , Zw
Qxv         , Dd          , Qxv         , Dd          , Dd          , Dd          , Zw          , Dd          , Dd          , Dd          , Dd          , Qxv         , Qxv         , Dd          , Re^Uf       , Hd          , Ys          , Ys^Xp         , Dd          , Zw          , Zw          , Zw          , Dd          , Dd          , Dd          , Dd          , Dd          , Dd          , Dd          , Dd          , Dd          , Dd          , Re^Uf       , Zw          , Ys          , Ys^Xp         , Dd          , Dd          , Dd          , Dd          , Zw          , Zw
Qxv         , Qxv         , Dd          , Dd          , Dd          , Zw          , Zw          , Zw          , Dd          , Dd          , Re^Uf       , Dd          , Dd          , Re^Uf       , Uu^Uf       , Ys          , Dd          , Dd          , Dd          , Dd          , Dd          , Zw          , Ys          , Dd          , Dd          , Dd          , Dd          , Dd          , Dd          , Zw          , Zw          , Dd          , Dd          , Re^Uf       , Dd          , Dd          , Qxv         , Dd          , Dd          , Qxv         , Dd          , Zw
Dd          , Qxv         , Hd          , Hd          , Hd          , Zw          , Dd          , Dd          , Dd          , Ys^Xp         , Uu^Uf       , Re^Uf       , Dd          , Dd          , Uu^Uf       , Ys          , Re^Uf       , Re^Uf       , Qxv         , Qxv         , Dd          , Dd          , Dd          , Dd          , Zw          , Zw          , Dd          , Dd          , Dd          , Zw          , Ys          , Dd          , Dd          , Re^Uf       , Dd          , Dd          , Qxv         , Qxv         , Qxv         , Qxv         , Rd          , Dd
Dd          , Dd          , Hd          , Hd          , Dd          , Dd          , Dd          , Dd          , Qxv         , Uu^Uf       , Ys          , Re^Uf       , Re^Uf       , Dd          , Dd          , Uu^Uf       , Uu^Uf       , Dd          , Qxv         , Qxv         , Dd          , Hd          , Dd          , Dd          , Dd          , Dd          , Dd          , Dd          , Zw          , Dd          , Dd          , Ys^Xp         , Ys          , Re^Uf       , Zw          , Dd          , Dd          , Qxv         , Qxv         , Qxv         , Rd          , Dd
Dd          , Dd          , Hd          , Hd          , Dd          , Dd          , Dd          , Dd          , Qxv         , Qxv         , Dd          , Dd          , Dd          , Zw          , Re^Uf       , Uu^Uf       , Dd          , Dd          , Dd          , Qxv         , Qxv         , Hd          , Hd          , Dd          , Dd          , Dd          , Dd          , Zw          , Dd          , Dd          , Dd          , Ys          , Dd          , Zw          , Zw          , Dd          , Dd          , Dd          , Qxv         , Qxv         , Dd          , Dd
Zw          , Dd          , Zw          , Hd          , Dd          , Dd          , Ys^Xp         , Dd          , Dd          , Dd          , Dd          , Zw          , Zw          , Zw          , Uu^Uf       , Uu^Uf       , Uu^Uf       , Dd          , Dd          , Qxv         , Qxv         , Qxv         , Qxv         , Dd          , Zw          , Dd          , Ys          , Zw          , Dd          , Dd          , Dd          , Dd          , Dd          , Dd          , Uh          , Hd          , Hd          , Hd          , Dd          , Qxv         , Hd          , Hd
Ys          , Zw          , Zw          , Dd          , Dd          , Dd          , Ys          , Ys          , Dd          , Dd          , Dd          , Zw          , Zw          , Zw          , Re^Uf       , Ys^Xp         , Ys          , Uu^Uf       , Dd          , Dd          , Dd          , Dd          , Dd          , Dd          , Ys^Xp         , Uh          , Ys^Xp         , Zw          , Dd          , Dd          , Dd          , Dd          , Zw          , Dd          , Dd          , Hd          , Md          , Hd          , Hd          , Hd          , Hd          , Md
Ys          , Ys          , Zw          , Dd          , Dd          , Zw          , Zw          , Ys          , Dd          , Dd          , Hd          , Dd          , Zw          , Zw          , Hd          , Re^Uf       , Ys          , Ys^Xp         , Hd          , Hd          , Dd          , Dd          , Dd          , Ys          , Ys          , Zw          , Ys          , Dd          , Hd          , Dd          , Dd          , Dd          , Zw          , Zw          , Dd          , Hd          , Hd          , Md          , Md          , Hd          , Md          , Md
Dd          , Ys          , Ys^Xp         , Dd          , Dd          , Ys          , Ys^Xp         , Zw          , Zw          , Dd          , Hd          , Hd          , Dd          , Zw          , Hd          , Ys^Xp         , Ys          , Ys          , Hd          , Zw          , Dd          , Dd          , Dd          , Zw          , Uh          , Ys^Xp         , Zw          , Hd          , Zw          , Dd          , Dd          , Dd          , Dd          , Zw          , Dd          , Hd          , Hd          , Md          , Md          , Md          , Xu          , Xu
Zw          , Ys          , Ys          , Dd          , Dd          , Ys          , Dd          , Ys          , Zw          , Dd          , Dd          , Dd          , Dd          , Hd          , Dd          , Hd          , Ys          , Hd          , Ys          , Zw          , Dd          , Dd          , Hd          , Uh          , Uh          , Zw          , Zw          , Zw          , Dd          , Zw          , Dd          , Dd          , Dd          , Hd          , Hd          , Hd          , Hd          , Md          , Xu          , Xu          , Xu          , Xu
Dd          , Zw          , Dd          , Ys          , Dd          , Dd          , Hd          , Dd          , Hd          , Uu^Cd       , Zw          , Dd          , Dd          , Dd          , Dd          , Dd          , Dd          , Ys^Xp         , Ys          , Hd          , Dd          , Dd          , Hd          , Uh          , Hd          , Dd          , Dd          , Dd          , Dd          , Dd          , Hd          , Hd          , Hd          , Hd          , Md          , Hd          , Rd          , Xu          , Xu          , Xu          , Xu          , Xu
Hd          , Dd          , Dd          , Dd          , Hd          , Dd          , Dd          , Hd          , Hd          , Zw          , Uh          , Zw          , Re^Uf       , Dd          , Dd          , Dd          , Dd          , Dd          , Dd          , Hd          , Hd          , Dd          , Hd          , Hd          , Hd          , Ys^Xp         , Dd          , Dd          , Dd          , Hd          , Md          , Md          , Md          , Md          , Xu          , Xu          , Uu          , Rd          , Rd          , Uu^Uf       , Uu^Uf       , Xu
Zw          , Hd          , Hd          , Dd          , Hd          , Dd          , Ys^Xp         , Dd          , Dd          , Hd          , Dd          , Uh          , Dd          , Re^Uf       , Dd          , Dd          , Dd          , Dd          , Dd          , Hd          , Ys          , Dd          , Dd          , Hd          , Dd          , Ys          , Ys^Xp         , Dd          , Hd          , Hd          , Md          , Md          , Xu          , Xu          , Xu          , Xu          , Uh          , Uu^Uf       , Uu          , Rd          , Rd          , Uh
Zw          , Zw          , Ys^Xp         , Hd          , Ys          , Ys          , Dd          , Dd          , Dd          , Dd          , Dd          , Dd          , Hd          , Hd          , Hd          , Hd          , Hd          , Dd          , Dd          , Dd          , Ys          , Ys^Xp         , Ys^Xp         , Ys          , Ys          , Ys          , Hd          , Hd          , Md          , Md          , Xu          , Xu          , Xu          , Xu          , Xu          , Xu          , Xu          , Xu          , Xu          , Uh          , Uh          , Rd
