Ww, Ds, Ds, Hhd, Hhd, Md, Md, Md, Md, Md, Md, Md, Hd, Dd, Rd, Dd, Hd, Hhd, Hhd, Md, Md, Hhd, Hd, Hd, Hd, Hd, Hd, Md, Md, Md, Hhd, Md, Md, Dd
Ww, Ds, Ds, Ds, Hhd, Md, Md, Md, Md, Md, Md, Hhd, Hd, Dd, Rd, Dd, Dd, Hhd, Hhd, Md, Md, Hhd, Hhd, Hd, Hhd, Hhd, Hhd, Md, Hhd, Hhd, Hhd, Md, Md, Md
Ww, Ww, Ww, Ds, Hhd, Hhd, Hhd, Hhd, Md, Hhd, Md, Hhd, Hd, Dd, Dd, Ds, Dd, Hd, Hhd, Hhd, Hhd, Md, Hhd, Hhd, Hhd, Hhd, Hd, Hhd, Hd, Hhd, Hhd, Md, Md, Dd
Ds, Ww, Ww, Ds, Ds, Hhd, Hhd, Md, Md, Md, Md, Hhd, Hhd, Dd, Dd, Rd, Rd, Hd, Hd, Hhd, Hhd, Md, Hhd, Hhd, Hhd, Hhd, Hd, Md, Hd, Hd, Hhd, Hhd, Md, Dd
Ds, Ds, Ww, Ww, Ds, Ds, Hhd, Hhd, Md, Md, Hhd, Md, Hhd, Hd, Dd, Rd, Rd, Dd^Edp, Dd, Hd, Hd, Md, Md, Hhd, Md, Md, Md, Hd, Hd, Hhd, Hhd, Hhd, Md, Md
Hhd, Ds, Ds, Ww, Ww, Hhd, Hhd, Hhd, Hhd, Md, Hhd, Hd, Hd, Hd, Dd^Edp, Gd, Rd, Dd, Dd^Edp, Dd, Hd, Hd, Hd, Md, Md, Md, Hhd, Hhd, Md, Md, Md, Hhd, Md, Md
Hhd, Hhd, Hhd, Ww, Ds, Ww, Ww, Hhd, Ds, Hd, Hd, Hd, Hd, Dd^Edp, Gd, Gd, Gd, Re, Gd, Dd, Gd, Hd, Ds, Md, Hhd, Md, Hhd, Hhd, Md, Md, Md, Md, Md, Md
Md, Md, Hhd, Ds, Ds, Ww, Ww, Ww, Ww, Ds, Ww, Ds, Gs, Gd, Gs, Gd, Gd, Re, Re, Gd, Gs, Gd, Ds, Hd, Hhd, Hhd, Hhd, Hhd, Md, Md, Md, Hhd, Hhd, Md
Md, Hhd, Hhd, Ds, Hhd, Ds, Ww, Ww, Ww, Ww, Wwf, Ww, Ww, Ww, Wwf, Ww, Ww, Wwf, Wwf, Ww, Wwf, Gs, Hd, Hd, Hhd, Hhd, Hhd, Hhd, Hhd, Md, Md, Md, Hhd, Hhd
Hhd, Hhd, Mdd, Hhd, Mdd, Hhd, Hhd, Ds, Ww, Ww, Wwf, Wwf, Ww, Ww, Ww, Ww, Gd, Wwf, Ce, Wwf, Wwf, Gs, Hd, Hd, Hd, Hhd, Hhd, Hhd, Gs, Md, Hhd, Md, Md, Hhd
Mdd, Mdd, Mdd, Mdd, Mdd, Hhd, Md, Hhd, Md, Hhd, Md, Hhd, Hhd, Gd, Gd, Gd, Gs, Ce, 1 Ke, Ce, Ww, Wwf, Wwf, Hd, Gs, Gs, Gs, Gs, Gs, Hhd, Hhd, Hhd, Md, Hhd
Mdd, Mdd, Mdd, Mdd, Mdd, Hhd, Md, Hhd, Hhd, Md, Md, Md, Hhd, Hhd, Hhd, Gd, Gs, Ce, Ce, Ce, Ww, Wwf, Wwf, Ww, Ww, Wwf, Ww, Wwf, Ww, Gs, Gs, Hhd, Md, Hhd
Mdd, Mdd, Mdd, Hd, Hd, Hd, Hhd, Md, Md, Md, Md^Xm, Hhd, Md, Md, Hhd, Gd, Gd, Re, Wwf, Wwf, Wwf, Wwf, Gs, Wwf, Wwf, Wwf, Ww, Ww, Ww, Ww, Gs, Gs, Hhd, Md
Mdd, Mdd, Mdd, Hd, Dd, Hd, Hd, Hhd, Md, Md, Md, Md, Hhd, Hhd, Ds, Gd, Gd, Re, Gs, Wwf, Gs, Gs, Gd, Gs, Hhd, Hhd, Md, Ww, Ww, Ww, Ww, Gs, Gs, Hhd
Mdd, Hd, Hd, Hd, Dd, Dd, Mdd, Hd, Hd, Hd, Hhd, Hhd, Hhd, Hhd, Dd^Edp, Ds^Edp, Rd, Rd, Gd, Gs, Gd, Gd, Hhd, Hhd, Hhd, Md, Md, Md, Md, Ww, Ww, Ww, Ww, Gs
Mdd, Mdd, Hd, Hd, Hd, Mdd, Mdd, Mdd, Hd, Hd, Dd, Hd, Ds, Ds, Rd, Ds, Dd^Edp, Dd, Hd, Hhd, Hhd, Hhd, Hhd, Hhd, Hhd, Md, Md, Md, Md, Md, Md, Ww, Ww, Ww
Hd, Mdd, Hd, Hd, Dd, Hd, Hd, Hd, Hd, Ds, Dd, Ds^Edp, Ds, Rd, Dd, Dd, Dd^Edp, Dd, Dd, Hhd, Dd, Md, Md, Md, Hhd, Hhd, Md, Md, Md, Md, Md, Ww, Ww, Ww
Hd, Hd, Hd, Hd, Mdd, Dd, Hd, Hd, Ds, Dd, Rd, Dd, Dd, Dd, Dd, Hd, Dd, Ce, 2 Ke, Ce, Dd^Edp, Hd, Hhd, Md, Md, Hhd, Hhd, Md, Md, Md, Md, Md, Md, Ww
Dd, Hd, Mdd, Mdd, Dd, Dd, Hd, Hd, Ds, Dd, Rd, Dd, Dd, Dd, Hd, Hd, Dd, Ce, Ce, Ce, Dd, Dd, Md, Hhd, Md, Md, Md, Hhd, Hhd, Md, Md, Md, Md, Md
Hd, Dd, Dd, Dd, Dd, Dd, Hd, Ds, Ds, Rd, Ds, Dd, Dd, Dd, Ds, Ds, Hd, Dd, Hd, Dd, Hd, Hhd, Md, Hhd, Hhd, Md, Hhd, Md, Md, Hhd, Md, Md, Md, Md
Hd, Hd, Hd, Dd, Dd, Dd, Ds, Ds, Rd, Ds, Ds^Edp, Ds, Ds, Ds, Ds^Edp, Ds, Hd, Hd, Hd, Hd, Hd, Hhd, Md, Md, Md, Hhd, Hhd, Hhd, Hhd, Md, Md, Md, Md, Md
Ds, Hd, Mdd, Dd, Ds, Dd, Ds, Rd, Ds, Ds, Ds, Ds, Hd, Ds, Ds, Ds, Hd, Hd, Hd, Hd, Hd, Md, Md, Md, Md, Md, Md, Hhd, Md, Hhd, Hhd, Hhd, Md, Md
Hd, Hd, Mdd, Hd, Dd, Dd, Dd, Rd, Ds, Ds, Ds, Hd, Hd, Hd, Hd, Ds, Ds, Dd, Dd, Dd, Dd, Md, Md, Md, Md, Md, Md, Md, Hhd, Md, Md, Hhd, Hhd, Md
Hd, Hd, Hd, Hd, Mdd, Dd, Dd, Ds, Ds, Rd, Rd, Ds, Dd, Hd, Hd, Dd, Dd^Edp, Dd, Dd, Dd, Dd, Md, Hhd, Md, Hhd, Md, Hhd, Hhd, Hhd, Md, Md, Md, Hhd, Hhd
Hd, Dd, Hd, Hd, Hd, Mdd, Hd, Dd, Dd, Ds, Rd, Ds, Ds, Dd, Hd, Ds, Dd, Dd, Dd, Dd, Hd, Hd, Dd, Hhd, Dd, Hhd, Hhd, Hhd, Md, Hhd, Md, Md, Hhd, Hhd
Hd, Dd, Dd, Hd, Mdd, Mdd, Dd, Hd, Hd, Dd, Ds, Rd, Rd, Ds, Ds, Dd, Hd, Hd, Hd, Dd, Dd, Hd, Hd, Dd, Dd, Hd, Hd, Hhd, Hhd, Md, Md, Md, Md, Md
Dd, Dd, Dd, Dd, Dd, Ds, Ds, Hd, Dd, Dd, Ds, Ds, Ds, Ds, Ds, Dd, Dd, Ds, Ds, Ds, Dd, Dd, Hd, Hd, Hd, Dd, Dd, Hhd, Hd, Md, Md, Md, Md, Md
