Ww, Ds, Ds^Qhh, Hhd^Qhh, Hhd^Qhh, Md^Qhh, Md^Qhh, Md^Qhh, Md^Qhh, Md^Qhh, Md^Qhh, Md^Qhh, Hd^Qhh, Dd, Rd, Dd, Hd, Hhd, Md, Md^Qhh, Md, Hhd, Hd, Hd, Hd, Hd, Hd, Md, Md, Md, Hhd, Md, Md, Dd
Ww, Ds, Ds, Ds^Qhh, Hhd, Md, Md, Md, Md, Md, Md, Hhd, Hd^Qhh, Dd, Rd, Dd, Dd, Hhd, Md, Md^Qhh, Md^Qhh, Hhd, Hhd, Hd, Hhd, Hhd, Hhd, Md, Hhd, Hhd, Hhd, Md, Md, Md
Wo, Ww, Ww, Ds^Qhh, Hhd, Hhd, Hhd, Hhd, Md, Hhd, Md^_mh, Hhd, Hd, Dd^Qhh, Dd, Ds, Dd, Hd, Hhd, Md, Md, Md^Qhh, Hhd, Hhd, Hhd, Hhd, Hd, Hhd, Hd, Hhd, Hhd, Md, Md, Dd
Ww, Wo, Ww, Ds^Qhh, Ds^Qhh, Hhd^Qhh, Hhd^Qhh, Md, Md, Md, Md, Hhd, Hhd, Dd^Qhh, Dd, Rd^Esd, Rd, Hd, Hd, Hhd, Md, Md^Qhh, Hhd, Hhd, Hhd, Hhd, Hd, Md, Hd, Hd, Hhd, Hhd, Md, Dd
Ds, Wo, Ww, Ww, Ds, Ds, Hhd^Qhh, Hhd, Md, Md, Hhd, Md, Hhd, Hd^Qhh, Dd, Rd, Rd, Dd^Edp, Dd, Hhd, Md, Md^Qhh, Md^Qhh, Hhd, Md, Md, Md, Hd, Hd, Hhd^_mh, Hhd, Hhd, Md, Md
Hhd, Ww, Wo, Ww, Ww, Hhd^Qhh, Hhd^Qhh, Hhd, Hhd, Md, Hhd, Hd, Hd^Qhh, Hd^Qhh, Dd^Edp, Gd, Rd^Esd, Dd, Dd^Edp, Dd, Hd, Md, Md, Md^Qhh, Md^Qhh, Md, Hhd, Hhd, Md, Md, Md, Hhd, Md, Md
Hhd, Ds, Ds, Wwr, Wo, Wo, Wo, Hhd^Qhh, Ds^Qhh, Hd, Hd^Qhh, Hd, Hd^Qhh, Dd^Edp, Gd, Gd, Gd, Re, Gd, Dd, Gd, Hhd, Hhd, Md, Md, Md^Qhh, Hhd, Hhd, Md, Md, Md, Md, Md, Md
Md, Md, Hhd^Qhh, Ds^Qhh, Ds^Qhh, Wo, Wo, Ww, Ww, Ds^Qhh, Wwr, Ds^Qhh, Ds, Ds, Ds, Gd, Gd, Re, Re, Gd, Ds, Hhd, Hhd^Esd, Md, Md^Qhh, Md^Qhh, Hhd, Hhd, Md, Md, Md, Hhd, Hhd, Md
Md, Hhd, Hhd^Qhh, Ds, Hhd, Ds^Qhh, Wwr, Wo, Ww, Wwr, Wwf, Ww, Ww, Ww, Wwf, Ww, Ww, Wwf, Wwf, Ww, Wwf, Ds, Hd, Md, Hhd^Qhh, Hhd, Hhd, Hhd, Hhd, Md, Md, Md, Hhd, Hhd
Hhd, Hhd, Mdd^Qhh, Hhd, Mdd, Hhd^Qhh, Hhd^Qhh, Ww, Wwr, Ww, Wwf, Wwf, Wwr, Ww, Ww, Ww, Wwf, Wwr, Ce, Wwf, Ww, Ds, Hd, Hd, Hd, Hhd^Qhh, Hhd, Hhd, Gs, Md, Hhd, Md, Md, Hhd
Mdd^Qhh, Mdd^Qhh, Mdd, Mdd, Mdd, Hhd, Md^Qhh, Hhd, Md, Hhd, Ds, Ds, Ds, Wwr, Ds, Ds, Ds, Ce, 1 Ke, Ce, Ww, Wwf, Wwr, Hd, Gs, Gs^Qhh, Gs^Qhh, Gs^Qhh, Gs^Qhh, Hhd, Hhd^Qhh, Hhd, Md^Qhh, Hhd
Mdd^Qhh, Mdd, Mdd, Mdd, Mdd^_mh, Hhd, Md^Qhh, Hhd, Hhd, Hhd, Hhd, Ds, Wwf, Wwf, Ds, Gd, Gs, Ce, Ce, Ce, Ww, Wwr, Wwf, Ww, Ww, Wwf, Ww, Wwf, Ww, Gs^Qhh, Ds, Hhd^Qhh, Md, Hhd^Qhh
Mdd^Qhh, Mdd, Mdd, Hd, Hd, Hd, Hhd, Md^Qhh, Md^Qhh, Md, Hhd, Ds, Gd, Wwf, Ds, Gd, Gd, Re, Wwf, Wwf, Wwr, Wwf, Gs^Qhh, Wwr, Wwf, Wwf, Ww, Ww, Wo, Wwr, Wo, Ds, Hhd, Md
Mdd^Qhh, Mdd^Qhh, Mdd^Qhh, Hd^Qhh, Dd^Qhh, Hd, Hd, Hhd, Md^Qhh, Md, Md, Hhd, Hhd, Ds, Ds, Gd, Gd, Re, Gs, Wwf, Ds, Gs^Qhh, Gd, Gs^Qhh, Hhd^Qhh, Hhd^Qhh, Md^Qhh, Wwr, Wwr, Wo, Wo, Wo, Ww, Hhd
Mdd, Hd, Hd, Hd, Dd^Qhh, Dd, Mdd, Hd, Hd^Qhh, Hd, Hhd, Hhd, Hhd, Hhd, Dd^Edp, Ds^Edp, Rd, Rd, Gd, Ds, Gd, Gd^Qhh, Hhd^Qhh, Hhd, Hhd, Md, Md, Md^Qhh, Md^Qhh, Ww, Ww, Wo, Wo, Ww
Mdd, Mdd, Hd, Hd, Hd^Qhh, Mdd, Mdd, Mdd, Hd^Qhh, Hd, Dd, Hd, Ds, Ds^Esd, Rd^Esd, Ds, Dd^Edp, Dd, Hd, Gd, Hhd, Hhd, Md, Hhd^Qhh, Hhd, Md, Md, Md, Md, Md^Qhh, Md^Qhh, Wo, Wo, Wo
Hd, Mdd, Hd, Hd, Dd, Hd^Qhh, Hd^Qhh, Hd^Qhh, Hd, Ds, Dd, Ds^Edp, Ds, Rd, Dd, Dd, Dd^Edp, Dd, Dd, Hhd, Dd, Md, Md, Md^Qhh, Hhd, Hhd, Md, Md, Md, Md, Md^Qhh, Wwr, Ww, Ww
Hd, Hd, Hd, Hd, Mdd, Dd, Hd, Hd, Ds, Dd, Rd, Dd, Dd, Dd, Dd, Hd, Dd, Ce, 2 Ke, Ce, Dd^Edp, Hd, Md, Md^Qhh, Md^Qhh, Hhd, Hhd, Md, Md, Md, Md, Md^Qhh, Md^Qhh, Ds
Dd, Hd, Mdd, Mdd, Dd, Dd, Hd, Hd, Ds, Dd, Rd, Dd, Dd, Dd, Hd, Hd, Dd, Ce, Ce, Ce, Dd, Dd, Md, Md, Md, Md^Qhh, Md, Hhd, Hhd, Md, Md, Md, Md, Md^Qhh
Hd^Qhh, Dd, Dd, Dd, Dd, Dd, Hd, Ds, Ds, Rd, Ds, Dd, Dd, Dd, Ds, Ds, Hd, Dd, Hd, Dd, Hd, Hhd, Md, Hhd, Md, Md^Qhh, Hhd, Md, Md, Hhd, Md, Md^_mh, Md, Md
Hd^Qhh, Hd^Qhh, Hd^Qhh, Dd, Dd, Dd, Ds, Ds, Rd, Ds, Ds^Edp, Ds, Ds, Ds, Ds^Edp, Ds, Hd, Hd, Hd, Hd, Hd, Hhd, Md, Md, Md, Hhd^Qhh, Hhd, Hhd, Hhd, Md, Md, Md, Md, Md
Ds^Qhh, Hd, Mdd^Qhh, Dd, Ds, Dd, Ds, Rd, Ds, Ds, Ds, Ds, Hd, Ds, Ds, Ds, Hd, Hd, Hd, Hd, Hd, Md, Md, Md, Md, Md^Qhh, Md^Qhh, Hhd, Md^Qhh, Hhd, Hhd, Hhd, Md, Md
Hd^Qhh, Hd, Mdd, Hd^Qhh, Dd, Dd, Dd, Rd, Ds, Ds, Ds, Hd, Hd, Hd, Hd, Ds, Ds^Qhu, Dd^Qhu, Dd^Qhu, Dd, Dd, Md, Md, Md, Md, Md, Md, Md^Qhh, Md, Md^Qhh, Md^Qhh, Hhd, Hhd, Md
Hd^Qhh, Hd, Hd^_mh, Hd^Qhh, Mdd^Qhh, Dd, Dd, Ds, Ds, Rd, Rd, Ds, Dd, Hd, Hd, Dd^Qhu, Dd^Edp, Dd^_ml, Dd, Dd^Qhu, Dd, Md, Hhd, Md, Hhd, Md, Hhd, Md, Hhd, Md, Md, Md^Qhh, Hhd, Hhd
Hd^Qhh, Dd, Hd, Hd, Hd, Mdd^Qhh, Hd^Qhh, Dd, Dd, Ds, Rd^Esd, Ds, Ds, Dd, Hd, Ds^Qhu, Dd, Dd, Dd^Qhu, Dd^Qhu, Hd, Hd, Dd, Hhd, Dd, Hhd, Hhd, Hhd, Md, Hhd, Md, Md^Qhh, Hhd^Qhh, Hhd
Hd^Qhh, Dd, Dd, Hd, Mdd, Mdd, Dd^Qhh, Hd, Hd, Dd, Ds, Rd, Rd, Ds^Esd, Ds^Qhu, Dd^Qhu, Hd, Hd, Hd^Qhu, Dd, Dd, Hd, Hd, Dd, Dd, Hd, Hd, Hhd, Hhd, Md, Md, Md, Md, Md^Qhh
Dd^Qhh, Dd^Qhh, Dd^Qhh, Dd^Qhh, Dd^Qhh, Ds^Qhh, Ds, Hd, Dd, Dd, Ds, Ds, Ds, Ds, Ds^Qhu, Dd, Dd, Ds, Ds, Ds^Qhu, Dd^Qhu, Dd, Hd, Hd, Hd, Dd, Dd, Hhd, Hd, Md, Md, Md, Md, Md^Qhh
