Dd, Rd, Rd, Dd, Dd, Dd, Hd, Dd, Hd, Hd, Mdd, Mdd, Hd, Mdd, Mdd, Mdd, Mdd, Mdd, Mdd, Mdd^Xm, Mdd, Mdd, Mdd^Xm, Mdd^Xm, Mdd, Md^Xm, Mdd, Mdd, Hd, Hd, Hd, Hd, Ds, Hd, Dd, Ds, Ds, Ds, Hd, Hd, Hd, Dd, Dd, Dd, Rd, Dd, Dd, Hd, Hd, Hd, Hd, Mdd^Xm, Hd, Mdd, Mdd^Xm, Mdd^Xm, Mdd^Xm, Mdd, Mdd, Mdd, Hd, Dd, Dd, Dd, Rd, Rd, Ds, Ds, Hd, Mdd, Mdd, Md^Xm, Mdd, Hd, Hd, Mdd, Mdd
Dd, Dd, Dd, Dd, Dd, Dd, Hd, Hd, Dd, Mdd, Mdd, Hd, Hd, Hd, Hd, Hd, Hd, Mdd, Hd, Hd, Mdd, Mdd, Mdd^Xm, Mdd^Xm, Mdd, Mdd, Hd, Mdd, Hd, Hd, Ds, Ds, Ds, Dd, Ds, Dd, Ds, Ds, Ds, Hd, Hd, Dd, Dd, Dd^Es, Dd^Edp, Rd, Dd^Vda, Hd, Hd, Hd, Hd, Hd, Hd, Hd, Mdd, Mdd^Xm, Mdd, Mdd, Hd, Hd, Hd, Dd, Dd, Dd, Rd, Dd, Dd, Hd, Hd, Mdd, Mdd, Mdd, Mdd, Mdd, Hd, Hd, Mdd
Dd, Dd, Dd, Dd, Rd, Dd, Dd, Dd, Dd, Hd, Hd, Hd, Hd, Hd, Mdd, Mdd, Hd, Hd, Hd, Mdd, Mdd^Xm, Mdd^Xm, Mdd, Mdd, Hd, Hd, Hd, Hd, Hd, Hd, Dd, Dd, Cud, Ds, Yhs^Xp, Ds, Yhs^Xp, Ds, Ds^Es, Ds, Hd, Dd, Hd, Ds, Ds, Rd, Ds, Dd, Dd, Hd, Hd, Hd, Mdd, Mdd, Mdd, Mdd, Mdd, Mdd, Hd, Dd, Dd, Dd, Re, Re, Dd, Dd, Hd, Hd, Hd, Hd, Hd, Mdd, Hd, Hd, Hd, Hd, Hd
Hd, Dd^Edpp, Dd, Dd, Dd, Rd, Rd, Dd, Dd, Hd, Hd, Hd, Hd, Hd, Mdd, Mdd, Hd, Hd, Mdd, Mdd, Mdd^Xm, Mdd^Xm, Hd, Hd, Hd, Hd, Dd, Hd, Ds, Ds, Ds, Dd, Dd, Ds, Re, Yhs, Yhs, Yhs, Re^Es, Dd, Dd, Dd, Dd, Ds, Ds, Ds^Esd, Rd, Ds^Edp, Dd, Dd, Hd, Hd, Hd, Mdd, Hd, Hd, Hd, Hd, Dd, Dd, Dd, Rd, Dd, Rd, Dd, Dd, Hd, Hd, Dd, Hd, Hd, Hd, Hd, Hd, Hd, Hd, Hd
Hd, Hd, Hd, Dd, Dd, Dd, Dd, Dd, Dd, Dd, Dd, Hd, Hd, Hd, Hd, Mdd, Hd, Hd, Mdd, Mdd^Xm, Mdd^Xm, Mdd, Hd, Hd, Dd, Dd, Dd, Dd, Ds, Yhs, Yhs, Dd, Dd, Ds, Yhs, Yhs^Xp, Uh, Re, Uzw, Ds, Ds^Es, Dd, Dd, Ds, Dd, Dd, 6 Rd, Dd, Dd, Hd, Dd, Hd, Hd, Hd, Hd, Dd, Dd, Hd, Dd, Dd^Es, Dd, Rd, Dd, Rd, Rd, Dd, Dd, Hd, Ds, Dd, Dd, Hd, Hd, Hd, Hd, Mdd, Mdd
Hd, Hd, Dd, Dd, Dd, Dd, Dd^Vdt, Rd, Rd, Dd, Dd, Dd, Dd, Hd, Hd, Hd, Hd, Hd, Mdd, Mdd^Xm, Mdd, Mdd, Hd, Hd, Dd, Ds, Ds, Yhs, Yhs, Ds, Ds, Yhs^Xp, Dd, Ds, Dd, Yhs, Uh, Uzw, Yhs, Uzw, Ds, Dd, Ds, Dd, Hd, Dd, Dd, Rd, Dd, Dd, Rd, Dd, Dd, Hd, Hd, Dd, Dd, Dd, Rd, Rd, Dd, Dd, Dd, Dd^Vdt, Rd, Dd, Dd, Ds, Ds, Dd, Hd, Dd, Hd, Hd, Mdd, Mdd, Mdd
Hd, Hd, Hd, Dd, Dd^Vdt, Dd, Dd, Dd, Re, Dd, Dd, Dd^Vdt, Dd, Hd, Hd, Hd, Hd, Hd, Hd, Mdd^Xm, Mdd, Mdd, Hd, Dd, Dd, Ds, Yhs, Yhs^Xp, Yhs, Re, Ds, Dd, Dd, Dd, Dd, Dd, Ds, Yhs^Xp, Yhs^Xp, Yhs, Yhs, Ds, Ds, Hd, Hd, Dd, Dd, Dd, Dd, Rd, Dd, Rd, Dd, Hd, Hd, Dd, Dd, Dd, Re, Dd, Ds, Dd^Edpp, Dd, Dd, Ce, Dd, Dd, Ds^Vdt, Dd, Dd, Dd, Hd, Dd, Mdd, Hd, Mdd, Mdd
Hd, Hd, Hd, Dd, Dd, Rd, Re, Re, Ce, Dd, Dd, Rd, Dd, Dd, Hd, Hd, Hd, Hd, Mdd, Mdd, Mdd, Hd, Hd, Dd, Ds, Ds, Yhs^Xp, Yhs, Re, Re, Ds, Ds, Dd, Hd, Hd, Dd, Dd, Ds, Cud, Yhs, Ds^Dr, Ds, Dd, Dd, Dd, Dd, Dd, Rd, Dd, Dd, Dd, Dd, Rd, Dd, Dd, Dd, Rd, Re, Dd, Dd, Dd^Vdt, Dd, Dd, Ce, 1 Ke, Ce, Rd, Ds, Dd, Dd, Dd, Dd, Dd, Dd, Dd, Hd, Hd
Hd, Hd, Hd, Hd, Hd, Dd, Dd, Ce, 2 Ke, Ce, Rd, Rd, Dd^Vdt, Hd, Hd, Hd, Hd, Hd, Hd, Hd, Hd, Hd, Hd, Hd, Dd, Dd, Ds, Ds, Dd, Ds^Dr, Ds, Ds, Ds, Dd, Hd, Dd, Dd, Dd, Ds, Ds, Ds, Dd, Rd, Dd^Vda, Rd, Rd, Dd, Dd, Hd, Hd, Hd, Dd, Dd, Rd, Rd, Rd, Rd, Dd, Dd, Dd, Dd, Dd, Rd, Ce, Ce, Ce, Re, Dd^Vdt, Dd, Ds, Dd, Dd, Hd, Hd, Dd, Hd, Hd
Mdd, Mdd, Hd, Hd, Hd, Dd, Re, Ce, Ce, Ce, Dd, Dd, Hd, Hd, Hd, Hd, Mdd, Mdd, Mdd, Hd, Hd, Hd, Hd, Dd, Hd, Dd, Dd, Dd, Dd, Dd, Yhs^Xp, Re, Yhs, Dd, Ds, Hd, Ds, Dd, Dd, Ds^Es, Ds, Dd, Ds, Rd, Dd, Dd, Hd, Dd, Hd, Mdd, Hd, Hd, Hd, Dd, Dd, Dd, Dd, Dd, Rd, Dd, Dd, Dd^Vdt, Dd, Dd, Dd, Dd, Dd, Rd, Rd, Dd, Hd, Dd, Dd, Dd, Hd, Hd, Hd
Mdd, Hd, Dd, Hd, Dd, Dd^Vdt, Dd, Dd, Dd, Dd, Dd, Hd^Vdt, Hd, Hd, Hd, Hd, Mdd, Mdd, Hd, Hd, Hd, Hd, Hd, Hd, Hd, Hd, Hd, Dd, Dd, Ds, Ds, Yhs^Xp, Yhs, Yhs, Ds, Ds, Ds, Dd, Dd, Ds, Re, Re, Yhs, Ds, Dd, Hd, Hd, Hd, Hd, Hd, Mdd, Hd, Hd, Hd, Hd, Dd, Dd, Dd, Dd, Rd, Dd, Dd, Hd, Dd, Dd, Dd, Dd, Dd^Vdt, Rd, Dd, Dd, Dd, Dd, Hd, Hd, Hd, Mdd
Hd, Dd, Dd, Dd, Dd, Dd, Hd, Dd, Hd, Hd, Hd, Hd, Mdd, Mdd, Mdd, Mdd, Mdd, Mdd, Hd, Hd, Hd, Hd, Hd, Hd, Hd, Dd, Hd, Dd, Dd, Ds, Ds, Re, Re^Es, Yhs^Xp, Yhs, Dd, Re, Re, Yhs, Ds, Ds, Yhs, Yhs^Xp, Ds, Ds, Dd, Dd, Dd, Hd, Mdd, Mdd, Hd, Dd, Hd, Hd, Dd, Dd, Dd, Rd, Rd, Dd, Dd^Es, Dd, Hd, Dd, Ds, Dd, Dd, Dd, Dd, Dd, Hd, Dd, Hd, Hd, Mdd, Mdd
Hd, Hd, Hd, Dd, Dd, Hd, Hd, Hd, Hd, Hd, Hd, Mdd, Mdd, Mdd, Mdd, Mdd, Mdd, Mdd, Mdd, Hd, Hd, Hd, Hd, Dd, Dd, Dd, Dd, Dd, Cud, Ds, Ds, Ds, Re, Yhs, Yhs, Ds, Ds, Re, Ds, Cud, Ds, Ds, Re, Yhs, Ds, Dd, Hd, Dd, Dd, Hd, Hd, Hd, Dd, Dd, Hd, Hd, Dd, Dd, Dd, Rd, Rd, Dd, Dd, Hd, Hd, Dd, Dd, Dd, Dd, Dd, Hd, Hd, Hd, Hd, Mdd, Mdd^Xm, Mdd
Dd, Dd, Hd, Dd, Dd, Dd, Hd, Hd, Hd, Hd, Hd, Hd, Hd, Hd, Mdd, Mdd, Hd, Hd, Hd, Hd, Hd, Hd, Dd, Dd, Dd, Dd^Edpp, Dd, Ds, Ds, Qxu, Ds, Ds, Yhs, Yhs, Ds, Ds^Es, Ds, Ds, Yhs, Ds, Ds, Ds, Yhs^Xp, Ds, Dd, Dd, Hd, Dd, Dd, Hd, Hd, Hd, Dd, Hd, Hd, Dd, Dd^Vdt, Dd, Rd, Rd, Rd, Dd, Hd, Hd, Hd, Hd, Hd, Hd, Hd, Dd, Hd, Hd, Hd, Hd, Hd, Mdd, Mdd
Hd, Dd, Dd, Dd, Dd, Hd, Hd, Hd, Hd, Hd, Hd, Hd, Hd, Hd, Mdd, Mdd, Hd, Hd, Hd, Hd, Hd, Hd, Hd, Dd, Ds, Dd, Dd, Ds, Qxu, Qxu, Qxu, Ds, Ds, Yhs^Xp, Ds, Ds, Yhs, Yhs^Xp, Re, Ds, Ds, Yhs, Re, Ds, Dd, Dd, Dd^Vdt, Hd, Dd, Dd, Dd, Dd, Co, Dd, Dd, Dd, Dd, Dd, Dd, Dd, Dd, Dd, Ds, Hd, Hd, Hd, Mdd, Hd, Hd, Hd, Mdd, Hd, Mdd, Hd, Hd, Mdd, Mdd
Dd, Dd, Dd, Dd, Dd, Hd, Dd, Dd, Hd, Hd, Hd, Hd, Hd, Hd, Hd, Hd, Hd, Hd, Hd, Hd, Ds, Hd, Hd, Dd, Dd, Dd^Vdt, Ds, Qxu, Qxua, Qxu, Yhs, Re, Re, Ds, Cud, Ds, Re^Es, Re^Es, Yhs, Ds, Qxu, Re, Re, Ds, Dd, Hd, Dd, Dd, Dd, Co, Dd, Dd, Dd, Co, Dd, Dd^Vda, Rd, Rd, Dd, Dd, Dd, Dd, Dd, Ds, Hd, Hd, Hd, Mdd, Hd, Mdd, Hd, Hd, Hd, Hd, Mdd, Mdd, Mdd
Dd, Dd, Dd^Edp, Dd, Dd, Dd, Hd, Hd, Hd, Hd, Hd, Hd, Dd, Dd, Hd, Dd, Hd, Hd, Dd, Dd, Co, Dd, Dd, Dd, Dd, Ds, Ds, Qxu, Qxu, Qxu, Qxu, Yhs, Yhs, Ds, Qxu, Ds, Re, Re, Ds, Ds, Qxu, Qxu, Ds, Ds, Dd, Hd, Ds, Dd, Dd, Dd, Ds, Dd, Dd^Vda, Dd, Dd, Rd, Dd, Rd, Dd, Hd, Dd, Dd, Dd, Dd, Ds, Hd, Hd, Hd, Hd, Hd, Hd, Hd, Hd, Mdd, Hd, Mdd, Hd
Rd, Dd, Dd, Dd^Edp, Ds, Dd, Dd, Hd, Hd, Hd, Dd, Hd, Dd, Hd, Dd, Dd, Co, Dd, Dd, Co, Ds, Co, Dd, Dd, Ds, Dd, Ds, Ds, Qxu, Qxu, Qxu, Qxu, Qxu, Qxu, Qxua, Qxu, Qxu, Qxu, Qxu, Qxu, Qxua, Qxu, Qxu, Qxu, Qxu, Ds, Ds, Qxu, Qxu, Dd, Qxu, Dd, Dd, Dd, Rd, Rd, Dd, Dd, Dd, Hd, Hd, Dd, Dd, Dd, Dd, Dd, Hd, Hd, Dd, Hd, Hd, Hd, Hd, Hd, Hd, Hd, Hd
Rd, Dd, Dd, Dd, Dd, Ds, Dd, Dd, Dd, Dd, Hd, Hd, Dd, Dd, Dd, Co, Dd, Dd, Dd, Dd^Edt, Ds^Dr, Dd, Dd, Yhs^Xp, Ds, Qxu, Dd, Ds, Qxu, Qxu, Qxu, Qxu, Qxu, Qxu, Qxu, Qxu, Qxu, Qxu, Qxu, Qxu, Qxu, Qxu, Qxu, Qxu, Qxu, Qxu, Qxu, Qxu, Qxu, Qxu, Qxu, Ds, Dd, Dd, Re, Rd, Dd, Co, Co, Dd, Hd, Dd, Hd, Dd, Dd, Ds, Dd, Hd, Dd, Dd, Hd, Hd, Hd, Hd, Hd, Hd, Hd
Dd, Rd, Dd, Dd, Dd, Dd, Dd, Dd, Dd, Hd, Dd, Dd, Dd, Dd, Dd, Dd, Dd, Dd, Dd^Vdt, Dd, Dd, Dd, Ds^Vda, Ds, Cud, Qxu, Qxu, Qxu, Qxu, Qxu, Qxu, Qxu, Qxu, Qxu, Qxu, Qxu, Qxu, Qxu, Cud, Qxu, Cud, Qxu, Cud, Qxu, Qxu, Qxu, Qxu, Qxu, Qxu, Cud, Dd, Dd, Rr, Re, Dd, Dd^Vdt, Dd, Ds, Co, Dd, Hd, Hd, Hd, Hd, Dd, Ds, Ds, Ds, Ds, Dd, Dd, Hd, Hd, Hd, Hd, Hd, Hd
Dd, Dd, Dd, Rd, Rd, Dd^Vda, Dd, Ds, Dd, Dd, Dd, Dd, Dd, Dd, Dd, Dd^Dr, Rr, Dd, Rr, Rr, Rr, Dd, Ds, Ds, Qxu, Qxu, Qxua, Qxu, Qxu, Qxu, Qxu, Qxu, Cud, Cud, Cud, Cud, Cud, Cud, Yhs, Cud, Uu, Cud, Uu, Cud, Cud, Qxu, Qxu, Qxua, Qxu, Qxu, Qxu^Bcx/, Rr, Dd, Dd, Dd, Dd, Dd^Vda, Dd, Ds, Dd, Hd, Hd, Hd, Hd, Dd, Dd, Ds, Ds, Dd, Ds, Ds, Dd, Dd, Hd, Hd, Hd, Hd
Dd, Dd, Dd, Dd, Re, Dd, Dd, Dd^Edp, Dd, Dd, Dd, Dd, Re, Dd, Rd, Rd, Dd, Rr, Dd, Dd, Dd, Rr, Rr, Qxu, Qxu, Qxu, Qxu, Qxu, Cud, Qxu, Cud, Cud, Uu, Uu, Uu, Yhs, Yhs, Yhs, Yhs^Xp, Yhs, Uu, Uu, Uu, Uu, Uu, Cud, Qxu, Qxu, Qxu^Bcx/, Qxu^Bcx/, Qxu, Qxu, Qxu, Cud, Qxu, Dd, Ds, Dd, Dd, Hd, Hd, Dd, Dd, Hd, Dd^Edpp, Dd, Ds, Ds, Ds, Ds, Ds, Dd, Dd^Edp, Hd, Hd, Hd, Hd
Dd, Hd, Dd, Dd, Dd, Rd, Rd, Dd, Rd, Rd, Rd, Re, Dd, Re, Dd, Dd, Dd, Dd, Dd^Dr, Ds, Cud, Ds, Qxu, Qxu^Bcx\, Qxu^Bcx\, Qxu, Qxu, Cud, Uu, Cud, Uu, Uu, Rr, Rr, Rr, Yhs^Xp, Rr, Cud, Uu, Uu, Uu, Uu, Cud, Uu, Uu, Uu, Rr, Qxu^Bcx/, Qxu, Qxu, Qxu, Qxua, Qxu, Qxu, Qxu, Qxu, Ds, Dd, Ds, Hd, Hd, Hd, Dd, Dd, Dd^Vdt, Dd, Dd, Ds, Ds, Dd, Ds, Ds, Dd, Dd, Hd, Hd, Hd
Hd, Hd, Hd, Dd, Dd, Dd, Dd, Dd, Dd, Dd, Dd, Dd, Co, Dd, Dd, Dd^Vdt, Dd, Dd, Ds, Qxu, Qxu, Qxu, Qxu, Qxu, Qxu, Qxu^Bcx\, Rr, Uu, Uu^Vd, Uu, Rr, Rr, Uu, Uu, Uu, Rr, Uu, Rr, Rr, Uu, Uu, Cud, 3 Kud, Cud, Uu, Rr, Uu, Uu, Uu, Cud, Cud, Qxu, Qxu, Qxu, Qxu, Qxu, Ds, Ds, Qxu, Ds, Hd, Hd, Hd, Hd, Hd, Dd, Dd, Dd, Dd, Dd, Ds, Dd, Dd, Dd^Edp, Dd, Hd, Hd
Hd, Dd, Dd, Dd, Hd, Dd, Dd, Rd, Dd, Hd, Hd, Dd, Co, Dd, Yhs, Dd, Dd, Dd, Ds, Qxu, Qxu, Qxua, Qxu, Cud, Cud, Uu, Uu, Rr, Rr, Rr, Uu, Uu, Xos, Xos, Xos, Uu, Uu, Uu^Edt, Uu, Rr, Rr, Cud, Cud, Cud, Rr, Rr, Uu, Uu, Uu, Uu, Uu^Es, Cud, Cud, Qxu, Qxu, Qxu, Qxu, Ds, Qxu, Qxu, Hd, Hd, Hd, Hd, Mdd, Hd, Hd, Dd, Dd^Edp, Dd, Ds, Ds, Ds, Dd, Dd^Edpp, Hd, Dd
Dd, Dd, Hd, Hd, Dd, Dd, Ds, Rd, Dd, Dd, Hd, Dd, Dd, Ds, Yhs, Yhs, Dd, Dd^Edt, Dd^Es, Ds, Ds, Qxu, Qxu, Qxu, Qxu, Cud, Uu, Rr, Rr, Uu, Uu, Xos, Xos^Zok, Xos^Zok, Xos^Zok, Xos, Qxu, Qxu, Qxu, Uu^Vu, Uu, Rr, Rr, Rr, Uu^Vud, Uu, Uu, Yhs, Cud, Uu, Rr, Rr, Cud, Qxu, Qxu, Qxu, Qxua, Qxu, Qxu, Qxu, Dd, Dd, Hd, Mdd, Mdd, Mdd, Hd, Hd, Dd, Dd, Dd, Ds, Ds, Dd, Dd, Dd, Dd
Hd, Hd, Dd, Hd, Dd^Es, Dd, Dd, Dd, Rd, Dd, Hd, Hd, Dd, Ds, Dd, Yhs^Xp, Dd, Dd, Ds^Edt, Ds, Qxu, Qxu, Qxu, Qxu, Cud, Cud, Cud, Uu, Rr, Uu^Vud, Uu, Xos, Xos^Zok, 9 Urb^Zok, Urb^Zok, Xos, Cud, Qxu, Qxu, Uu, Uu^Edt, Rr, Uu^Vud, Uu, Uu, Uu, Uu, Yhs^Xp, Yhs, Uu, Rr, Cud, 5 Kud, Cud, Qxu, Qxu, Qxu, Qxu, Uu, Uu, Dd, Hd, Dd, Hd, Mdd, Mdd, Mdd, Hd, Dd, Hd, Dd, Dd, Dd, Dd, Dd, Hd, Hd
Hd, Hd, Hd, Dd, Dd, Dd, Rd, Dd, Dd, Dd, Dd, Dd, Dd, Co, Co, Dd, Dd, Yhs, Ds^Es, Ds^Edt, Ds^Edt, Dd, Qxu, Qxu, Cud, 4 Kud, Cud, Uu, Rr, Uu, Uu, Xos, Xos, Xos^Zok, Xos, Urb, Uu, Qxu, Qxu, Cud, Uu, Rr, Uu, Uu, Rr, Rr, Rr, Uu^Vd, Uu, Uu, Rr, Cud, Cud, Cud, Qxu, Qxu, Qxu, Qxu, Uu, Uh, Uh, Dd, Dd, Hd, Hd, Hd, Hd, Hd, Hd, Hd, Dd, Dd, Dd, Dd, Dd, Hd, Hd
Hd, Hd, Hd, Hd, Dd, Rd, Dd, Dd, Hd, Dd, Dd, Hd, Hd, Dd, Dd, Co, Dd, Dd, Ds, Dd^Edt, Dd^Edt, Dd, Dd, Qxu, Qxu, Cud, Uu, Uu, Rr, Rr, Rr, Uu, Uu, Xos, Qxu^Ebur, Cud, Qxu, Qxu^Bcx\, Qxu^Bcx\, Uu, Uu, Rr, Rr, Rr, Uu, Uu, Uu, Rr, Rr, Rr, Rr, Rr, Rr, Cud, Cud, Qxu, Qxu, Qxu, Uu, Qxu, Uh, Uu, Uzw, Dd, Dd, Hd, Hd, Hd, Hd, Dd, Dd, Dd, Dd, Ds, Ds, Dd, Dd
Hd, Hd, Dd, Dd, Rd, Dd, Dd^Edp, Dd, Hd, Dd, Ds, Dd, Dd, Dd, Dd, Dd, Yhs, Yhs^Xp, Yhs, Dd^Edt, Dd, Dd, Qxu, Qxu, Qxu, Uu, Rr, Rr, Uu^Vd, Uu, Yhs^Xp, Rr, Rr, Qxu, Qxu, Qxu, Qxu, Qxu, Uu, Rr, Rr, Rr, Uu, Uu, Uu, Uu, Cud, Uu, Uu^Edt, Uu, Uu^Vd, Rr, Rr, Rr, Cud, Qxu, Qxu, Qxu, Qxu, Qxu, Uu, Uzw, Ds, Dd, Ds^Es, Ds, Dd, Hd, Dd, Dd, Dd, Dd, Dd^Edp, Dd, Ds, Ds, Dd
Dd, Dd, Re, Rd, Dd, Dd, Dd, Dd, Dd, Dd, Ds, Yhs^Xp, Yhs, Ds, Ds, Dd, Ds, Yhs, Yhs, Dd^Es, Ds, Ds, Qxu, Qxua, Qxu, Rr, Uu, Uu, Uu, Yhs, Yhs, Yhs, Yhs^Xp, Rr, Uu^Vud, Qxu, Yhs, Cud, Yhs, Uu, Uu^Vud, Rr, Uu, Uu, Yhs, Uu, Uu, Uu^Edt, Uu^Edt, Yhs^Xp, Yhs^Xp, Uu, Rr, Uu, Uu, Cud, Qxu, Qxu, Qxu, Qxu, Uu, Uu, Ds, Ds, Ds, Dd, Dd, Hd, Dd, Hd, Dd, Dd, Dd, Dd, Dd, Ds, Re
Re, Re, Dd, Dd, Dd, Hd, Dd, Dd, Hd, Dd, Dd, Ds, Yhs^Xp, Yhs, Ds, Dd, Ds, Ds, Yhs, Yhs, Ds, Cud, Qxu, Qxu, Qxu, Uu, Cud, Uu, Uu, Uu, Uu, Yhs^Xp, Yhs, Rr, Uu, Uu, Uu, Yhs, Uu, Uu, Uu, Rr, Uu, Yhs^Xp, Yhs^Xp, Uu, Uu^Vud, Uu^Edt, Uu, Yhs, Yhs, Uu, Rr, Uu, Uu, Cud, Qxu, Qxua, Qxu, Qxu, Qxu, Qxu, Uzw, Uh, Uh, Ds, Ds, Dd, Hd, Hd, Hd, Hd, Dd, Hd, Dd, Dd, Re
Hd, Dd, Hd, Hd, Hd, Hd, Dd, Dd, Hd, Dd, Ds, Dd, Dd, Ds, Ds, Dd^Es, Ds, Ds, Ds, Yhs^Xp, Yhs, Ds, Qxu, Qxu, Qxu, Qxu, Qxu, Cud, Cud, Uu, Cud, Uu, Uu, Rr, Rr, Uu, Uu, Uu, Uu^Edt, Cud, Uu, Rr, Uu, Yhs, Yhs^Edt, Uu, Uu, Uu, Uu, Yhs^Xp, Uu, Uu, Rr, Uu, Uu, Cud, Qxu, Qxu, Qxu, Uu, Qxu, Qxu, Uzw, Uzw, Uu, Dd, Hd, Dd, Dd, Hd, Hd, Hd, Dd, Dd, Hd, Dd, Dd
Hd, Hd, Mdd, Mdd, Hd, Dd, Dd, Dd, Hd, Dd, Dd, Ds, Ds, Dd, Dd, Ds, Yhs^Xp, Yhs, Uzw, Uzw, Yhs, Uu, Uu^Vd, Qxu, Uu, Qxu, Qxua, Qxu, Qxu, Cud, Qxu, Cud, Cud, Uu, Uu, Rr, Rr, Rr, Rr, Uu^Edt, Rr^Edt, Rr, Rr, Uu^Edt, Uu^Edt, Uu^Edt, Uu, Cud, Uu, Uu, Rr, Rr, Uu, Rr, Cud, Cud, Qxu, Qxu, Uu, Uu^Vud, Yhs, Uh, Uh, Uzw, Ds, Dd, Dd, Dd, Hd, Hd, Hd, Hd, Dd, Dd, Ds, Dd, Dd
Mdd, Mdd, Mdd, Mdd, Hd, Dd, Hd, Hd, Dd, Dd, Yhs, Yhs, Ds, Dd, Dd, Ds, Yhs, Yhs, Uu^Vu, Uzw, Yhs, Yhs, Uu, Uu, Qxu, Qxu, Qxu, Qxu, Qxu, Qxu, Qxu, Qxu, Qxu, Qxu, Qxu^Bcx/, Rr, Uu, Uu, Uu^Edt, Rr^Edt, Uu^Edt, Uu^Vud, Uu, Rr, Rr^Edt, Uu^Edt, Rr, Uu, Rr, Rr, Uu, Uu, Qxu^Bcx\, Qxu, Qxu, Qxu, Qxu, Qxu, Qxu, Uu, Yhs, Uh, Uu, Uu, Ds^Dr, Dd, Dd, Dd, Dd, Dd, Hd, Hd, Hd, Ds, Hd, Dd, Dd
Mdd, Mdd, Hd, Hd, Hd, Dd, Dd, Hd, Ds, Ds, Yhs, Yhs^Xp, Uzw, Ds, Cud, Uu, Uu, Yhs, Uu, Uu^Dr, Uzw, Yhs^Xp, Uzw, Qxu, Qxu, Qxu, Qxu, Qxu, Qxu, Qxu, Qxu, Qxua, Qxu, Qxu^Bcx/, Qxu, Qxu, Cud, Uu^Edt, Uu, Uu^Edt, Uu^Edt, Uu^Edt, Uu, Uu^Edt, Uu, Rr, Uu, Rr, Cud, Uu, Cud, Qxu, Qxu, Qxu^Bcx\, Qxu^Bp\, Qxu, Qxu, Qxu, Qxu, Yhs, Uu, Uu, Uu, Uzw, Ds, Uzw, Yhs, Yhs, Ds, Dd, Dd, Dd, Dd, Dd, Dd, Dd, Dd
Hd, Mdd, Hd, Hd, Hd, Dd, Dd, Ds, Ds, Yhs, Uu, Uzw, Uzw, Uu, Uu, Uu, Uzw, Uu, Uzw, Uzw, Uzw, Uzw, Uzw, Qxu, Qxu, Yhs, Yhs^Xp, Cud, Yhs, Qxu, Qxu^Bcx/, Qxu, Qxu, Qxu, Qxu, Qxu, Qxu, Cud, Cud, Uu^Edt, Uu, Uu, Uu, Uu, Cud, Uu, Cud, Cud, Qxu, Cud, Qxu, Qxu, Qxu, Qxu, Qxu, Qxu, Qxu, Qxua, Qxu, Ds, Uh, Yhs^Xp, Yhs, Yhs, Yhs, Yhs, Uzw, Yhs, Ds^Es, Hd, Ds, Dd^Edp, Dd, Hd, Hd, Dd, Dd
Hd, Hd, Hd, Hd, Hd, Dd, Dd, Ds, Ds, Ds, Uu, Uu, Yhs, Uh, Uu^Dr, Uh, Uh, Uh, Uu, Yhs, Yhs, Uzw, Yhs^Xp, Uzw, Qxu, Yhs, Yhs, Yhs, Re, Re, Yhs, Qxu, Qxu, Qxu, Cud, Qxu, Qxu, Qxu, Qxu, Cud, Cud, Cud, Cud, Cud, Qxu, Cud, Qxu, Qxu, Qxu, Qxu, Qxu, Qxua, Qxu, Qxu, Qxu, Qxu, Uu, Qxu, Qxu, Ds^Es, Uu, Uu, Ds, Ds, Uh, Yhs^Xp, Uzw, Ds, Ds, Ds, Uu, Dd, Dd, Hd, Dd, Dd, Hd
Hd, Dd, Hd, Hd, Hd, Hd, Dd, Dd, Dd, Uh, Uh, Uh, Dd, Uu, Ds, Ds, Uh, Uu, Uu^Vud, Yhs, Yhs^Xp, Uzw, Uu, Qxu, Qxu, Qxu, Uh, Yhs^Xp, Yhs, Yhs, Yhs, Yhs, Yhs, Qxu, Qxu, Yhs, Yhs, Qxu, Qxu, Qxu, Qxu, Qxu, Qxu, Qxu, Qxu, Qxu, Qxu, Qxu, Qxu, Qxu, Qxu, Qxu, Qxu, Uu, Uu, Uu, Qxu, Qxu, Ds, Ds, Ds^Es, Ds, Ds, Uzw, Uh, Yhs, Uzw, Uu, Uu^Vud, Yhs, Uu, Uu, Ds, Ds, Hd, Dd, Ds
Hd, Hd, Hd, Hd, Mdd, Hd, Hd, Dd, Dd, Dd, Dd, Dd, Hd, Dd, Dd, Dd, Ds, Uzw, Yhs^Xp, Uu, Uh, Yhs, Uu, Uu, Uzw, Qxu, Uh, Uu, Uu, Uzw, Uh, Yhs, Qxu, Qxu, Yhs, Qxu, Yhs, Qxu, Qxu, Qxu, Qxu, Qxu, Qxua, Qxu, Qxu, Qxu, Qxu, Qxu, Qxu, Uu, Uh, Qxu, Yhs, Yhs, Uh, Uu, Uu, Uu, Uh, Yhs^Xp, Ds, Uzw, Uzw, Uh, Uu, Uzw, Yhs, Yhs^Xp, Uu, Yhs, Yhs^Xp, Yhs, Dd, Dd, Ds, Ds, Ds
Hd, Hd, Hd, Hd, Hd, Mdd, Mdd, Hd, Hd, Dd, Dd, Hd, Hd, Dd, Dd, Dd, Ds, Yhs, Ds, Ds, Uu, Uh, Uzw, Uzw, Uzw, Uh, Qxu, Uh, Uzw, Uu^Vd, Uu, Uu, Uu, Uzw, Yhs, Uh, Yhs^Xp, Yhs, Qxu, Yhs, Yhs, Qxu, Qxu, Qxu, Qxu, Uu, Qxu, Qxu, Qxu, Uu, Qxu, Qxu, Yhs, Yhs^Xp, Uh, Uu, Uu^Vd, Uh, Yhs, Yhs, Ds, Uzw, Yhs, Yhs, Uu, Uu, Uzw, Yhs, Yhs^Xp, Yhs, Yhs, Uu, Dd, Hd, Hd, Ds, Dd
Dd, Hd, Hd, Hd, Hd, Mdd, Mdd, Mdd, Mdd, Dd, Dd, Hd, Hd, Dd, Dd, Dd, Uzw, Ds^Es, Uzw, Ds, Uzw, Uzw, Yhs, Yhs^Xp, Yhs, Uzw, Yhs, Qxu, Uzw, Yhs, Yhs^Xp, Uu, Uzw, Uh, Uh, Uu^Vu, Ds, Ds^Es, Ds, Qxu, Yhs^Xp, Yhs^Xp, Qxu, Qxu, Qxu, Qxu, Qxu, Uh, Uu, Qxu, Qxu, Yhs, Yhs, Uh, Yhs, Uu, Yhs, Yhs, Uh, Uh, Yhs^Xp, Yhs, Yhs, Yhs, Ds, Ds, Ds, Yhs, Ds, Yhs, Ds, Ds, Hd, Hd, Hd, Hd, Hd
Dd, Dd, Hd, Hd, Hd, Mdd, Mdd^Xm, Mdd^Xm, Mdd, Hd, Hd, Hd, Hd, Hd, Hd, Dd, Ds, Ds, Uu, Uu^Es, Uu, Uu^Vu, Uh, Uh, Qxu, Uh, Uh, Qxu, Uzw, Uzw, Yhs^Xp, Yhs^Xp, Uzw, Uzw, Uzw, Uu, Ds^Es, Yhs, Yhs, Ds, Ds, Yhs, Ds, Ds^Es, Ds, Ds, Qxu, Uu^Vd, Uh, Uh, Qxu, Qxu, Yhs, Yhs, Yhs, Yhs, Uu, Uu, Uu, Yhs, Yhs^Xp, Yhs, Ds, Yhs, Ds, Ds^Es, Ds, Uzw, Ds, Ds, Hd, Hd, Hd, Hd, Mdd, Hd, Hd
Dd, Hd, Hd, Mdd, Mdd, Mdd^Xm, Mdd^Xm, Mdd^Xm, Mdd, Hd, Hd, Hd, Hd, Hd, Dd, Dd, Yhs, Yhs, Uu, Uu, Uzw, Uu, Yhs, Uh, Uh, Qxu, Uu, Uu, Uu, Uzw, Yhs, Yhs, Yhs, Uzw, Ds, Ds^Es, Ds^Dr, Yhs, Yhs^Xp, Yhs, Ds, Ds, Yhs, Ds, Ds, Ds, Uzw, Qxu, Uu, Uh, Uh, Qxu, Yhs, Yhs, Qxu, Uh, Qxu, Uu^Vud, Uzw, Uzw, Yhs, Yhs, Ds^Es, Ds, Uu, Yhs, Yhs, Ds, Ds^Es, Ds, Ds, Hd, Dd, Hd, Hd, Mdd, Mdd
Hd, Hd, Hd, Mdd, Mdd^Xm, Mdd^Xm, Mdd^Xm, Mdd^Xm, Mdd, Hd, Hd, Hd, Hd, Hd, Dd, Dd, Yhs, Uu, Uu, Uu, Yhs, Yhs^Xp, Yhs, Uh, Qxu, Qxu, Yhs, Uu, Yhs, Ds, Ds, Yhs, Yhs, Uu, Ds, Ds^Es, Yhs, Ds^Es, Ds, Yhs, Uu, Uu, Yhs, Yhs, Yhs, Uzw, Uzw, Uu, Qxu, Yhs, Yhs, Yhs, Yhs, Qxu, Qxu, Qxu, Qxu, Yhs, Uzw, Uzw, Yhs, Yhs, Ds, Uu, Yhs^Xp, Yhs^Xp, Yhs, Ds, Yhs, Yhs, Uu, Ds, Dd, Hd, Hd, Mdd, Hd
Dd, Hd, Hd, Hd, Hd, Hd, Mdd, Mdd, Hd, Hd, Mdd, Hd, Hd, Hd, Hd, Dd, Ds, Ds, Ds, Yhs, Yhs^Xp, Yhs^Xp, Uzw, Qxu, Qxu, Uzw, Yhs, Yhs^Xp, Yhs, Uu, Ds^Es, Ds, Ds, Ds, Ds, Uzw, Uzw, Yhs, Yhs, Yhs, Uu, Uu^Vu, Uu, Yhs^Xp, Yhs, Uzw, Uzw, Uzw, Qxu, Qxu, Qxu, Yhs^Xp, Uu, Uu, Qxu, Qxu, Yhs, Yhs, Uzw, Yhs, Ds, Ds, Uu, Yhs, Uu, Yhs, Ds, Ds, Yhs, Yhs^Xp, Uu, Uu, Hd, Hd, Mdd, Hd, Mdd
Hd, Hd, Hd, Hd, Hd, Hd, Dd, Mdd, Mdd, Mdd, Mdd, Hd, Hd, Hd, Hd, Hd, Hd, Ds, Yhs, Yhs, Yhs, Yhs, Uzw, Uzw, Uzw, Uzw, Uzw, Yhs, Yhs, Uu, Uu, Ds, Ds, Ds^Es, Ds, Uzw, Uzw, Yhs, Yhs, Yhs, Ds, Uu, Ds, Yhs, Yhs, Yhs, Yhs, Uzw, Qxu, Qxu, Uh, Yhs, Uu, Uu, Qxu, Qxu, Qxu, Yhs, Uzw, Ds, Ds, Ds^Es, Yhs, Uu, Uu, Uu, Uu, Yhs, Uu, Uu, Uu, Uu, Hd, Hd, Mdd, Mdd, Mdd
