Dd, Rd, Rd, Dd, Dd, Dd, Hd, Dd, Hd, Hd, Mdd, Mdd^Qhh, Hd^Qhh, Mdd^Qhh, Mdd^Qhh, Mdd^Qhh, Mdd^Qhh, Mdd^Qhh, Mdd^Qhh, Mdd^Qhh, Mdd^Qhh, Mdd^Qhh, Mdd^Qhh, Mdd^Qhh, Mdd^Qhh, Md^Qhh, Mdd^Qhh, Mdd^Qhh, Hd, Hd, Hd, Hd, Ds, Hd, Dd, Ds, Ds, Ds, Hd, Hd, Hd, Dd, Dd, Dd, Rd, Dd, Dd, Hd, Hd, Hd, Hd, Mdd^Qhh, Hd^Qhh, Mdd^Qhh, Mdd^Qhh, Mdd^Qhh, Mdd^Qhh, Mdd^Qhh, Mdd^Qhh, Mdd^Qhh, Hd, Dd, Dd, Dd, Rd, Rd, Ds, Ds, Hd^Qhh, Mdd^Qhh, Mdd^Qhh, Md^Qhh, Mdd^Qhh, Hd^Qhh, Hd^Qhh, Mdd^Qhh, Mdd^Qhh
Dd, Dd, Dd, Dd^Esd, Dd, Dd, Hd, Hd, Dd, Mdd, Mdd, Hd, Hd, Hd^Qhh, Hd, Hd, Hd^_mh, Mdd, Hd, Hd, Mdd, Mdd, Mdd^Xm, Mdd^Xm, Mdd^Qhh, Mdd^Qhh, Hd, Mdd, Hd, Hd, Ds, Ds, Ds, Dd, Ds, Dd, Ds, Ds, Ds, Hd, Hd, Dd, Dd, Dd^Es, Dd^Edp, Rd, Dd^Vdr, Hd, Hd, Hd, Hd, Hd, Hd^Qhh, Hd, Mdd, Mdd^Xm, Mdd, Mdd, Hd^Qhh, Hd, Hd, Dd, Dd, Dd, Rd, Dd, Dd, Hd, Hd^Qhh, Mdd, Mdd^Qhh, Mdd, Mdd^Qhh, Mdd, Hd^_mh, Hd^Qhh, Mdd^Qhh
Dd, Dd^Esd, Dd, Dd, Rd, Dd, Dd, Dd, Dd, Hd, Hd, Hd, Hd, Hd^Qhh, Mdd, Mdd, Hd^Qhh, Hd^Qhh, Hd^Qhh, Mdd, Mdd^Xm, Mdd^Xm, Mdd, Mdd^Qhh, Hd, Hd, Hd, Hd, Hd, Hd, Dd, Dd, Cud, Ds, Yhs^Xp, Ds, Yhs^Xp, Ds, Ds^Es, Ds, Hd, Dd, Hd, Ds, Ds, Rd^Edt, Ds, Dd, Dd, Hd, Hd, Hd, Mdd^Qhh, Mdd, Mdd, Mdd^_mh, Mdd^Qhh, Mdd, Hd^Qhh, Dd, Dd, Dd, Re, Re^Esd, Dd, Dd^Esd, Hd, Hd, Hd, Hd^Qhh, Hd, Mdd^Qhh, Hd, Hd^Qhh, Hd^Qhh, Hd, Hd^Qhh
Hd, Dd^Edpp, Dd, Dd^Esd, Dd, Rd^Esd, Rd^Esd, Dd, Dd, Hd, Hd, Hd, Hd, Hd^Qhh, Mdd^Qhh, Mdd, Hd^Qhh, Hd, Mdd^Qhh, Mdd, Mdd^Xm, Mdd^Xm, Hd^Qhh, Hd^Qhh, Hd, Hd, Dd, Hd, Ds, Ds, Ds, Dd, Dd, Ds, Re^Esd, Yhs^Yva, Yhs, Yhs^Esd, Re^Es, Dd, Dd, Dd, Dd, Ds, Ds, Ds^Esd, Rd, Ds^Edp, Dd, Dd, Hd, Hd^Qhh, Hd^Qhh, Mdd^Qhh, Hd^Qhh, Hd^Qhh, Hd, Hd^Qhh, Dd, Dd, Dd, Rd^Esd, Dd, Rd, Dd, Dd, Hd, Hd, Dd, Hd, Hd, Hd, Hd, Hd, Hd^Qhh, Hd, Hd^Qhh
Hd, Hd, Hd, Dd, Dd, Dd^Esd, Dd, Dd, Dd, Dd, Dd, Hd, Hd, Hd, Hd^Qhh, Mdd, Hd^Qhh, Hd, Mdd^Qhh, Mdd^Xm, Mdd^Xm, Mdd, Hd^Qhh, Hd, Dd, Dd, Dd, Dd, Ds, Yhs^Esd, Yhs^Esd, Dd, Dd, Ds^Edb, Yhs^Esd, Yhs^Xp, Uh, Re, Uzw, Ds, Ds^Es, Dd, Dd, Ds, Dd, Dd, 6 Rd^Esd, Dd, Dd, Hd, Dd, Hd, Hd, Hd, Hd, Dd, Dd, Hd, Dd, Dd^Es, Dd, Rd, Dd, Rd^Esd, Rd^Esd, Dd, Dd, Hd, Ds, Dd, Dd, Hd, Hd, Hd, Hd, Mdd^Qhh, Mdd^Qhh
Hd, Hd, Dd, Dd, Dd, Dd, Dd^Vdt, Rd^Esd, Rd^Esd, Dd, Dd, Dd, Dd, Hd, Hd, Hd^Qhh, Hd, Hd, Mdd^Qhh, Mdd^Xm, Mdd, Mdd, Hd^Qhh, Hd, Dd, Ds, Ds, Yhs, Yhs^Esd, Ds, Ds, Yhs^Xp, Dd, Ds, Dd, Yhs, Uh, Uzw, Yhs, Uzw, Ds, Dd, Ds, Dd, Hd, Dd, Dd, Rd, Dd, Dd, Rd^Esd, Dd, Dd, Hd, Hd, Dd, Dd, Dd, Rd^Esd, Rd, Dd, Dd, Dd, Dd^Vdt, Rd, Dd, Dd, Ds, Ds, Dd, Hd, Dd, Hd, Hd, Mdd^Qhh, Mdd^Qhh, Mdd^Qhh
Hd, Hd, Hd, Dd, Dd^Vdt, Dd, Dd, Dd, Re, Dd, Dd, Dd^Vdt, Dd, Hd, Hd, Hd, Hd, Hd, Hd^Qhh, Mdd^Xm, Mdd^Qhh, Mdd, Hd^Qhh, Dd, Dd, Ds, Yhs^Esd, Yhs^Xp, Yhs, Re^Esd, Ds^Esd, Dd, Dd, Dd, Dd, Dd, Ds, Yhs^Xp, Yhs^Xp, Yhs, Yhs^Esd, Ds, Ds, Hd, Hd, Dd, Dd, Dd, Dd, Rd, Dd, Rd, Dd, Hd, Hd, Dd, Dd, Dd, Re, Dd^Esd, Ds, Dd^Edpp, Dd, Dd, Ce, Dd, Dd, Ds^Vdt, Dd, Dd, Dd, Hd, Dd, Mdd^Qhh, Hd^Qhh, Mdd^Qhh, Mdd^Qhh
Hd, Hd, Hd, Dd, Dd, Rd^Esd, Re, Re, Ce, Dd, Dd^Esd, Rd, Dd, Dd, Hd, Hd, Hd, Hd, Mdd, Mdd^Qhh, Mdd, Hd^Qhh, Hd, Dd, Ds, Ds, Yhs^Xp, Yhs, Re^Esd, Re, Ds, Ds, Dd, Hd, Hd, Dd, Dd, Ds, Cud, Yhs, Ds^Dr, Ds^Edb, Dd^Edb, Dd, Dd, Dd, Dd, Rd, Dd, Dd, Dd, Dd, Rd, Dd, Dd, Dd, Rd, Re, Dd, Dd, Dd^Vdt, Dd, Dd, Ce, 1 Ke, Ce, Rd, Ds, Dd, Dd, Dd, Dd, Dd, Dd, Dd, Hd, Hd
Hd, Hd, Hd, Hd, Hd, Dd, Dd, Ce, 2 Ke, Ce, Rd, Rd, Dd^Vdt, Hd, Hd, Hd, Hd, Hd, Hd, Hd, Hd, Hd, Hd, Hd, Dd, Dd, Ds, Ds, Dd^Edt, Ds^Dr, Ds^Edt, Ds, Ds, Dd, Hd, Dd, Dd, Dd, Ds, Ds^Edb, Ds, Dd^Edb, Rd^Edt, Dd^Vdr, Rd, Rd, Dd, Dd, Hd, Hd, Hd, Dd, Dd, Rd^Esd, Rd, Rd, Rd, Dd, Dd, Dd, Dd, Dd, Rd^Esd, Ce, Ce, Ce, Re, Dd^Vdt, Dd, Ds, Dd, Dd, Hd, Hd, Dd, Hd, Hd
Mdd, Mdd, Hd, Hd, Hd, Dd, Re, Ce, Ce, Ce, Dd, Dd^Esd, Hd, Hd, Hd, Hd, Mdd, Mdd, Mdd, Hd, Hd, Hd, Hd, Dd, Hd, Dd, Dd, Dd, Dd, Dd, Yhs^Xp, Re^Esd, Yhs, Dd, Ds, Hd, Ds, Dd, Dd, Ds^Es, Ds, Dd, Ds, Rd, Dd, Dd, Hd, Dd, Hd, Mdd^Qhh, Hd^Qhh, Hd, Hd, Dd, Dd, Dd, Dd^Qhu, Dd^Qhu, Rd^Qhu, Dd^Qhu, Dd^Qhu, Dd^Vdt, Dd^Qhu, Dd, Dd, Dd, Dd, Rd^Esd, Rd^Esd, Dd, Hd, Dd, Dd, Dd, Hd, Hd, Hd^Qhh
Mdd, Hd, Dd^Qhu, Hd, Dd, Dd^Vdt, Dd, Dd, Dd, Dd, Dd, Hd^Vdt, Hd, Hd, Hd, Hd, Mdd, Mdd, Hd, Hd, Hd, Hd, Hd, Hd, Hd, Hd, Hd, Dd, Dd, Ds, Ds, Yhs^Xp, Yhs, Yhs^Esd, Ds^Esd, Ds, Ds^Esd, Dd, Dd, Ds^Esd, Re, Re, Yhs^Esd, Ds, Dd, Hd, Hd, Hd, Hd^Qhh, Hd^Qhh, Mdd^Qhh, Hd, Hd, Hd, Hd, Dd, Dd^Qhu, Dd, Dd^Esd, Rd^Esd, Dd, Dd^Qhu, Hd^Qhu, Dd, Dd, Dd, Dd, Dd^Vdt, Rd^Esd, Dd^Esd, Dd, Dd, Dd, Hd, Hd, Hd^Qhh, Mdd^Qhh
Hd^Qhu, Dd^Qhu, Dd, Dd^Qhu, Dd, Dd, Hd, Dd, Hd, Hd, Hd, Hd, Mdd, Mdd, Mdd, Mdd, Mdd, Mdd, Hd, Hd, Hd, Hd, Hd, Hd, Hd, Dd, Hd, Dd, Dd, Ds, Ds, Re, Re^Es, Yhs^Xp, Yhs, Dd, Re^Esd, Re, Yhs, Ds, Ds, Yhs, Yhs^Xp, Ds, Ds, Dd, Dd, Dd, Hd, Mdd^Qhh, Mdd^Qhh, Hd^Qhh, Dd, Hd, Dd^Qhu, Dd^Qhu, Dd, Dd, Rd, Rd, Dd, Dd^Es, Dd, Hd^Qhu, Dd^Qhu, Ds^Qhu, Dd, Dd, Dd, Dd, Dd, Hd, Dd, Hd, Hd^Qhh, Mdd^Qhh, Mdd^Qhh
Hd^Qhu, Hd^Qhu, Hd, Dd^Qhu, Dd^Qhu, Hd^Qhu, Hd^Qhu, Hd, Hd, Hd, Hd, Mdd, Mdd, Mdd, Mdd, Mdd, Mdd, Mdd, Mdd, Hd, Hd, Hd, Hd, Dd, Dd, Dd, Dd, Dd, Cud, Ds, Ds, Ds^Esd, Re, Yhs^Yva, Yhs^Esd, Ds, Ds, Re^Esd, Ds, Cud, Ds, Ds, Re^Esd, Yhs, Ds, Dd, Hd, Dd, Dd, Hd^Qhh, Hd, Hd, Dd, Dd^Qhu, Hd, Hd, Dd, Dd, Dd, Rd, Rd^Esd, Dd, Dd, Hd, Hd^Qhu, Dd^Qhu, Dd, Dd, Dd, Dd, Hd, Hd, Hd^Qhh, Hd^Qhh, Mdd, Mdd^Xm, Mdd^Qhh
Dd^Qhu, Dd, Hd, Dd, Dd, Dd, Hd^Qhu, Hd, Hd, Hd, Hd, Hd, Hd, Hd, Mdd, Mdd, Hd, Hd, Hd, Hd, Hd, Hd, Dd, Dd, Dd, Dd^Edpp, Dd, Ds, Ds, Qxu, Ds, Ds, Yhs, Yhs^Esd, Ds, Ds^Es, Ds^Edt, Ds, Yhs, Ds, Ds, Ds, Yhs^Xp, Ds, Dd, Dd, Hd, Dd, Dd, Hd, Hd, Hd, Dd, Hd, Hd, Dd, Dd^Vdt, Dd, Rd, Rd, Rd^Esd, Dd, Hd, Hd, Hd^Qhu, Hd, Hd, Hd, Hd, Dd, Hd, Hd, Hd^Qhh, Hd, Hd, Mdd, Mdd^Qhh
Hd, Dd, Dd, Dd, Dd, Hd^Qhu, Hd, Hd, Hd, Hd, Hd, Hd, Hd, Hd, Mdd, Mdd, Hd, Hd, Hd, Hd, Hd, Hd, Hd, Dd, Ds, Dd, Dd, Ds, Qxu, Qxu, Qxu, Ds, Ds^Esd, Yhs^Xp, Ds, Ds, Yhs, Yhs^Xp, Re, Ds, Ds, Yhs^Esd, Re^Esd, Ds, Dd, Dd, Dd^Vdt, Hd, Dd, Dd, Dd, Dd, Co, Dd, Dd, Dd^Qhu, Dd^Edt, Dd, Dd, Dd, Dd, Dd, Ds, Hd, Hd, Hd^Qhu, Mdd, Hd, Hd, Hd, Mdd^Qhh, Hd^Qhh, Mdd, Hd, Hd, Mdd^_mh, Mdd^Qhh
Dd, Dd, Dd, Dd, Dd, Hd^Qhu, Dd^Qhu, Dd, Hd, Hd, Hd, Hd, Hd, Hd, Hd, Hd, Hd, Hd, Hd, Hd, Ds, Hd, Hd, Dd, Dd, Dd^Vdt, Ds, Qxu, Qxua, Qxu, Yhs, Re^Esd, Re, Ds, Cud, Ds, Re^Es, Re^Es, Yhs, Ds, Qxu, Re, Re, Ds^Esd, Dd, Hd, Dd, Dd, Dd, Co, Dd, Dd, Dd, Co, Dd, Dd^Vda, Rd, Rd, Dd, Dd, Dd, Dd, Dd, Ds, Hd, Hd^Qhu, Hd^Qhu, Mdd, Hd, Mdd, Hd, Hd^Qhh, Hd, Hd, Mdd, Mdd, Mdd^Qhh
Dd, Dd, Dd^Edp, Dd, Dd, Dd, Hd^Qhu, Hd, Hd, Hd, Hd, Hd, Dd, Dd, Hd, Dd, Hd, Hd, Dd, Dd, Co, Dd, Dd, Dd, Dd, Ds, Ds, Qxu, Qxu, Qxu, Qxu, Yhs, Yhs, Ds, Qxu, Ds, Re, Re, Ds, Ds, Qxu, Qxu, Ds, Ds, Dd, Hd, Ds, Dd, Dd, Dd, Ds, Dd, Dd^Vda, Dd, Dd, Rd, Dd, Rd^Esd, Dd, Hd, Dd, Dd, Dd, Dd, Ds, Hd, Hd^Qhu, Hd, Hd, Hd, Hd, Hd^Qhh, Hd^Qhh, Mdd^Qhh, Hd^Qhh, Mdd^Qhh, Hd^Qhh
Rd, Dd, Dd, Dd^Edp, Ds, Dd, Dd, Hd^Qhu, Hd, Hd, Dd, Hd, Dd, Hd, Dd^Qhu, Dd, Co, Dd, Dd, Co, Ds, Co, Dd, Dd, Ds, Dd, Ds, Ds, Qxu, Qxu, Qxu, Qxu, Qxu, Qxu, Qxua, Qxu, Qxu, Qxu, Qxu, Qxu, Qxua, Qxu, Qxu, Qxu, Qxu, Ds, Ds, Qxu, Qxu, Dd, Qxu, Dd, Dd, Dd^Edt, Rd^Esd, Rd, Dd, Dd, Dd, Hd, Hd, Dd, Dd, Dd, Dd, Dd, Hd^Qhu, Hd, Dd, Hd, Hd, Hd, Hd, Hd, Hd, Hd, Hd^Qhh
Rd, Dd, Dd, Dd, Dd, Ds, Dd, Dd^Qhu, Dd^Qhu, Dd, Hd^Qhu, Hd, Dd, Dd^Qhu, Dd, Co, Dd, Dd, Dd, Dd^Edt, Ds^Dr, Dd, Dd, Yhs^Xp, Ds, Qxu, Dd, Ds, Qxu, Qxu, Qxu, Qxu, Qxu, Qxu, Qxu, Qxu, Qxu, Qxu, Qxu, Qxu, Qxu, Qxu, Qxu, Qxu, Qxu, Qxu, Qxu, Qxu, Qxu, Qxu, Qxu, Ds^Esd, Dd, Dd^Esd, Re, Rd, Dd^Qhu, Co^Qhu, Co^Qhu, Dd, Hd, Dd, Hd, Dd, Dd, Ds, Dd, Hd^Qhu, Dd^Qhu, Dd, Hd, Hd, Hd, Hd, Hd, Hd, Hd
Dd, Rd^Esd, Dd, Dd, Dd, Dd, Dd, Dd, Dd, Hd^Qhu, Dd, Dd^Qhu, Dd, Dd^Qhu, Dd, Dd, Dd, Dd, Dd^Vdt, Dd, Dd, Dd, Ds^Vda, Ds, Cud, Qxu, Qxu, Qxu, Qxu, Qxu, Qxu, Qxu, Qxu, Qxu, Qxu, Qxu, Qxu, Qxu, Cud, Qxu, Cud, Qxu, Cud, Qxu, Qxu, Qxu, Qxu, Qxu, Qxu, Cud, Dd, Dd, Rr, Re, Dd^Esd, Dd^Vdt, Dd, Ds, Co^Qhu, Dd, Hd^Qhu, Hd, Hd^Qhu, Hd, Dd, Ds, Ds, Ds^_ml, Ds^Qhu, Dd, Dd, Hd, Hd, Hd, Hd, Hd, Hd
Dd^_ml, Dd, Dd, Rd^Esd, Rd, Dd^Vdr, Dd, Ds, Dd, Dd, Dd, Dd^Qhu, Dd^Qhu, Dd^Qhu, Dd, Dd^Dr, Rr, Dd, Rr, Rr, Rr, Dd, Ds, Ds, Qxu, Qxu, Qxua, Qxu, Qxu, Qxu, Qxu, Qxu, Cud, Cud, Cud, Cud, Cud, Cud, Yhs, Cud, Uu, Cud, Uu, Cud, Cud, Qxu, Qxu, Qxua, Qxu, Qxu, Qxu^Bcx/, Rr, Dd, Dd, Dd, Dd, Dd^Vda, Dd, Ds, Dd^Qhu, Hd, Hd^Qhu, Hd, Hd^Qhu, Dd^Qhu, Dd, Ds, Ds^Esd, Dd^Qhu, Ds, Ds, Dd, Dd, Hd, Hd, Hd, Hd
Dd, Dd, Dd, Dd, Re, Dd^Edt, Dd, Dd^Edp, Dd, Dd, Dd, Dd, Re, Dd, Rd^Esd, Rd^Esd, Dd, Rr, Dd, Dd, Dd, Rr, Rr, Qxu, Qxu, Qxu, Qxu, Qxu, Cud, Qxu, Cud, Cud, Uu, Uu, Uu, Yhs, Yhs, Yhs, Yhs^Xp, Yhs^Yva, Uu^Vyf, Uu, Uu, Uu, Uu, Cud, Qxu, Qxu, Qxu^Bcx/, Qxu^Bcx/, Qxu, Qxu, Qxu, Cud, Qxu, Dd, Ds^Edt, Dd, Dd, Hd, Hd, Dd, Dd, Hd, Dd^Edpp, Dd^Qhu, Ds^Qhu, Ds^Qhu, Ds^Qhu, Ds, Ds, Dd, Dd^Edp, Hd, Hd, Hd, Hd
Dd, Hd, Dd, Dd, Dd, Rd, Rd, Dd, Rd^Esd, Rd, Rd^Esd, Re, Dd, Re, Dd, Dd, Dd^Edt, Dd, Dd^Dr, Ds, Cud, Ds, Qxu, Qxu^Bcx\, Qxu^Bcx\, Qxu, Qxu, Cud, Uu, Cud, Uu, Uu, Rr, Rr, Rr, Yhs^Xp, Rr, Cud^Br\, Uu^Br\, Uu^Br/, Uu^Br/, Uu^Br/, Cud^Br\, Uu, Uu, Uu, Rr, Qxu^Bcx/, Qxu, Qxu, Qxu, Qxua, Qxu, Qxu, Qxu, Qxu, Ds, Dd, Ds, Hd, Hd, Hd, Dd, Dd, Dd^Vdt, Dd, Dd, Ds, Ds, Dd, Ds, Ds, Dd, Dd, Hd, Hd, Hd
Hd, Hd, Hd, Dd, Dd, Dd, Dd, Dd, Dd, Dd, Dd, Dd, Co, Dd, Dd, Dd^Vdt, Dd, Dd, Ds^Edt, Qxu, Qxu, Qxu, Qxu, Qxu, Qxu, Qxu^Bcx\, Rr, Uu, Uu^Vd, Uu, Rr, Rr, Uu^Br/, Uu^Br\, Uu^Br\, Rr, Uu^Br/, Rr^Br/, Rr, Uu^Br\, Uu, Cud, 3 Kud, Cud^Br\, Uu^Br\, Rr, Uu, Uu, Uu, Cud, Cud, Qxu, Qxu, Qxu, Qxu, Qxu, Ds, Ds, Qxu, Ds, Hd, Hd, Hd, Hd, Hd, Dd, Dd, Dd, Dd, Dd, Ds, Dd, Dd, Dd^Edp, Dd, Hd, Hd
Hd^Qhh, Dd, Dd, Dd, Hd, Dd, Dd, Rd, Dd, Hd, Hd, Dd, Co, Dd, Yhs, Dd, Dd^Esd, Dd, Ds, Qxu, Qxu, Qxua, Qxu, Cud, Cud, Uu, Uu, Rr, Rr, Rr, Uu^Br/, Uu^Br/, Xos, Xos, Xos, Uu^Br\, Uu, Uu^Edt, Uu, Rr, Rr, Cud, Cud, Cud, Rr, Rr^Br\, Uu^Br|, Uu, Uu, Uu, Uu^Es, Cud, Cud, Qxu, Qxu, Qxu, Qxu, Ds, Qxu, Qxu, Hd^Qhh, Hd^Qhh, Hd^Qhh, Hd^Qhh, Mdd^Qhh, Hd, Hd, Dd, Dd^Edp, Dd, Ds, Ds, Dd, Dd, Dd^Edpp, Hd, Dd
Dd^Qhh, Dd^Qhh, Hd^Qhh, Hd, Dd, Dd, Ds, Rd, Dd, Dd, Hd, Dd, Dd, Ds, Yhs^Esd, Yhs^Esd, Dd, Dd^Edt, Dd^Es, Ds, Ds, Qxu, Qxu, Qxu, Qxu, Cud, Uu, Rr, Rr, Uu^Vyf, Yhs^Xp, Xos, Xos^Zok, Xos^Zok, Xos^Zok, Xos, Qxu, Qxu, Qxu, Uu^Vu, Uu, Rr, Rr, Rr, Uu^Vud, Uu, Uu^Br|, Yhs^Yva, Cud, Uu, Rr, Rr, Cud, Qxu, Qxu, Qxu, Qxua, Qxu, Qxu, Qxu, Dd^Qhh, Dd, Hd, Mdd, Mdd, Mdd^Qhh, Hd, Hd, Dd, Dd, Dd, Ds, Ds, Dd, Dd, Dd, Dd
Hd^Qhh, Hd, Dd^Qhh, Hd, Dd^Es, Dd, Dd, Dd, Rd^Esd, Dd, Hd, Hd, Dd, Ds, Dd, Yhs^Xp, Dd, Dd, Ds^Edt, Ds, Qxu, Qxu, Qxu, Qxu, Cud, Cud, Cud, Uu, Rr, Yhs^Xp, Yhs^Yva, Xos, Xos^Zok, 9 Urb^Zok, Urb^Zok, Xos, Cud, Qxu, Qxu, Uu, Uu^Edt, Rr, Uu^Vyf, Uu, Uu^Br/, Uu^Br/, Uu^Br\, Yhs^Xp, Yhs^Br|, Uu, Rr, Cud, 5 Kud, Cud, Qxu, Qxu, Qxu, Qxu, Uu^Qhh, Uu^Qhh, Dd, Hd, Dd^_mh, Hd, Mdd, Mdd^Qhh, Mdd^Qhh, Hd, Dd, Hd, Dd, Dd, Dd, Dd, Dd, Hd, Hd
Hd^Qhh, Hd, Hd, Dd^Qhh, Dd, Dd, Rd, Dd, Dd, Dd, Dd, Dd, Dd, Co, Co, Dd, Dd, Yhs, Ds^Es, Ds^Edt, Ds^Edt, Dd, Qxu, Qxu, Cud, 4 Kud, Cud, Uu, Rr, Uu, Uu, Xos, Xos, Xos^Zok, Xos, Urb, Uu, Qxu, Qxu, Cud, Uu^Br\, Rr, Uu^Br/, Uu^Br/, Rr, Rr, Rr, Uu^Vd, Uu^Br/, Uu^Br/, Rr, Cud, Cud, Cud, Qxu, Qxu, Qxu, Qxu, Uu, Uh^Qhh, Uh^Qhh, Dd, Dd^Qhh, Hd, Hd^Qhh, Hd, Hd^Qhh, Hd, Hd, Hd, Dd, Dd, Dd, Dd, Dd, Hd, Hd
Hd^Qhh, Hd^_mh, Hd^Qhh, Hd^Qhh, Dd, Rd^Esd, Dd, Dd, Hd, Dd, Dd, Hd, Hd, Dd, Dd, Co, Dd, Dd, Ds, Dd^Edt, Dd^Edt, Dd, Dd, Qxu, Qxu, Cud, Uu, Uu, Rr, Rr, Rr, Uu, Uu, Xos, Qxu^Ebur, Cud, Qxu, Qxu^Bcx\, Qxu^Bcx\, Uu, Uu^Br/, Rr^Br/, Rr, Rr, Uu, Uu, Uu^Br/, Rr^Br/, Rr, Rr, Rr, Rr, Rr, Cud, Cud, Qxu, Qxu, Qxu, Uu, Qxu, Uh, Uu^Qhh, Uzw^Esd, Dd^Qhh, Dd, Hd^Qhh, Hd, Hd, Hd, Dd, Dd, Dd, Dd, Ds, Ds, Dd, Dd
Hd^Qhh, Hd^Qhh, Dd^Qhh, Dd, Rd^Esd, Dd, Dd^Edp, Dd, Hd, Dd, Ds, Dd, Dd, Dd, Dd, Dd, Yhs^Esd, Yhs^Xp, Yhs, Dd^Edt, Dd, Dd, Qxu, Qxu, Qxu, Uu, Rr, Rr, Uu^Vd, Uu, Yhs^Xp, Rr, Rr, Qxu, Qxu, Qxu, Qxu, Qxu, Uu, Rr^Br/, Rr, Rr, Uu, Cud, Uu^Br\, Uu^Br|, Cud, Uu, Uu^Edt, Uu, Uu^Vd, Rr, Rr, Rr, Cud, Qxu, Qxu, Qxu, Qxu, Qxu, Uu, Uzw, Ds^Edb, Dd, Ds^Es, Ds, Dd, Hd, Dd, Dd, Dd, Dd, Dd^Edp, Dd, Ds, Ds, Dd
Dd, Dd, Re, Rd, Dd, Dd, Dd, Dd, Dd, Dd, Ds, Yhs^Xp, Yhs^Esd, Ds^Esd, Ds, Dd^Esd, Ds, Yhs, Yhs^Esd, Dd^Es, Ds, Ds, Qxu, Qxua, Qxu, Rr, Uu, Uu, Uu, Yhs, Yhs, Yhs, Yhs^Xp, Rr, Uu^Vyf, Qxu, Yhs, Cud, Yhs^Br/, Uu^Br|, Uu^Vud, Rr, Uu, Uu, Yhs^Yva, Uu^Br|, Uu, Uu^Edt, Uu^Edt, Yhs^Xp, Yhs^Xp, Uu, Rr, Uu, Uu, Cud, Qxu, Qxu, Qxu, Qxu, Uu, Uu, Ds, Ds, Ds, Dd, Dd, Hd, Dd, Hd, Dd, Dd, Dd, Dd, Dd, Ds, Re
Re, Re, Dd, Dd, Dd, Hd, Dd, Dd, Hd, Dd, Dd, Ds, Yhs^Xp, Yhs, Ds, Dd, Ds, Ds, Yhs, Yhs^Esd, Ds, Cud, Qxu, Qxu, Qxu, Uu, Cud, Uu, Uu, Uu, Uu, Yhs^Xp, Yhs^Yva, Rr, Uu, Uu, Uu, Yhs^Br/, Uu^Br|, Uu, Uu, Rr, Uu, Yhs^Xp, Yhs^Xp, Uu^Br|, Uu^Vud, Uu^Edt, Uu^Br|, Yhs^Br/, Yhs^Yva, Uu, Rr, Uu, Uu, Cud, Qxu, Qxua, Qxu, Qxu, Qxu, Qxu, Uzw, Uh, Uh, Ds, Ds, Dd, Hd, Hd, Hd, Dd, Dd, Hd, Dd, Dd, Re
Hd, Dd, Hd, Hd, Hd, Hd, Dd, Dd, Hd, Dd, Ds^Qhu, Dd, Dd, Ds, Ds, Dd^Es, Ds, Ds, Ds, Yhs^Xp, Yhs^Yva, Ds, Qxu, Qxu, Qxu, Qxu, Qxu, Cud, Cud, Uu, Cud, Uu, Uu, Rr, Rr, Uu, Uu, Uu^Br|, Uu^Br|, Cud, Uu, Rr, Uu, Yhs, Yhs^Edt, Uu^Br|, Uu^Br\, Uu, Uu^Br/, Yhs^Xp, Uu, Uu, Rr, Uu, Uu, Cud, Qxu, Qxu, Qxu, Uu, Qxu, Qxu, Uzw, Uzw, Uu, Dd, Hd, Dd, Dd, Hd, Hd, Hd, Dd, Dd, Hd, Dd, Dd
Hd, Hd, Mdd, Mdd, Hd, Dd, Dd, Dd, Hd, Dd^Qhu, Dd, Ds^Qhu, Ds^Qhu, Dd, Dd, Ds, Yhs^Xp, Yhs^Esd, Uzw, Uzw, Yhs^Edb, Uu^Edb, Uu^Vd, Qxu, Uu, Qxu, Qxua, Qxu, Qxu, Cud, Qxu, Cud, Cud, Uu, Uu, Rr, Rr, Rr, Rr, Uu^Edt, Rr^Edt, Rr, Rr, Uu^Edt, Uu^Edt, Uu^Edt, Uu, Cud, Uu, Uu, Rr, Rr, Uu, Rr, Cud, Cud, Qxu, Qxu, Uu, Uu^Vud, Yhs, Uh, Uh, Uzw, Uu^Dr, Dd, Dd, Dd, Hd, Hd, Hd, Hd, Dd, Dd, Ds, Dd, Dd
Mdd, Mdd, Mdd, Mdd, Hd, Dd, Hd, Hd, Dd, Dd^Qhu, Yhs^Esd, Yhs^Esd, Ds^Esd, Dd^Qhu, Dd, Ds, Yhs^Esd, Yhs, Uu^Vu, Uzw^Edb, Yhs^Edb, Yhs^Edb, Uu^Edb, Uu, Qxu, Qxu, Qxu, Qxu, Qxu, Qxu, Qxu, Qxu, Qxu, Qxu, Qxu^Bcx/, Rr, Uu, Uu, Uu^Edt, Rr^Edt, Uu^Edt, Uu^Vyf, Uu, Rr, Rr^Edt, Uu^Edt, Rr, Uu, Rr, Rr, Uu, Uu, Qxu^Bcx\, Qxu, Qxu, Qxu, Qxu, Qxu, Qxu, Uu, Yhs^Yva, Uh, Uu, Uu^Dr, Ds^Dr, Dd^Edt, Dd, Dd, Dd, Dd, Hd, Hd, Hd, Ds, Hd, Dd, Dd
Mdd, Mdd, Hd, Hd, Hd, Dd, Dd, Hd, Ds^Qhu, Ds^Qhu, Yhs, Yhs^Xp, Uzw, Ds^Qhu, Cud^Qhu, Uu, Uu, Yhs, Uu, Uu^Dr, Uzw^Dr, Yhs^Xp, Uzw^Edb, Qxu, Qxu, Qxu, Qxu, Qxu, Qxu, Qxu, Qxu, Qxua, Qxu, Qxu^Bcx/, Qxu, Qxu, Cud, Uu^Edt, Uu, Uu^Edt, Uu^Edt, Uu^Edt, Uu, Uu^Edt, Uu, Rr, Uu, Rr, Cud, Uu, Cud, Qxu, Qxu, Qxu^Bcx\, Qxu^Bp\, Qxu, Qxu, Qxu, Qxu, Yhs, Uu, Uu, Uu, Uzw^Edt, Ds, Uzw^Edt, Yhs, Yhs^Esd, Ds, Dd, Dd, Dd, Dd, Dd, Dd, Dd, Dd
Hd, Mdd, Hd, Hd, Hd, Dd, Dd, Ds, Ds^Qhu, Yhs^Esd, Uu, Uzw^_mll, Uzw, Uu, Uu, Uu^Qhu, Uzw, Uu, Uzw, Uzw^Dr, Uzw, Uzw, Uzw, Qxu, Qxu, Yhs, Yhs^Xp, Cud, Yhs, Qxu, Qxu^Bcx/, Qxu, Qxu, Qxu, Qxu, Qxu, Qxu, Cud, Cud, Uu^Edt, Uu, Uu, Uu, Uu, Cud, Uu, Cud, Cud, Qxu, Cud, Qxu, Qxu, Qxu, Qxu, Qxu, Qxu, Qxu, Qxua, Qxu, Ds, Uh, Yhs^Xp, Yhs, Yhs, Yhs, Yhs, Uzw, Yhs^Esd, Ds^Qhu, Hd, Ds, Dd^Edp, Dd, Hd, Hd, Dd, Dd
Hd, Hd, Hd, Hd, Hd, Dd, Dd, Ds, Ds, Ds^Qhu, Uu, Uu, Yhs^Qhu, Uh, Uu^Qhu, Uh^Qhu, Uh, Uh, Uu, Yhs^Yva, Yhs, Uzw, Yhs^Xp, Uzw, Qxu, Yhs, Yhs^Dr, Yhs, Re, Re, Yhs, Qxu, Qxu, Qxu, Cud, Qxu, Qxu, Qxu, Qxu, Cud, Cud, Cud, Cud, Cud, Qxu, Cud, Qxu, Qxu, Qxu, Qxu, Qxu, Qxua, Qxu, Qxu, Qxu, Qxu, Uu, Qxu, Qxu, Ds^Es, Uu, Uu, Ds, Ds, Uh, Yhs^Xp, Uzw^Qhu, Ds^Qhu, Ds^Edt, Ds^Qhu, Uu^Qhu, Dd, Dd, Hd, Dd, Dd, Hd
Hd, Dd, Hd, Hd, Hd, Hd, Hd, Dd, Dd, Uh^Qhu, Uh^Qhu, Uh^Qhu, Dd, Uu^Qhu, Ds, Ds, Uh, Uu, Uu^Vyf, Yhs, Yhs^Xp, Uzw, Uu, Qxu, Qxu, Qxu, Uh, Yhs^Xp, Yhs, Yhs^Yva, Yhs, Yhs, Yhs, Qxu, Qxu, Yhs, Yhs, Qxu, Qxu, Qxu, Qxu, Qxu, Qxu, Qxu, Qxu, Qxu, Qxu, Qxu, Qxu, Qxu, Qxu, Qxu, Qxu, Uu, Uu, Uu, Qxu, Qxu, Ds, Ds, Ds^Es, Ds, Ds, Uzw, Uh, Yhs, Uzw^Qhu, Uu, Uu^Vyf, Yhs^Esd, Uu, Uu^Qhu, Ds, Ds, Hd, Dd, Ds
Hd, Hd, Hd, Hd, Mdd^Qhh, Hd, Mdd, Dd, Dd, Dd, Dd, Dd, Hd, Dd, Dd, Dd, Ds, Uzw, Yhs^Xp, Uu, Uh, Yhs, Uu, Uu, Uzw, Qxu, Uh, Uu, Uu, Uzw, Uh, Yhs^Yva, Qxu, Qxu, Yhs, Qxu, Yhs, Qxu, Qxu, Qxu, Qxu, Qxu, Qxua, Qxu, Qxu, Qxu, Qxu, Qxu, Qxu, Uu, Uh, Qxu, Yhs, Yhs^Yva, Uh, Uu, Uu, Uu, Uh, Yhs^Xp, Ds, Uzw, Uzw, Uh, Uu, Uzw^Qhu, Yhs^Yva, Yhs^Xp, Uu^Edb, Yhs^Edb, Yhs^Xp, Yhs^Qhu, Dd, Dd, Ds, Ds, Ds
Hd, Hd, Hd, Hd^Qhh, Hd, Mdd^Qhh, Mdd^Qhh, Mdd, Hd, Dd, Dd, Hd, Hd, Dd, Dd, Dd, Ds^Esd, Yhs^Esd, Ds^Esd, Ds, Uu, Uh, Uzw, Uzw, Uzw, Uh, Qxu, Uh, Uzw^Edb, Uu^Vd, Uu, Uu, Uu, Uzw, Yhs, Uh, Yhs^Xp, Yhs, Qxu, Yhs, Yhs, Qxu, Qxu, Qxu, Qxu, Uu, Qxu, Qxu, Qxu, Uu, Qxu, Qxu, Yhs, Yhs^Xp, Uh, Uu, Uu^Vd, Uh, Yhs, Yhs^Yva, Ds^Esd, Uzw, Yhs, Yhs, Uu^Qhu, Uu^Qhu, Uzw, Yhs, Yhs^Xp, Yhs^Edb, Yhs^Esd, Uu^Qhu, Dd, Hd, Hd, Ds, Dd
Dd, Hd, Hd, Hd^Qhh, Hd^Qhh, Mdd, Mdd, Mdd^Qhh, Mdd^Qhh, Dd, Dd, Hd, Hd, Dd, Dd, Dd, Uzw, Ds^Es, Uzw, Ds^Edb, Uzw^Edb, Uzw^Edb, Yhs, Yhs^Xp, Yhs, Uzw, Yhs, Qxu, Uzw^Edb, Yhs^Edb, Yhs^Xp, Uu, Uzw, Uh, Uh, Uu^Vu, Ds, Ds^Es, Ds, Qxu, Yhs^Xp, Yhs^Xp, Qxu, Qxu, Qxu, Qxu, Qxu, Uh, Uu, Qxu, Qxu, Yhs, Yhs, Uh, Yhs^Edb, Uu^Edb, Yhs^Edb, Yhs^Edb, Uh, Uh, Yhs^Xp, Yhs^Esd, Yhs, Yhs^Esd, Ds^Qhu, Ds, Ds, Yhs^Esd, Ds^Esd, Yhs^Esd, Ds^Qhu, Ds^Qhu, Hd, Hd, Hd, Hd, Hd
Dd, Dd, Hd, Hd, Hd^Qhh, Mdd^_mh, Mdd^Xm, Mdd^Xm, Mdd^Qhh, Hd, Hd, Hd, Hd, Hd, Hd, Dd, Ds, Ds, Uu, Uu^Edb, Uu, Uu^Vu, Uh, Uh, Qxu, Uh, Uh, Qxu, Uzw, Uzw^Edb, Yhs^Xp, Yhs^Xp, Uzw, Uzw, Uzw, Uu, Ds^Es, Yhs^Yva, Yhs, Ds, Ds, Yhs, Ds, Ds^Es, Ds, Ds, Qxu, Uu^Vd, Uh, Uh, Qxu, Qxu, Yhs^Edb, Yhs^Edb, Yhs^Edb, Yhs^Edb, Uu, Uu, Uu, Yhs^Yva, Yhs^Xp, Yhs, Ds^Esd, Yhs^Esd, Ds^Qhu, Ds^Es, Ds^_ml, Uzw, Ds, Ds^Qhu, Hd, Hd, Hd, Hd, Mdd, Hd, Hd
Dd, Hd, Hd, Mdd, Mdd^Qhh, Mdd^Xm, Mdd^Xm, Mdd^Xm, Mdd, Hd^Qhh, Hd, Hd, Hd, Hd, Dd, Dd, Yhs, Yhs, Uu, Uu, Uzw, Uu, Yhs, Uh, Uh, Qxu, Uu, Uu, Uu, Uzw, Yhs^Esd, Yhs, Yhs^Vyv, Uzw, Ds, Ds^Es, Ds^Dr, Yhs, Yhs^Xp, Yhs, Ds^Dr, Ds, Yhs, Ds, Ds, Ds, Uzw, Qxu, Uu, Uh, Uh, Qxu, Yhs^Edb, Yhs^Edb, Qxu, Uh, Qxu, Uu^Vyv, Uzw, Uzw, Yhs, Yhs, Ds^Es, Ds^Qhu, Uu, Yhs^Esd, Yhs^Esd, Ds, Ds^Es, Ds^Qhu, Ds^Qhu, Hd, Dd, Hd, Hd, Mdd, Mdd
Hd, Hd, Hd, Mdd^Qhh, Mdd^Xm, Mdd^Xm, Mdd^Xm, Mdd^Xm, Mdd^Qhh, Hd^Qhh, Hd, Hd, Hd, Hd, Dd, Dd, Yhs^Esd, Uu, Uu, Uu, Yhs^Yva, Yhs^Xp, Yhs, Uh, Qxu, Qxu, Yhs, Uu, Yhs^Esd, Ds, Ds^Esd, Yhs, Yhs, Uu, Ds, Ds^Es, Yhs, Ds^Es, Ds, Yhs^Esd, Uu, Uu, Yhs, Yhs^Esd, Yhs^Edb, Uzw^Edb, Uzw, Uu, Qxu, Yhs, Yhs, Yhs, Yhs, Qxu, Qxu, Qxu, Qxu, Yhs, Uzw^Qhu, Uzw^Qhu, Yhs^Qhu, Yhs^Qhu, Ds^Qhu, Uu^Qhu, Yhs^Xp, Yhs^Xp, Yhs^Esd, Ds^Esd, Yhs^Esd, Yhs^Esd, Uu^Qhu, Ds, Dd, Hd, Hd, Mdd, Hd
Dd, Hd, Hd, Hd^Qhh, Hd^Qhh, Hd, Mdd, Mdd^Qhh, Hd, Hd, Mdd, Hd, Hd, Hd, Hd, Dd, Ds, Ds^Esd, Ds^Esd, Yhs^Esd, Yhs^Xp, Yhs^Xp, Uzw, Qxu, Qxu, Uzw, Yhs, Yhs^Xp, Yhs, Uu, Ds^Es, Ds^Esd, Ds, Ds, Ds, Uzw, Uzw, Yhs, Yhs, Yhs^Yva, Uu, Uu^Vu, Uu, Yhs^Xp, Yhs, Uzw^Edb, Uzw, Uzw, Qxu, Qxu, Qxu, Yhs^Xp, Uu, Uu, Qxu, Qxu, Yhs, Yhs, Uzw^Qhu, Yhs, Ds, Ds, Uu, Yhs^Yva, Uu, Yhs, Ds, Ds, Yhs^Yva, Yhs^Xp, Uu, Uu^Qhu, Hd, Hd, Mdd, Hd, Mdd
Hd, Hd, Hd, Hd, Hd, Hd^Qhh, Dd^Qhh, Mdd^Qhh, Mdd, Mdd, Mdd, Hd, Hd, Hd, Hd, Hd, Hd, Ds, Yhs, Yhs, Yhs, Yhs, Uzw, Uzw, Uzw, Uzw, Uzw, Yhs, Yhs, Uu, Uu, Ds, Ds, Ds^Es, Ds, Uzw, Uzw, Yhs, Yhs, Yhs, Ds, Uu, Ds, Yhs, Yhs, Yhs, Yhs, Uzw, Qxu, Qxu, Uh, Yhs, Uu, Uu, Qxu, Qxu, Qxu, Yhs, Uzw^Qhu, Ds, Ds, Ds^Es, Yhs, Uu, Uu, Uu, Uu, Yhs, Uu, Uu, Uu, Uu^Qhu, Hd, Hd, Mdd, Mdd, Mdd
