border_size=1
usage=map

Xu, Xu, Xu, Xu, Xu, Xu, Xu, Xu, Xu, Xu, Xu, Xu, Xu, Xu, Xu, Xu, Xu, Xu, Xu, Xu, Xu, Xu, Xu, Xu, Xu, Xu, Wwg, Xu, Xu, Xu, Xos, Xos, Urb, Rr, Urb, Xos, Xos, Xos, Xos, Xos, Xos, Xos, Xos, Qxu, Qxu, Qxu, Qxu, Qxu, Xos, Xos, Xos, Xos, Xos, Xos, Xos, Xos, Xos, Xos, Xos, Xos, Xos, Qxu, Qxu, Qxu, Qxu, Qxu, Qxu, Qxu, Qxu, Qxu, Qxu, Qxu, Qxu, Qxu, Qxu
Xu, Xu, Xu, Xu, Xu, Xu, Xu, Xu, Xu, Xu, Xu, Xu, Xu, Xu, Xu, Xu, Xu, Xu, Xu, Xu, Xu, Xu, Xu, Xu, Xu, Xu, Xu, Wwg, Wwg, Xu, Xos, Xos, Urb, Rr, Urb, Xos, Xos, Xos, Xos, Xos, Xos, Xos, Xos, Qxu, Qxu, Qxu, Qxu^Xo, Qxu^Xo, Qxu, Xos, Xos, Xos, Xos, Xos, Xos, Xos, Xos, Xos, Xos, Xos, Xos, Xos, Xos, Qxu, Qxu, Qxu, Qxu^Xo, Qxu, Qxu, Qxu, Qxu, Qxu, Qxu, Qxu, Qxu
Xu, Xu, Xu, Xu, Xu, Xu, Xu, Xu, Xu, Xu, Wog, Wog, Xu, Xu, Xu, Xu, Xu, Xu, Xu, Xu, Xu, Xu, Xu, Xu, Xos, Xu, Xu, Xu, Xu, Wwg^Xo, Xos, Xos, Urb, Rr, Urb, Xos, Xos, Yhl, Yhl, Xos, Xos, Xos, Xos, Qxu, Qxu^Xo, Qxu^Xo, Qxu, Qxu, Xos, Uu, Ur^Z/, Xos, Xol, Xos, Xos, Urb, Urb, Xos, Xu, Xu, Xu, Xos, Xos, Xos, Xos, Qxu^Xo, Qxu, Qxu^Xo, Qxu^Xo, Qxu, Qxu, Qxu, Qxu, Qxu, Qxu
Xu, Xu, Xu, Xu, Xu, Xu, Xu, Xu, Xu, Xu, Wwg, Wog, Wog, Wog, Wwg, Xu, Xos, Xu, Xu, Xu, Xu, Xu, Xos, Xos, Xos, Xos, Xos, Xu, Xos, Wwg, Qxu, Qxu, Urb, Rr, Urb, Qxu, Qxu, Yhl, Yhr^Xp, Xos, Xos, Xos, Xos, Xos, Xos, Qxu, Uu, Xos, Xos, Xos, Ur^Em, Ur^Em, Uu, Xol, Xos, Xos, Xol, Urb, Urb, Xu, Xu, Xu, Xos, Xos, Xos, Xos, Yhr, Qxu, Qxu, Qxu^Xo, Qxu^Xo, Qxu, Qxu, Qxu, Qxu
Xu, Xu, Xu, Xu, Xu, Xu, Xu, Xu, Xu, Wwf, Wwf, Wwg, Wwg, Wwg, Uh, Xos, Xos, Xos, Xos, Xu, Xos, Xos, Xos, Xos, Xos, Xos, Xos, Xos, Qxu, Qxu, Qxu, Qxu, Urb, Rr, Urb, Qxu, Qxu, Qxu, Qxu, Xos, Xos, Xos, Xos, Xos, Xos, Xos, Xos, Urb^Z/, Urb, Uu^Uf, Wwf, Wwf, Xos, Xos, Xos, Xol, Urb, Urb^Z\, Xos, Xos, Xos, Xos, Xol, Xos, Xos, Yhr^Xp, Xos, Xos, Xos, Qxu, Qxu^Xo, Qxu, Qxu, Qxu, Qxu
Xu, Xu, Xu, Xu, Xu, Xu, Xu, Xu, Xu, Xu, Uu, Wwg, Uu, Wwf, Wwf, Xos, Xos, Xos, Xos, Xos, Xos, Xos, Xos, Xos, Xos, Xos, Xos, Yhl, Qxu, Qxu, Urb, Urb^Bz, Rr, Rr, Rr, Urb^Bz, Urb, Qxu, Qxu, Qxu, Yhr^Xp, Xos, Xos, Urb, Urb^Z/, Xos, Urb, Urb, Urb, Ur^Em, Xos, Xos, Xol, Xos, Urb, Urb, Xos, Urb, Urb^Z/, Xos, Xol, Xol, Uh, Uu^Uf, Uu^Uf, Yhr, Xos, Xos, Yhr^Xp, Qxu, Qxu, Qxu^Xo, Qxu, Qxu, Qxu
Xu, Xu, Xu, Xu, Xu, Xu, Xu, Xu, Uu, Xu, Uu, Uu, Urb^Ii, Wwf, Uu, Xos, Xos, Xos, Xu, Xos, Xos, Xos, Yhr, Xos, Xos, Xos, Yhr^Xp, Yhl, Qxu, Qxu, Urb, Rr, Rr, Rr, Rr, Rr, Urb, Qxu, Qxu, Qxu, Yhr, Xos, Xos, Xos, Xos, Urb, Urb, Urb, Xos, Xos, Xos, Xol, Urb, Urb, Urb^Z/, Xos, Xos, Xos, Xos, Wwf, Ur, Xol, Xos, Yhr^Xp, Yhr, Yhr, Yhr, Yhr, Xos, Xos, Qxu, Qxu^Xo, Qxu, Qxu, Qxu
Xu, Xu, Xu, Xu, Wog, Xu, Wwf, Xu, Uu, Uu, Cud, Uu, Urb, Urb^Ii, Uu, Uu, Uu, Xu, Xu, Xos, Xos, Yhr, Xos, Xos, Xos, Yhl, Yhl, Yhr, Qxu, Qxu, Urb, Rr, Rr, 4 Rr, Rr, Rr, Urb, Qxu, Qxu, Qxu, Qxu, Xos, Xos, Xos, Xos, Urb, Urb, Xol, Xol, Xos, Urb, Urb, Xos, Xos, Xos, Urb, Xos, Xos, Xos, Ur, Xos, Ur^Z/, Ur, Yhr, Yhr, Yhr, Yhr, Xos, Xos, Xos, Qxu, Qxu^Xo, Qxu, Qxu, Qxu
Xu, Xu, Xu, Wog, Wwg, Wwg, Uu, Uu, Uu, Cud, 3 Kud, Cud, Uh, Urb, Uu, Uu^Bzu, Uu, Xu, Xu, Xos, Xos, Yhr, Xos, Xos, Xos, Yhl, Yhl^Xp, Yhr^Xp, Qxu, Qxu, Urb, Rr, Rr, Rr, Rr, Rr, Urb, Qxu, Xos, Xos, Xos, Qxu, Yhl, Xos, Xos, Uu^Em, Uu^Em, Urb, Urb, Uu, Urb, Urb, Urb, Xos, Xol, Xos, Xos, Xos, Xol, Urb, Xos, Xos, Xos, Yhr^Xp, Yhr, Yhr^Xp, Uu, Xos, Yhr^Xp, Yhr, Xos, Qxu^Xo, Qxu, Qxu, Qxu
Xu, Xu, Xu, Wog, Wwg, Wwg, Uu, Urb^Ii, Uh, Cud, Cud, Cud, Uu^Uf, Uu^Vu, Uh, Uu, Uu, Xu, Xos, Xos, Xos, Yhr, Yhr^Z/, Xos, Xos, Xos, Xos, Qxu, Qxu, Qxu, Urb, Urb, Urb, Rr, Urb, Urb, Xol, Xos, Xos, Xos, Xos, Xos, Xos, Yhl, Xos, Xos, Xos, Urb, Urb, Urb, Xos, Urb, Urb, Urb, Urb, Xol, Xos, Xol, Urb, Urb, Xos, Xos, Xos, Xos, Uh, Yhr^Xp, Uu, Uh, Xos, Xos, Xos, Xos, Xos, Qxu, Qxu
Xu, Xu, Xu, Xu, Wwg, Wwf, Uu, Uu, Urb, Uu^Uf, Ur, Urb, Urb, Uu^Uf, Uu, Uh, Uh, Xos, Xos, Xos, Xos, Xos, Yhr, Yhr, Xos, Xos, Xos, Qxu, Qxu, Qxu, Xos, Urb, Urb, Rr, Rr^Zz/, Urb^Zz/, Urb, Xol, Xos, Xos, Xos, Xos, Xos, Xos, Xol, Xos, Urb, Urb, Urb, Xos, Xos, Xos, Xos, Urb, Urb, Urb, Urb, Urb, Xos, Xos, Xos, Xos, Xos, Xos, Uu^Ufi, Uu^Uf, Yhr^Xp, Xos, Xos, Xos, Xos, Xos, Xos, Xos, Xos
Xu, Xu, Xu, Xu, Wwf, Uh, Uu, Uu^Uf, Uu^Vu, Uu^Uf, Uu^Uf, Urb, Urb, Uu, Uu^Bzu, Uh, Uh, Xos, Xos, Xos, Urb, Yhr, Yhr, Yhr, Yhr, Xos, Xos, Xos, Xos, Xos, Xos, Xos, Xos, Urb^Zz/, Rr, Rr, Rr, Urb, Urb, Xos, Qxu, Qxu, Qxu, Xol, Urb, Urb^Z\, Urb^Z\, Urb, Xos, Xos, Xos, Xos, Xos, Uu^Em, Ur^Em, Xos, Xos, Urb, Urb^Z/, Xos, Urb^Z\, Urb, Xos, Xos, Uh, Uh, Yhr^Xp, Xos, Yhr, Xos, Xos, Xos, Xos, Xos, Xos
Xu, Xu, Xu, Xu, Xu, Uh, Uh, Uu, Uu^Uf, Urb, Uu, Uu, Urb, Urb, Urb, Urb, Xol, Xol, Urb, Urb, Urb^Ii, Urb, Xos, Yhr^Xp, Yhr^Vud, Yhr, Yhr, Xos, Xos, Xos, Xos, Xos, Urb, Urb, Rr, Rr, Rr^Ii, Rr, Rr, Urb, Urb, Qxu, Urb, Urb, Urb, Urb, Xos, Xos, Xos, Xos, Xos, Xos, Xos, Uu^Em, Urb^Em, Xol, Xol, Xos, Xos, Urb, Xos, Xos, Xos, Xos, Yhr, Yhr, Uu, Yhr, Xos, Xos, Xos, Xos, Xos, Xos, Xos
Xu, Xu, Xu, Xu, Xu, Xu, Uh, Uu^Uf, Uh, Urb, Urb, Uu^Uf, Urb, Urb, Urb^Zz/, Urb^Zz/, Urb, Urb, Urb, Urb, Xos, Xos, Xos, Xos, Xos, Yhr^Xp, Yhr, Xos, Yhr^Z\, Yhr, Xos, Xos, Urb, Rr, Rr, Rr, Rr, Rr, Rr, Rr, Urb, Urb, Urb, Urb, Qxu, Qxu, Xos, Xos, Urb, Xos, Xos, Xos, Xos, Wwf, Urb, Urb, Urb, Xol, Urb^Z\, Urb, Xos, Xos, Xos, Xos, Uu, Yhr^Xp, Uh, Xos, Xol, Xos, Xos, Xos, Xos, Xos, Xos
Xu, Xu, Xu, Xu, Xos, Xos, Xos, Uh, Uh, Uu^Vu, Uh, Urb, Xos, Urb^Zz/, Urb, Rr, Rr, Urb, Urb, Xos, Yhr, Yhr^Vud, Yhr^Xp, Xos, Xos, Xos, Yhr, Yhr^Xp, Xos, Xos, Xos, Xos, Urb, Rr, Rr, Rr, 2 Rr, Rr, Rr, Rr, Urb, Urb, Qxu, Qxu, Qxu, Qxu, Xos, Xos, Xos, Urb^Z/, Urb, Xos, Urb, Urb, Xos, Urb, Urb, Urb, Xos, Xos, Xos, Xos, Xos, Xos, Uu^Ii, Uu^Vu, Uh, Xol, Xol, Xos, Xos, Xos, Xos, Xos, Xos
Xu, Xu, Xos, Xos, Xos, Xos, Xos, Xos, Xos, Uh, Xos, Xos, Xos, Urb, Urb, Urb, Rr, Urb, Urb^Ii, Urb, Urb, Yhr, Xos, Xos, Xos, Xos, Yhr^Z\, Yhr, Xos, Xos, Xos, Urb, Urb^Ii, Rr, Rr, Rr, Rr, Rr, Rr, Rr, Urb, Qxu, Qxu, Qxu, Qxu, Qxu, Xos, Xos, Urb, Urb^Z\, Xos, Urb, Xos, Xos, Xos, Urb, Urb, Urb, Urb^Z/, Xos, Xos, Xos, Xos, Uu^Uf, Yhr^Xp, Yhr^Ii, Yhr, Uh, Xu, Xos, Xos, Xos, Xos, Xos, Xos
Xos, Xos, Xol, Xol, Yhr, Xol, Xol, Xos, Xos, Xos, Xos, Xos, Urb, Urb, Urb, Urb, Rr, Urb, Urb, Urb, Xos, Xos, Xos, Xos, Xos, Yhr, Xol, Xos, Xos, Xos, Urb^Ebme, Urb, Rr, Rr, Rr, Rr, Rr, Rr, Rr, Rr, Urb, Urb, Urb, Qxu, Qxu, Qxu, Xos, Xos, Xos, Xos, Xos, Xos, Xos, Xos, Xos, Urb, Wwf, Xos, Xos, Urb, Xos, Xos, Xos, Uh, Uu^Uf, Yhr, Yhr^Xp, Yhr, Xu, Xu, Xu, Xos, Xos, Xos, Xos
Xos, Xos, Yhr, Yhr, Yhr^Ii, Yhr, Yhr^Uf, Xos, Xos, Xos, Yhr^Z\, Urb, Uu^Vu, Urb, Urb, Rr, Rr, Urb, Urb, Urb, Urb, Xos, Xos, Xos, Xol, Xos, Xos, Xos, Urb^Ebme, Urb^Ebur, Rr, Rr, Urb, Urb, Urb^Ii, Rr, Rr, Rr, Urb, Urb, Qxu, Urb, Urb, Urb, Urb, Qxu, Xol, Xos, Xos, Xos, Xos, Xos, Xol, Xol, Urb, Urb, Urb, Xos, Xos, Xos, Xos, Xos, Xos, Uu, Uh, Uu^Ii, Uu, Uu^Uf, Xu, Xu, Xu, Xos, Xos, Xos, Xos
Xos, Xos, Yhr, Yhr^Ii, Yhr^Ii, Yhr^Ii, Yhr, Xos, Xos, Yhr, Xol, Xos, Urb, Urb, Urb, Rr, Urb, Urb, Urb, Uu^Vu, Urb, Urb, Xos, Xol, Urb, Urb, Urb, Urb^Ebur, Rr, Rr, Urb, Urb, Xos, Xos, Xos, Urb, Urb, Urb, Qxu, Qxu, Qxu, Qxu, Qxu, Urb, Urb, Urb, Urb, Xol, Xos, Xos, Xos, Xos, Urb, Urb, Urb, Urb, Urb, Xos, Xos, Xos, Urb, Xos, Xos, Xos, Xos, Uu^Uf, Xu, Xu, Xu, Xu, Xu, Xos, Xos, Xos, Xos
Xos, Xos, Yhr, Yhr^Ii, Yhr^Ii, Yhr^Ii, Yhr, Xos, Xos, Xos, Xos, Xos, Xos, Urb, Urb, Rr, Urb^Zz/, Xos, Xos, Urb, Xos, Xos, Xol, Xol, Urb, Urb, Rr, Rr, Urb, Urb, Xos, Xos, Xos, Xos, Xos, Xos, Xos, Qxu, Qxu, Qxu, Qxu, Qxu, Qxu, Qxu, Xos, Urb, Urb^Z/, Urb^Z/, Urb, Xol, Xol, Xos, Urb, Urb, Xos, Xos, Xos, Urb^Z/, Urb, Urb, Qxu, Xu, Xu, Xos, Xu, Xu, Xu, Xu, Xu, Xu, Xu, Xos, Xos, Xos, Xos
Xos, Xos, Xos, Yhr, Yhr, Yhr, Xos, Xos, Xos, Xos, Xos, Xos, Xos, Xos, Urb^Zz/, Rr^Zz/, Urb, Xos, Xos, Xos, Xol, Xos, Urb, Urb, Rr, Rr, Urb, Urb, Xos, Xos, Xos, Xos, Xos, Xos, Xos, Xos, Xos, Xos, Xos, Qxu, Qxu, Qxu, Xos, Xos, Xos, Xos, Xos, Urb, Urb, Urb, Urb, Xos, Urb, Urb, Xos, Xos, Xos, Xos, Urb, Qxu, Qxu, Qxu, Qxu, Xu, Xu, Xu, Xu, Xu, Xu, Xu, Xu, Xos, Xos, Xos, Xos
Xos, Xos, Xos, Cud, 5 Kud, Cud, Xos, Xos, Xos, Xos, Xos, Xos, Xos, Xos, Urb, Rr, Rr, Urb, Urb, Xol, Urb^Zz\, Urb, Rr, Rr, Urb, Urb, Xos, Xos, Xol, Xol, Urb^Z\, Urb, Urb, Xos, Xos, Xos, Xos, Xos, Xos, Xos, Xos, Xos, Xos, Xos, Xos, Xos, Xos, Xos, Xos, Urb, Urb, Urb, Urb, Urb, Xos, Xos, Xos, Xos, Urb, Qxu, Qxu, Qxu, Qxu, Xu, Uu^Uf, Uu^Emf, Uh, Xu, Xu, Xu, Xu, Xos, Xos, Xos, Xos
Xos, Xos, Xos, Cud, Rr, Cud, Xos, Xos, Xos, Xos, Urb, Xos, Urb, Urb, Urb, Urb, Urb, Rr, Urb, Urb, Urb, Rr^Zz\, Urb^Zz\, Urb, Xos, Xos, Xos, Xol, Urb^Z\, Urb, Urb, Urb^Z\, Xos, Xos, Xos, Xos, Xos, Xos, Xos, Xos, Xos, Xos, Xos, Xos, Xos, Xos, Xos, Xos, Xos, Xos, Xos, Urb, Xos, Xos, Xos, Xos, Xos, Xos, Xu, Xu, Xu, Qxu, Qxu, Qxu, Uu^Ii, Uu^Uf, Uu, Uh, Xu, Xu, Xos, Xos, Xos, Xos, Xos
Xos, Xos, Xos, Urb, Rr, Urb, Urb, Xos, Urb, Urb, Rr, Urb, Rr, Urb, Rr, Urb, Rr, Rr, Rr, Urb, Rr, Rr, Urb, Urb^Zz\, Xos, Xos, Xos, Urb, Urb, Urb^Z\, Xos, Urb, Urb^Z/, Xos, Urb, Xol, Xol, Xos, Xu, Xos, Xos, Xos, Xos, Xos, Xos, Xos, Xos, Xos, Xos, Xos, Xos, Xos, Xos, Xos, Xos, Xos, Xos, Xu, Xu, Xu, Qxu, Qxu, Qxu, Uu, Uu, Ur^Em, Uu^Uf, Uh, Xos, Xos, Xos, Xos, Xos, Xos, Xos
Xos, Xos, Xos, Urb, Urb, Rr, Rr, Urb, Rr, Rr, Urb, Rr, Urb, Rr, Urb, Rr, Urb, Urb, Urb, Rr, Rr, Urb, Urb, Xos, Xos, Xos, Xos, Xos, Xos, Xos, Xos, Xos, Urb, Rr, Rr, Urb, Urb, Xu, Xu, Xu, Xos, Xos, Xos, Xos, Xol, Xos, Xol, Xos, Xos, Xos, Xos, Urb, Xos, Xos, Xos, Xos, Xos, Xu, Xu, Xu, Xu, Qxu, Xu, Xu, Uu, Ur, Uu^Bzu, Xos, Xos, Xos, Xos, Xos, Xos, Xos, Xos
Qxu, Xos, Xos, Xos, Urb, Rr, Rr, Rr, Urb, Urb, Xos, Urb, Xos, Urb, Xos, Urb, Qxu, Qxu, Qxu, Urb, Urb, Rr, Urb, Xos, Xos, Xos, Xos, Xos, Xos, Xos, Xos, Urb, Urb, Urb, Rr, Rr, Urb, Xu, Xu, Xu, Xos, Xos, Xos, Xol, Iwr, Cud, Iwr, Xol, Xos, Xos, Urb, Urb, Xos, Xos, Xos, Xos, Xos, Xos, Xos, Xu, Xu, Xu, Xu, Xu, Ur, Uu, Uu, Xos, Xos, Xos, Xos, Xos, Xos, Xos, Xos
Qxu, Qxu, Qxu^Xo, Xos, Urb, Rr, Urb, Urb, Xos, Xos, Xos, Xos, Xos, Xos, Xos, Xos, Xos, Qxu, Qxu, Urb, Urb, Rr, Urb, Yhr^Ii, Yhr^Xp, Xos, Xos, Xos, Xos, Xos, Xos, Urb, Rr, Rr, Urb, Urb, Xos, Xos, Xos, Xos, Xol, Xos, Iwr, Cud, Iwr, Iwr, Iwr, Cud, Iwr, Xos, Xol, Xos, Xos, Urb, Urb, Xos, Xos, Xos, Xos, Xos, Xos, Xu, Uu^Uf, Uh, Uu, Uu^Ii, Xos, Xos, Xos, Xos, Xos, Xos, Xos, Xos, Xos
Qxu, Qxu, Qxu^Xo, Qxu, Urb, Rr, Urb, Xos, Xos, Xos, Xos, Xos, Xos, Xos, Xos, Xos, Xos, Xos, Urb, Urb, Rr, Rr, Urb, Yhr^Ii, Yhr, Xu, Xu, Xu, Xu, Xu, Xu, Urb, Rr, Urb, Xos, Xos, Xos, Xos, Xos, Xol, Iwr, Cud, Iwr, Iwr, Wog, Wog, Wog, Iwr, Iwr, Cud, Iwr, Xol, Xos, Xos, Xos, Urb, Urb, Xu, Xu, Xu, Xu, Uu, Ur, Ur^Em, Uu, Xos, Xos, Xos, Xos, Xos, Xos, Xos, Xos, Xos, Xos
Qxu, Qxu, Qxu^Xo, Qxu, Urb, Rr, Urb, Xos, Xos, Xos, Xos, Xos, Xos, Xos, Xos, Xos, Urb, Urb, Rr, Rr, Urb, Urb, Urb, Yhr, Yhr^Xp, Xu, Xu, Xu, Xu, Xu, Xu, Urb, Rr, Urb, Xol, Xos, Xos, Xos, Xos, Cud, Iwr, Iwr, Wog, Wog, Wog, Wog, Wog, Wog, Iwr, Iwr, Iwr, Cud, Xos, Xos, Xos, Xos, Xu, Xu, Xu, Xu, Xu, Uu^Ii, Uu, Uu^Em, Xu, Xos, Xos, Xos, Xos, Xos, Xos, Xos, Xos, Xos, Xos
Qxu, Qxu, Qxu^Xo, Qxu, Urb, Rr, Urb, Xol, Xol, Xos, Xos, Xos, Xos, Xos, Xos, Xos, Urb, Rr, Urb, Urb, Xos, Xos, Xos, Yhr^Ii, Yhr, Xu, Xu, Xu, Xos, Xos, Xos, Urb, Rr, Urb, Urb, Xol, Xos, Xos, Xol, Xos, Iwr, Iwr, Iwr, Wog, Wog, Wog, Iwr, Iwr, Iwr, Cud, Xos, Xos, Xos, Xos, Xos, Xu, Xu, Xu, Urb, Xu, Uu^Uf, Uu, Uu^Uf, Xu, Xu, Xu, Xu, Xos, Xos, Xos, Xos, Xos, Xos, Xos, Xos
Qxu, Qxu, Qxu^Xo, Qxu, Urb, Rr, Urb, Urb, Urb, Xos, Xol, Xos, Xos, Xos, Qxu, Qxu, Urb, Rr, Urb, Xos, Xos, Xos, Xos, Xos, Xos, Xu, Xos, Xos, Xos, Xos, Xos, Urb, Rr, Rr, Rr, Urb, Urb, Xol, Urb, Cud, Cud, Iwr, Iwr, Iwr, Iwr, Iwr, Iwr, Cud, Xos, Xos, Xos, Xos, Xos, Xos, Xu, Xu, Xu, Xu, Uh, Uh, Uu^Uf, Ur, Uu, Uu, Wwg, Xu, Xu, Xu, Xu, Xos, Xos, Xos, Xos, Xos, Xos
Qxu, Qxu, Qxu^Xo, Qxu, Urb, Rr, Rr, Urb, Urb, Urb, Urb, Xol, Urb, Qxu, Qxu, Qxu, Urb, Rr, Urb, Xol, Xol, Xos, Xos, Xos, Xos, Xos, Xos, Xos, Xol, Xos, Urb^Ebme, Urb, Rr, Rr, Rr, Rr, Rr, Urb, Rr, Rr, Urb, Cud, Xos, Xos, Xos, Cud, Xos, Xos, Xos, Xos, Xos, Xos, Xos, Xos, Xu, Xu, Xu, Xu, Xu, Uu^Uf, Uu, Ur^Ii, Uu, Uh, Xu, Wwg, Wog, Xu, Xu, Xos, Xos, Xos, Xos, Xos, Xos
Qxu, Qxu, Xos, Xos, Xos, Urb, Urb, Rr, Rr, Urb, Urb, Urb, Urb, Urb, Urb, Urb, Urb, Rr, Urb, Urb, Urb, Xos, Xos, Xos, Xos, Xos, Xos, Xol, Urb, Urb, Rr, Rr, Urb, Urb, Urb, Rr, Rr, Rr, Rr, Urb, Urb, Xol, Xol, Xos, Xol, Xos, Xos, Xos, Xos, Xos, Xos, Xos, Xos, Xos, Xos, Xu, Xu, Xu, Xu, Uu^Em, Uu, Uu, Uu^Uf, Xu, Xu, Wog, Wog, Xu, Xu, Xos, Xos, Xos, Xos, Xos, Xos
Xos, Xos, Xos, Xos, Xos, Xos, Xos, Urb, Urb, Rr, Rr, Urb, Rr, Rr, Rr, Rr, Rr, Rr, Rr, Urb, Urb, Urb, Urb, Xol, Xol, Xol, Urb, Urb^Ebur, Rr, Rr, Urb, Urb, Xos, Xos, Xos, Urb, Urb, Rr, Rr, Rr, Rr, Urb, Urb, Xos, Xol, Xol, Xos, Xos, Xos, Xos, Xos, Xos, Xos, Xos, Xos, Xu, Xu, Xu, Qxu^Xo, Qxu, Qxu, Xu, Xu, Xu, Xu, Xu, Xu, Wog^Xo, Wog, Xos, Xos, Xos, Xos, Xos, Xos
Xos, Xos, Xos, Xos, Iwr, Xos, Xos, Urb, Rr, Rr, Rr, Rr, Rr, Rr, Rr, Rr^Ii, Rr, Rr, Rr, Rr, Rr, Urb, Urb, Urb, Urb, Urb^Z\, Rr^Z\, Rr, Urb, Urb, Xos, Xos, Xos, Xos, Xos, Xos, Xos, Urb, Urb, Rr, Rr, Rr, Rr, Urb^Bzu, Urb, Xol, Xol, Xos, Xos, Xos, Xos, Xos, Xos, Xos, Xos, Xu, Xu, Qxu, Qxu, Qxu^Xo, Qxu^Xo, Xu, Xu, Xu, Xu, Xu, Xu, Xu, Xos, Wog, Wog, Xos, Xos, Xos, Xos
Xos, Xos, Xos, Iwr, Iwr, Iwr, Cud, Urb, Rr, Rr, Rr^Ii, Rr, Rr, Rr, Rr, Rr, Rr, Rr, Rr, Rr, Rr, Rr^Ii, Urb, Urb, Rr, Rr, Urb, Urb^Z\, Xos, Xos, Xos, Xos, Xos, Xos, Xos, Xos, Xos, Xos, Xos, Urb, Urb^Bzu, Rr, Rr, Rr, Rr^Z/, Xol, Urb, Urb, Urb^Bzu, Xol, Xol, Xos, Xos, Xos, Xos, Xu, Xu, Xu, Xu, Qxu, Qxu, Xu, Xu, Xu, Xos, Xos, Xos, Xos, Xos, Xos, Xos, Wog, Xos, Xos, Xos
Xos, Xos, Xos, Iwr, Iwr, Iwr, Xos, Urb, Rr, Rr, Rr, Rr, Rr, Rr, Rr, Rr, Rr, Rr, Rr, Rr, Rr, Rr, Rr, Rr, Urb, Urb, Urb, Xos, Xos, Xos, Xos, Xos, Xu, Xos, Xos, Xos, Xos, Xos, Xos, Xos, Xos, Urb, Xol, Rr^Z/, Rr, Rr, Rr^Cov, Urb^Cov, Urb^Cov, Urb, Urb^Bzu, Xos, Xol, Xos, Xos, Xos, Xos, Xu, Xu, Xu, Xu, Xu, Xu, Xos, Xos, Xos, Xos, Xos, Xos, Xos, Xos, Xos, Xos, Xos, Xos
Xos, Xos, Xos, Xos, Xos, Xos, Xos, Urb, Rr, Rr, Rr, Rr, Rr, Rr, Rr, Rr, Rr, Rr, Rr, Rr, Rr, Rr, Urb, Urb^Ii, Urb, Urb, Xu, Xos, Xos, Xos, Xos, Xu, Xu, Xu, Xu, Xos, Xos, Xos, Xos, Xos, Xos, Xol, Urb, Urb, Urb, Rr^Cov, Rr^Cov, 1 Rr^Kov, Rr^Cov, Urb^Cov, Urb, Urb, Urb^Bzu, Xol, Xos, Xos, Xos, Xos, Xos, Xu, Xu, Xu, Xos, Xos, Xos, Xos, Xos, Xos, Xos, Xos, Xos, Xos, Xos, Xos, Xos
Xos, Xos, Xos, Xos, Xos, Xos, Xos, Urb, Rr, Rr, Rr, Rr, Rr, Rr, Rr, Rr^Ii, Rr, Rr, Rr, Rr, Rr, Rr, Urb, Urb, Urb, Urb, Xu, Xu, Xu, Xos, Uu, Uu^Uf, Wwf, Xu, Xu, Xu, Xos, Xos, Xos, Xos, Xos, Xos, Xos, Urb^Bzu, Urb, Urb, Urb, Rr^Cov, Rr, Rr, Rr, Urb, Urb, Urb, Urb^Bzu, Xol, Xol, Xos, Xos, Xos, Xos, Xos, Xos, Xos, Xos, Xos, Xos, Xos, Xos, Xos, Xos, Xos, Xos, Xos, Xos
Xos, Xos, Xos, Xos, Iwr, Xos, Xos, Urb, Urb, Rr, Rr, Rr, Rr, Rr, Rr, Rr, Rr, Rr, Rr, Rr, Rr, Urb^Ii, Urb, Urb, Xu, Urb, Cud, Xu, Uu, Uu, Xu, Uu, Uh, Wwf, Xu, Xu, Xos, Xos, Xos, Xos, Xos, Xos, Xos, Xos, Xos, Urb^Bzu, Urb, Urb, Urb, Rr, Rr, Rr, Rr, Urb, Urb, Urb, Urb^Bzu, Xos, Xos, Xos, Xos, Xos, Xos, Xos, Xos, Xos, Xos, Xos, Xos, Xos, Xos, Xos, Xos, Xos, Xos
Xos, Xos, Xos, Iwr, Iwr, Iwr, Cud, Urb, Urb, Rr^Ii, Rr, Rr, Rr, Rr, Rr, Rr, Rr, Rr, Rr, Rr, Urb, Urb, Xu, Xu, Xu, Xu, Xu, Urb, Ur^Br/, Ur^Br/, Uu, Uu, Xu, Xu, Xu, Xu, Xos, Xos, Xos, Xos, Xos, Xos, Xos, Xos, Xos, Xos, Xos, Urb^Bzu, Urb, Urb, Urb, Rr, Rr, Rr, Rr, Urb, Urb, Urb, Urb^Bzu, Xol, Xol^Zok, Xos, Xos, Xos, Xos, Xos, Xos, Xos, Xos, Xos, Xos, Xos, Xos, Xos, Xos
Xos, Xos, Xos, Iwr, Iwr, Iwr, Xos, Xos, Xos, Urb, Urb, Rr, Rr, Rr, Rr, Rr, Rr^Ii, Rr, Urb, Urb, Xos, Xu, Xu, Xu, Xu, Xu, Uu, Uu, Uu^Br|, Uu, Uh, Uh, Xu, Xu, Xu, Xos, Xos, Xos, Xos, Xos, Xos, Xos, Xos, Xos, Xos, Xos, Xos, Xos, Xos, Urb^Bzu, Urb, Urb, Urb, Rr, Rr, Rr, Rr, Urb, Rb^Zok, Urb^Zok, Xos^Zok, Xos^Zok, Xos, Xos, Xos, Xos, Xos, Xos, Xos, Xos, Xos, Xos, Xos, Xos, Xos
Xos, Xos, Xos, Xos, Iwr, Xos, Iwr, Xos, Xos, Xos, Xos, Urb, Urb, Urb, Urb, Urb, Urb, Urb, Xos, Xos, Xos, Xu, Xu^Zok, Xu^Zok, Uu^Zok, Uu, Uu^Br/, Ur^Br/, Uu, Uu^Uf, Xos, Xu, Xu, Xu, Xos, Xos, Xos, Xos, Xos, Xos, Xos, Xos, Xos, Xos, Xos, Xos, Xos, Xos, Xos, Xos, Xos, Urb^Bzu, Urb, Urb, Urb, Rr, Rr^Zok, Rr^Zok, Xos^Zok, Xos^Zok, Xos, Xos, Xos, Xos, Xos, Xos, Xos, Xos, Xos, Xos, Xos, Xos, Xos, Xos, Xos
Xos, Xos, Xos, Xos, Xos, Iwr, Iwr, Iwr, Iwr, Xos, Xos, Xos, Xos, Xos, Xos, Xos, Xos, Xos, Xos, Xos, Xos, Xos, Xos, Xos^Zok, Xos^Zok, Uu^Zok, Uu^Zok, Uu, Xos, Xos, Xos, Xos, Xos, Xos, Xos, Xos, Xos, Xos, Xos, Xos, Xos, Xos, Xos, Xos, Xos, Xos, Xos, Xos, Xos, Xos, Xos, Xos, Xos, Urb^Bzu, Urb^Zok, Rb^Zok, Xos^Zok, Xos^Zok, Xos, Xos, Xos, Xos, Xos, Xos, Xos, Xos, Xos, Xos, Xos, Xos, Xos, Xos, Xos, Xos, Xos
Xos, Xos, Xos, Xos, Xos, Iwr, Iwr, Iwr, Iwr, Iwr, Iwr, Xos, Xos, Xos, Xos, Xos, Xos, Xos, Xos, Xos, Xos, Xos, Xos, Xos, Xos, Xos^Zok, Xos^Zok, Xos^Zok, Xos, Xos, Xos, Xos, Xos, Xos, Xos, Xos, Xos, Xos, Xos, Xos, Xos, Xos, Xos, Xos, Xos, Xos, Xos, Xos, Xos, Xos, Xos, Xos, Xos, Xos^Zok, Xos^Zok, Xos^Zok, Xos, Xos, Xos, Xos, Xos, Xos, Xos, Xos, Xos, Xos, Xos, Xos, Xos, Xos, Xos, Xos, Xos, Xos, Xos
Xos, Xos, Xos, Xos, Xos, Xos, Xos, Iwr, Iwr, Iwr, Xos, Xos, Xos, Xos, Xos, Xos, Xos, Xos, Xos, Xos, Xos, Xos, Xos, Xos, Xos, Xos, Xos, Xos, Xos, Xos, Xos, Xos, Xos, Xos, Xos, Xos, Xos, Xos, Xos, Xos, Xos, Xos, Xos, Xos, Xos, Xos, Xos, Xos, Xos, Xos, Xos, Xos, Xos, Xos, Xos, Xos, Xos, Xos, Xos, Xos, Xos, Xos, Xos, Xos, Xos, Xos, Xos, Xos, Xos, Xos, Xos, Xos, Xos, Xos, Xos
Xos, Xos, Xos, Xos, Xos, Xos, Xos, Xos, Xos, Xos, Xos, Xos, Xos, Xos, Xos, Xos, Xos, Xos, Xos, Xos, Xos, Xos, Xos, Xos, Xos, Xos, Xos, Xos, Xos, Xos, Xos, Xos, Xos, Xos, Xos, Xos, Xos, Xos, Xos, Xos, Xos, Xos, Xos, Xos, Xos, Xos, Xos, Xos, Xos, Xos, Xos, Xos, Xos, Xos, Xos, Xos, Xos, Xos, Xos, Xos, Xos, Xos, Xos, Xos, Xos, Xos, Xos, Xos, Xos, Xos, Xos, Xos, Xos, Xos, Xos
Xos, Xos, Xos, Xos, Xos, Xos, Xos, Xos, Xos, Xos, Xos, Xos, Xos, Xos, Xos, Xos, Xos, Xos, Xos, Xos, Xos, Xos, Xos, Xos, Xos, Xos, Xos, Xos, Xos, Xos, Xos, Xos, Xos, Xos, Xos, Xos, Xos, Xos, Xos, Xos, Xos, Xos, Xos, Xos, Xos, Xos, Xos, Xos, Xos, Xos, Xos, Xos, Xos, Xos, Xos, Xos, Xos, Xos, Xos, Xos, Xos, Xos, Xos, Xos, Xos, Xos, Xos, Xos, Xos, Xos, Xos, Xos, Xos, Xos, Xos
