Xu, Xu, Xu, Xu, Xu, Xu, Xu, Xu, Xu, Xu, Xu, Xu, Xu, Xu, Xu, Xu, Xu, Xu, Xu, Xu, Xu, Xu, Xu, Xu, Xu, Xu, Wwg, Xu, Xu, Xu, Xos, Xos, Urb, Rr, Urb, Xos, Xos, Xos, Xos, Xos, Xos, Xos, Xos, Qxu, Qxu, Qxu, Qxu, Qxu, Xos, Xos, Xos, Xos, Xos, Xos, Xos, Xos, Xos, Xos, Xos, Xos, Xos, Qxu, Qxu, Qxu, Qxu, Qxu, Qxu, Qxu, Qxu, Qxu, Qxu, Qxu, Qxu, Qxu, Qxu
Xu, Xu, Xu, Xu, Xu, Xu, Xu, Xu, Xu, Xu, Xu, Xu, Xu, Xu, Xu, Xu, Xu, Xu, Xu, Xu, Xu, Xu, Xu, Xu, Xu, Xu, Xu, Wwg, Wwg, Xu, Xos, Xos, Urb, Rr, Urb, Xos, Xos, Xos, Xos, Xos, Xos, Xos, Xos, Qxu, Qxu, Qxu, Qxu^Xo, Qxu^Xo, Qxu, Xos^Xzm\, Xos^Xzm\, Xos, Xos, Xos, Xos, Xos, Xos^Xzm\, Xos, Xos, Xos, Xos, Xos, Xos, Qxu, Qxu, Qxu, Qxu^Xo, Qxu, Qxu, Qxu, Qxu, Qxu, Qxu, Qxu, Qxu
Xu, Xu, Xu, Xu, Xu, Xu, Xu, Xu, Xu, Xu, Wog, Wog, Xu, Xu, Xu, Xu, Xu, Xu, Xu, Xu, Xu, Xu, Xu, Xu, Xos, Xu, Xu, Xu, Xu, Wwg^Xo, Xos, Xos, Urb, Rr, Urb, Xos, Xos, Yhl, Yhl, Xos^Xzm\, Xos, Xos, Xos, Qxu, Qxu^Xo, Qxu^Xo, Qxu, Qxu, Xos, Uu, Ur^Pr/, Xos, Xol, Xos, Xos, Urb, Urb, Xos^Xzm\, Xu, Xu, Xu, Xos, Xos, Xos, Xos, Qxu^Xo, Qxu, Qxu^Xo, Qxu^Xo, Qxu, Qxu, Qxu, Qxu, Qxu, Qxu
Xu, Xu, Xu, Xu, Xu, Xu, Xu, Xu, Xu, Xu, Wwrg, Wog, Wog, Wog, Wwg, Xu, Xos, Xu, Xu, Xu, Xu, Xu, Xos, Xos, Xos, Xos, Xos, Xu, Xos, Wwg, Qxu, Qxu, Urb, Rr, Urb, Qxu, Qxu, Yhl, Yhr^Xp, Xos, Xos, Xos, Xos, Xos, Xos, Qxu, Uu, Xos, Xos^Xzm/, Xos, Ur^Em, Ur^Em, Uu, Xol, Xos, Xos, Xos^Efs, Urb, Urb, Xu, Xu, Xu, Xos, Xos, Xos^Xzm/, Xos, Yhr, Qxu, Qxu, Qxu^Xo, Qxu^Xo, Qxu, Qxu, Qxu, Qxu
Xu, Xu, Xu, Xu, Xu, Xu, Xu, Xu, Xu, Wwf, Wwf, Wwg, Wwg, Wwg, Uh, Xos, Xos, Xos, Xos, Xu, Xos, Xos, Xos, Xos, Xos, Xos, Xos, Xos^Xzm/, Qxu, Qxu, Qxu, Qxu, Urb, Rr, Urb, Qxu, Qxu, Qxu, Qxu, Xos, Xos, Xos, Xos, Xos, Xos, Xos, Xos, Urb^Pr/, Urb, Uu^Uf, Wwf, Wwf, Xos, Xos, Xos^Xzm/, Xos^Efs, Urb, Urb^Pr\, Xos, Xos, Xos, Xos, Xos^Efs, Xos, Xos, Yhr^Xp, Xos, Xos, Xos, Qxu, Qxu^Xo, Qxu, Qxu, Qxu, Qxu
Xu, Xu, Xu, Xu, Xu, Xu, Xu, Xu, Xu, Xu, Uu, Wwg, Uu, Wwf, Wwf, Xos, Xos, Xos, Xos, Xos, Xos, Xos, Xos, Xos, Xos, Xos, Xos, Yhl, Qxu, Qxu, Urb, Urb^Ebn, Rr, Rr, Rr, Urb^Ebn, Urb, Qxu, Qxu, Qxu, Yhr^Xp, Xos, Xos, Urb, Urb^Pr/, Xos^Xzm\, Urb, Urb, Urb, Ur^Em, Xos, Xos, Xos^Efs, Xos, Urb, Urb, Xos, Urb, Urb^Pr/, Xos, Xos^Efs, Xos^Efs, Uh, Uu^Uf, Uu^Uf, Yhr, Xos, Xos, Yhr^Xp, Qxu, Qxu, Qxu^Xo, Qxu, Qxu, Qxu
Xu, Xu, Xu, Xu, Xu, Xu, Xuc, Xu, Uu, Xuc, Uu, Uu, Urb^Ii, Wwf, Uu, Xos, Xos, Xos, Xu, Xos, Xos^Xzm/, Xos, Yhr, Xos, Xos^Xzm/, Xos, Yhr^Xp, Yhl, Qxu, Qxu, Urb, Rr, Rr, Rr, Rr, Rr, Urb, Qxu, Qxu, Qxu, Yhr, Xos, Xos, Xos, Xos, Urb, Urb, Urb, Xos, Xos, Xos^Xzm/, Xos^Efs, Urb, Urb, Urb^Pr/, Xos, Xos^Xzm\, Xos, Xos, Wwf, Ur, Xos^Efs, Xos, Yhr^Xp, Yhr, Yhr, Yhr, Yhr, Xos, Xos, Qxu, Qxu^Xo, Qxu, Qxu, Qxu
Xu, Xu, Xu, Xu, Wog, Xuc, Wwf, Xu, Uu, Uu, Cte, Uu, Urb, Urb^Ii, Uu, Uu, Uu, Xuc, Xu, Xos, Xos, Yhr, Xos, Xos, Xos, Yhl, Yhl, Yhr, Qxu, Qxu, Urb, Rr, Rr, 4 Rr, Rr, Rr, Urb, Qxu, Qxu, Qxu, Qxu, Xos, Xos, Xos, Xos, Urb, Urb, Xos, Xos^Efs, Xos, Urb, Urb, Xos, Xos, Xos, Urb, Xos, Xos, Xos, Ur, Xos, Ur^Pr/, Ur, Yhr, Yhr, Yhr, Yhr, Xos, Xos^Xzm/, Xos, Qxu, Qxu^Xo, Qxu, Qxu, Qxu
Xu, Xu, Xuc, Wog, Wwrg, Wwrg, Uu, Uu, Uu, Cte, 3 Kte, Cte, Uh, Urb, Uu, Uu^Eb, Uu, Xuc, Xu, Xos, Xos, Yhr, Xos, Xos, Xos, Yhl, Yhl^Xp, Yhr^Xp, Qxu, Qxu, Urb, Rr, Rr, Rr, Rr, Rr, Urb, Qxu, Xos, Xos, Xos, Qxu, Yhl, Xos, Xos, Uu^Em, Uu^Em, Urb, Urb, Uu, Urb, Urb, Urb, Xos, Xos^Efs, Xos, Xos, Xos, Xos^Efs, Urb, Xos, Xos, Xos, Yhr^Xp, Yhr, Yhr^Xp, Uu, Xos^Xzm/, Yhr^Xp, Yhr, Xos, Qxu^Xo, Qxu, Qxu, Qxu
Xu, Xu, Xuc, Wog, Wwg, Wwg, Uu, Urb^Ii, Uh, Cte, Cte, Cte, Uu^Uf, Uu^Vu, Uh, Uu, Uu, Xu, Xos, Xos, Xos, Yhr, Yhr^Pr/, Xos^Xzm\, Xos^Xzm\, Xos, Xos, Qxu, Qxu, Qxu, Urb, Urb, Urb, Rr, Urb, Urb, Xos^Efs, Xos, Xos, Xos, Xos, Xos, Xos, Yhl, Xos, Xos, Xos, Urb, Urb, Urb, Xos, Urb, Urb, Urb, Urb, Xos^Efs, Xos, Xos^Efs, Urb, Urb, Xos, Xos, Xos, Xos, Uh, Yhr^Xp, Uu, Uh, Xos, Xos, Xos, Xos, Xos, Qxu, Qxu
Xu, Xu, Xu, Xuc, Wwg, Wwf, Uu, Uu, Urb, Uu^Uf, Ur, Urb, Urb, Uu^Uf, Uu, Uh, Uh, Xos, Xos, Xos, Xos, Xos, Yhr, Yhr, Xos, Xos, Xos, Qxu, Qxu, Qxu, Xos, Urb, Urb, Rr, Rr^Zz/, Urb^Zz/, Urb, Xos^Efs, Xos, Xos, Xos, Xos, Xos, Xos, Xos^Efs, Xos^Efs, Urb, Urb, Urb, Xos, Xos, Xos, Xos, Urb, Urb, Urb, Urb, Urb, Xos, Xos, Xos, Xos, Xos, Xos, Uu^Ufi, Uu^Uf, Yhr^Xp, Xos, Xos, Xos, Xos, Xos, Xos, Xos, Xos
Xu, Xu, Xu, Xuc, Wwf, Uh, Uu, Uu^Uf, Uu^Vu, Uu^Uf, Uu^Uf, Urb, Urb, Uu, Uu^Eb, Uh, Uh, Xos, Xos^Efs, Xos^Xzm/, Urb, Yhr, Yhr, Yhr, Yhr, Xoc^Xzm\, Xoc, Xos, Xos, Xos, Xos, Xos, Xos, Urb^Zz/, Rr, Rr, Rr, Urb, Urb, Xos, Qxu, Qxu, Qxu, Xos, Urb, Urb^Pr\, Urb^Pr\, Urb, Xos, Xos, Xos, Xos, Xos, Uu^Em, Ur^Em, Xos, Xos, Urb, Urb^Pr/, Xos^Xzm/, Urb^Pr\, Urb, Xos, Xos, Uh, Uh, Yhr^Xp, Xos^Xzm/, Yhr, Xos, Xos, Xos, Xos, Xos, Xos
Xu, Xu, Xu, Xu, Xu, Uh, Uh, Uu, Uu^Uf, Urb, Uu, Uu, Urb, Urb, Urb, Urb, Xos, Xos^Efs, Urb, Urb, Urb^Ii, Urb, Xos, Yhr^Xp, Yhr^Vud, Yhr, Yhr, Xos^Xzm\, Xos, Xos, Xos, Xos, Urb, Urb, Rr, Rr, Rr^Ii, Rr, Rr, Urb, Urb, Qxu, Urb, Urb, Urb, Urb, Xos, Xos, Xos, Xos, Xos, Xos, Xos, Uu^Em, Urb^Em, Xos^Efs, Xos^Efs, Xos, Xos, Urb, Xos, Xos, Xos, Xos, Yhr, Yhr, Uu, Yhr, Xos, Xos, Xos, Xos, Xos, Xos, Xos
Xu, Xu, Xu, Xu, Xu, Xu, Uh, Uu^Uf, Uh, Urb, Urb, Uu^Uf, Urb, Urb, Urb^Zz/, Urb^Zz/, Urb, Urb, Urb, Urb, Xos, Xos, Xos, Xos, Xos, Yhr^Xp, Yhr, Xos^Xzm/, Yhr^Pr\, Yhr, Xos, Xos, Urb, Rr, Rr, Rr, Rr, Rr, Rr, Rr, Urb, Urb, Urb, Urb, Qxu, Qxu, Xos, Xos, Urb, Xos, Xos^Xzm\, Xos, Xos, Wwf, Urb, Urb, Urb, Xos^Xzm\, Urb^Pr\, Urb, Xos, Xos, Xos, Xos, Uu, Yhr^Xp, Uh, Xos, Xol, Xos, Xos, Xos, Xos, Xos, Xos
Xu, Xu, Xu, Xu, Xos, Xos, Xos, Uh, Uh, Uu^Vu, Uh, Urb, Xos, Urb^Zz/, Urb, Rr, Rr, Urb, Urb, Xos, Yhr, Yhr^Vud, Yhr^Xp, Xos^Xzm\, Xos, Xos, Yhr, Yhr^Xp, Xos, Xos, Xos, Xos, Urb, Rr, Rr, Rr, 2 Rr, Rr, Rr, Rr, Urb, Urb, Qxu, Qxu, Qxu, Qxu, Xos, Xos, Xos, Urb^Pr/, Urb, Xos^Xzm/, Urb, Urb, Xos, Urb, Urb, Urb, Xos, Xos, Xos, Xos, Xos^Xzm/, Xos, Uu^Ii, Uu^Vu, Uh, Xos^Efs, Xos^Efs, Xos, Xos, Xos, Xos, Xos, Xos
Xu, Xu, Xos, Xos, Xos, Xos, Xos, Xos, Xos, Uh, Xos, Xos, Xos, Urb, Urb, Urb, Rr, Urb, Urb^Ii, Urb, Urb, Yhr, Xos, Xos, Xos, Xos, Yhr^Pr\, Yhr, Xos, Xos, Xos, Urb, Urb^Ii, Rr, Rr, Rr, Rr, Rr, Rr, Rr, Urb, Qxu, Qxu, Qxu, Qxu, Qxu, Xos, Xos, Urb, Urb^Pr\, Xos, Urb, Xos, Xos, Xos, Urb, Urb, Urb, Urb^Pr/, Xos^Xzm\, Xos^Xzm\, Xos, Xos, Uu^Uf, Yhr^Xp, Yhr^Ii, Yhr, Uh, Xu, Xos, Xos, Xos, Xos, Xos, Xos
Xos, Xos, Xos^Efs, Xos^Efs, Yhr, Xos^Efs, Xos^Efs, Xos, Xos, Xos, Xoc, Xoc, Urb, Urb, Urb, Urb, Rr, Urb, Urb, Urb, Xos, Xos, Xos, Xos, Xos, Yhr, Xol, Xos, Xos, Xos, Urb^Ebme, Urb, Rr, Rr, Rr, Rr, Rr, Rr, Rr, Rr, Urb, Urb, Urb, Qxu, Qxu, Qxu, Xos, Xos, Xos, Xos, Xos, Xos, Xos, Xos, Xos, Urb, Wwf, Xos, Xos, Urb, Xos, Xos, Xos, Uh, Uu^Uf, Yhr, Yhr^Xp, Yhr, Xuc, Xu, Xu, Xos, Xos, Xos, Xos
Xos, Xos^Xzm/, Yhr, Yhr, Yhr^Ii, Yhr, Yhr^Uf, Xos, Xos^Xzm/, Xos, Yhr^Pr\, Urb, Uu^Vu, Urb, Urb, Rr, Rr, Urb, Urb, Urb, Urb, Xos^Xzm\, Xos, Xos, Xos^Efs, Xos, Xos, Xos, Urb^Ebme, Urb^Ebur, Rr, Rr, Urb, Urb, Urb^Ii, Rr, Rr, Rr, Urb, Urb, Qxu, Urb, Urb, Urb, Urb, Qxu, Xos^Efs, Xos, Xos, Xos, Xos, Xos, Xos^Efs, Xos^Efs, Urb, Urb, Urb, Xos, Xos, Xos, Xos, Xos, Xos, Uu, Uh, Uu^Ii, Uu, Uu^Uf, Xu, Xu, Xu, Xos, Xos, Xos, Xos
Xos, Xos, Yhr, Yhr^Ii, Yhr^Ii, Yhr^Ii, Yhr, Xos, Xos, Yhr, Xol, Xos, Urb, Urb, Urb, Rr, Urb, Urb, Urb, Uu^Vu, Urb, Urb, Xos, Xos^Efs, Urb, Urb, Urb, Urb^Ebur, Rr, Rr, Urb, Urb, Xos, Xos, Xos, Urb, Urb, Urb, Qxu, Qxu, Qxu, Qxu, Qxu, Urb, Urb, Urb, Urb, Xos^Efs, Xos, Xos, Xos, Xos^Xzm/, Urb, Urb, Urb, Urb, Urb, Xos, Xos^Xzm\, Xos, Urb, Xos, Xos, Xos, Xos, Uu^Uf, Xu, Xu, Xu, Xu, Xu, Xos, Xos, Xos, Xos
Xos, Xos, Yhr, Yhr^Ii, Yhr^Ii, Yhr^Ii, Yhr, Xos, Xos, Xos, Xos, Xos, Xos, Urb, Urb, Rr, Urb^Zz/, Xos, Xos, Urb, Xos, Xos, Xos, Xos, Urb, Urb, Rr, Rr, Urb, Urb, Xos, Xos, Xos, Xos, Xos, Xos, Xos, Qxu, Qxu, Qxu, Qxu, Qxu, Qxu, Qxu, Xos, Urb, Urb^Pr/, Urb^Pr/, Urb, Xos^Efs, Xos^Efs, Xos, Urb, Urb, Xos, Xos, Xos, Urb^Pr/, Urb, Urb, Qxu, Xu, Xu, Xos, Xu, Xu, Xu, Xu, Xu, Xu, Xu, Xos, Xos, Xos, Xos
Xos, Xos, Xos, Yhr, Yhr, Yhr, Xos, Xos, Xos, Xos, Xos, Xos, Xos, Xos, Urb^Zz/, Rr^Zz/, Urb, Xos, Xoc, Xos, Xos^Efs, Xos^Efs, Urb, Urb, Rr, Rr, Urb, Urb, Xos, Xos, Xos, Xos, Xos, Xos, Xos, Xos, Xos, Xos, Xos, Qxu, Qxu, Qxu, Xos, Xos, Xos, Xos, Xos, Urb, Urb, Urb, Urb, Xos, Urb, Urb, Xos, Xos, Xos, Xos, Urb, Qxu, Qxu, Qxu, Qxu, Xu, Xuc, Xuc, Xu, Xu, Xu, Xu, Xu, Xos, Xos, Xos, Xos
Xos, Xos, Xos, Cud, 5 Kud, Cud, Xos, Xos, Xos, Xos, Xos, Xos, Xoc, Xoc, Urb, Rr, Rr, Urb, Urb, Xoc, Urb^Zz\, Urb, Rr, Rr, Urb, Urb, Xos, Xos, Xos^Efs, Xos^Efs, Urb^Pr\, Urb, Urb, Xos, Xos, Xos, Xos, Xos, Xos, Xos, Xos, Xos, Xos, Xos, Xos, Xos, Xos, Xos, Xos, Urb, Urb, Urb, Urb, Urb, Xos, Xos, Xos, Xos, Urb, Qxu, Qxu, Qxu, Qxu, Xu, Uu^Uf, Uu^Emf, Uh, Xuc, Xuc, Xu, Xu, Xos, Xos, Xos, Xos
Xos, Xos, Xos, Cud, Rr, Cud, Xoc, Xos, Xoc, Xoc, Urb, Xos, Urb, Urb, Urb, Urb, Urb, Rr, Urb, Urb, Urb, Rr^Zz\, Urb^Zz\, Urb, Xos, Xos, Xos, Xos^Efs, Urb^Pr\, Urb, Urb, Urb^Pr\, Xos, Xos, Xos, Xos, Xos, Xos, Xos, Xos, Xos, Xos, Xos, Xos, Xos, Xos, Xos, Xos, Xos, Xos, Xos, Urb, Xos, Xos, Xos, Xos, Xos, Xos, Xu, Xu, Xu, Qxu, Qxu, Qxu, Uu^Ii, Uu^Uf, Uu, Uh, Xuc, Xu, Xos, Xos, Xos, Xos, Xos
Xos, Xos, Xos, Urb, Rr, Urb, Urb, Xoc, Urb, Urb, Rr, Urb, Rr, Urb, Rr, Urb, Rr, Rr, Rr, Urb, Rr, Rr, Urb, Urb^Zz\, Xos, Xos, Xos, Urb, Urb, Urb^Pr\, Xos, Urb, Urb^Pr/, Xos, Urb, Xos^Efs, Xos^Efs, Xos, Xu, Xos, Xos, Xos, Xos, Xos, Xos, Xos, Xos, Xos, Xos, Xos, Xos, Xos, Xos, Xos, Xos, Xos, Xos, Xu, Xu, Xu, Qxu, Qxu, Qxu, Uu, Uu, Ur^Em, Uu^Uf, Uh, Xos, Xos, Xos, Xos, Xos, Xos, Xos
Xos, Xos, Xos, Urb, Urb, Rr, Rr, Urb, Rr, Rr, Urb, Rr, Urb, Rr, Urb, Rr, Urb, Urb, Urb, Rr, Rr, Urb, Urb, Xos, Xos, Xos, Xos, Xos, Xos, Xos, Xos, Xos, Urb, Rr, Rr, Urb, Urb, Xu, Xu, Xu, Xos, Xos, Xos, Xos, Xos^Efs, Xos, Xoc^Efs, Xos, Xos, Xos, Xos, Urb, Xos, Xos, Xos, Xos, Xos, Xu, Xu, Xu, Xu, Qxu, Xu, Xu, Uu, Ur, Uu^Eb, Xos, Xos, Xos, Xos, Xos, Xos, Xos, Xos
Qxu, Xos, Xos, Xos, Urb, Rr, Rr, Rr, Urb, Urb, Xos, Urb, Xos, Urb, Xos, Urb, Qxu, Qxu, Qxu, Urb, Urb, Rr, Urb, Xos, Xos, Xos, Xos, Xos, Xos, Xos, Xos, Urb, Urb, Urb, Rr, Rr, Urb, Xu, Xu, Xu, Xos, Xos, Xoc, Xos^Efs, Iwr, Cud, Iwr, Xoc^Efs, Xos, Xos, Urb, Urb, Xos, Xos, Xos, Xos, Xos, Xos, Xos, Xu, Xu, Xu, Xuc, Xu, Ur, Uu, Uu, Xos, Xos, Xos, Xos, Xos, Xos, Xos, Xos
Qxu, Qxu, Qxu^Xo, Xos, Urb, Rr, Urb, Urb, Xos, Xos, Xos, Xos, Xos, Xos, Xos, Xos, Xos, Qxu, Qxu, Urb, Urb, Rr, Urb, Yhr^Ii, Yhr^Xp, Xos^Xzm\, Xos, Xos, Xos, Xos, Xos, Urb, Rr, Rr, Urb, Urb, Xos, Xos, Xos, Xos, Xoc^Efs, Xoc, Iwr, Cud, Iwr, Ior, Iwr, Cud, Iwr, Xoc, Xoc^Efs, Xos, Xos, Urb, Urb, Xos, Xos, Xos, Xos, Xos, Xos, Xuc, Uu^Uf, Uh, Uu, Uu^Ii, Xos, Xos, Xos, Xos, Xos, Xos, Xos, Xos, Xos
Qxu, Qxu, Qxu^Xo, Qxu, Urb, Rr, Urb, Xos, Xos, Xos, Xos, Xos, Xos, Xos, Xos, Xos, Xoc, Xoc, Urb, Urb, Rr, Rr, Urb, Yhr^Ii, Yhr, Xu, Xu, Xu, Xu, Xu, Xu, Urb, Rr, Urb, Xos, Xos, Xos, Xos, Xos, Xoc^Efs, Iwr, Cud, Iwr, Ior, Wog, Wog, Wog, Iwr, Iwr, Cud, Iwr, Xoc^Efs, Xoc, Xos, Xos, Urb, Urb, Xu, Xu, Xu, Xu, Uu, Ur, Ur^Em, Uu, Xos, Xos, Xos, Xos, Xos, Xos, Xos, Xos, Xos, Xos
Qxu, Qxu, Qxu^Xo, Qxu, Urb, Rr, Urb, Xos, Xos, Xos, Xos, Xos, Xos, Xos, Xos, Xos, Urb, Urb, Rr, Rr, Urb, Urb, Urb, Yhr, Yhr^Xp, Xu, Xu, Xu, Xu, Xu, Xu, Urb, Rr, Urb, Xos^Efs, Xos, Xos, Xos, Xos, Cud, Ior, Iwr, Wog, Wog, Wog, Wog, Wog, Wog, Ior, Iwr, Iwr, Cud, Xos, Xos, Xos, Xos, Xu, Xu, Xu, Xu, Xuc, Uu^Ii, Uu, Uu^Em, Xu, Xos, Xos, Xos, Xos, Xos, Xos, Xos, Xos, Xos, Xos
Qxu, Qxu, Qxu^Xo, Qxu, Urb, Rr, Urb, Xoc^Efs, Xoc^Efs, Xos, Xos, Xos, Xos, Xos, Xos, Xos, Urb, Rr, Urb, Urb, Xos, Xos, Xos, Yhr^Ii, Yhr, Xu, Xu, Xu, Xos, Xos, Xos, Urb, Rr, Urb, Urb, Xoc^Efs, Xoc, Xos, Xos^Efs, Xos^Efs, Iwr, Iwr, Iwr, Wog, Wog, Wog, Iwr, Iwr, Iwr, Cud, Xos, Xos, Xos, Xos, Xos, Xu, Xu, Xu, Urb, Xuc, Uu^Uf, Uu, Uu^Uf, Xuc, Xuc, Xu, Xu, Xos, Xos, Xos, Xos, Xos, Xos, Xos, Xos
Qxu, Qxu, Qxu^Xo, Qxu, Urb, Rr, Urb, Urb, Urb, Xoc, Xos, Xos, Xoc, Xoc, Qxu, Qxu, Urb, Rr, Urb, Xos, Xos, Xos, Xos, Xos, Xos, Xu, Xos, Xos, Xos, Xos, Xos, Urb, Rr, Rr, Rr, Urb, Urb, Xos, Urb, Cud, Cud, Iwr, Ior, Iwr, Iwr, Iwr, Iwr, Cud, Xos, Xos, Xos, Xos, Xos, Xos, Xu, Xu, Xu, Xu, Uh, Uh, Uu^Uf, Ur, Uu, Uu, Wwg, Xu, Xuc, Xu, Xu, Xos, Xos, Xos, Xos, Xos, Xos
Qxu, Qxu, Qxu^Xo, Qxu, Urb, Rr, Rr, Urb, Urb, Urb, Urb, Xos^Efs, Urb, Qxu, Qxu, Qxu, Urb, Rr, Urb, Xoc^Efs, Xoc^Efs, Xos, Xos, Xos, Xos, Xos, Xos, Xos, Xoc^Efs, Xoc^Efs, Urb^Ebme, Urb, Rr, Rr, Rr, Rr, Rr, Urb, Rr, Rr, Urb, Cud, Xos, Xos, Xos, Cud, Xos, Xos, Xos, Xos, Xos, Xos, Xos, Xos, Xu, Xu, Xu, Xu, Xuc, Uu^Uf, Uu, Ur^Ii, Uu, Uh, Xuc, Wwg, Wog, Xuc, Xu, Xos, Xos, Xos, Xos, Xos, Xos
Qxu, Qxu, Xos, Xos, Xos, Urb, Urb, Rr, Rr, Urb, Urb, Urb, Urb, Urb, Urb, Urb, Urb, Rr, Urb, Urb, Urb, Xoc, Xoc^Efs, Xos, Xos, Xos, Xos^Efs, Xoc, Urb, Urb, Rr, Rr, Urb, Urb, Urb, Rr, Rr, Rr, Rr, Urb, Urb, Xos^Efs, Xos^Efs, Xos, Xol, Xos, Xos, Xos, Xos, Xos, Xos, Xos, Xos, Xos, Xos, Xu, Xu, Xu, Xu, Uu^Em, Uu, Uu, Uu^Uf, Xuc, Xu, Wog, Wog, Xu, Xu, Xos, Xos, Xos, Xos, Xos, Xos
Xos, Xos, Xos, Xoc, Xoc, Xos, Xoc, Urb, Urb, Rr, Rr, Urb, Rr, Rr, Rr, Rr, Rr, Rr, Rr, Urb, Urb, Urb, Urb, Xoc^Efs, Xoc, Xoc^Efs, Urb, Urb^Ebur, Rr, Rr, Urb, Urb, Xos, Xos, Xos, Urb, Urb, Rr, Rr, Rr, Rr, Urb, Urb, Xos, Xos^Efs, Xol, Xoc, Xos, Xos, Xos, Xos, Xos, Xos, Xos, Xos, Xu, Xu, Xu, Qxu^Xo, Qxu, Qxu, Xuc, Xuc, Xuc, Xu, Xu, Xu, Wog^Xo, Wog, Xos, Xos, Xos, Xos, Xos, Xos
Xos, Xos, Xoc, Xoc, Iwr, Xoc, Xoc, Urb, Rr, Rr, Rr, Rr, Rr, Rr, Rr, Rr^Ii, Rr, Rr, Rr, Rr, Rr, Urb, Urb, Urb, Urb, Urb^Pr\, Rr^Pr\, Rr, Urb, Urb, Xos, Xos, Xos, Xos, Xos, Xos, Xos, Urb, Urb, Rr, Rr, Rr, Rr, Urb^Eb, Urb, Xos^Efs, Xoc, Xoc, Xoc^Efs, Xos, Xos, Xos, Xos, Xos, Xos, Xu, Xu, Qxu, Qxu, Qxu^Xo, Qxu^Xo, Xu, Xu, Xu, Xu, Xu, Xu, Xu, Xos, Wog, Wog, Xos, Xos, Xos, Xos
Xos, Xos, Xoc, Iwr, Ior, Ior, Cud, Urb, Rr, Rr, Rr^Ii, Rr, Rr, Rr, Rr, Rr, Rr, Rr, Rr, Rr, Rr, Rr^Ii, Urb, Urb, Rr, Rr, Urb, Urb^Pr\, Xoc, Xos, Xos, Xos, Xos, Xos, Xos, Xos, Xos, Xos, Xos, Urb, Urb^Eb, Rr, Rr, Rr, Rr^Pr/, Xoc^Efs, Urb, Urb, Urb^Eb, Xoc^Efs, Xos, Xos, Xos, Xos, Xos, Xu, Xu, Xu, Xu, Qxu, Qxu, Xu, Xu, Xu, Xos, Xos, Xos, Xos, Xos, Xos, Xos, Wog, Xos, Xos, Xos
Xos, Xos, Xoc, Iwr, Ior, Ior, Xoc, Urb, Rr, Rr, Rr, Rr, Rr, Rr, Rr, Rr, Rr, Rr, Rr, Rr, Rr, Rr, Rr, Rr, Urb, Urb, Urb, Xoc, Xos, Xos, Xos, Xos, Xu, Xos, Xos, Xos, Xos, Xos, Xos, Xos, Xos, Urb, Xos^Efs, Rr^Pr/, Rr, Rr, Rr^Cov, Urb^Cov, Urb^Cov, Urb, Urb^Eb, Xoc^Efs, Xoc^Efs, Xos, Xos, Xos, Xos, Xu, Xu, Xu, Xu, Xu, Xu, Xos, Xos, Xos, Xos, Xos, Xos, Xos, Xos, Xos, Xos, Xos, Xos
Xos, Xos, Xoc, Xoc, Xoc, Xoc, Xoc, Urb, Rr, Rr, Rr, Rr, Rr, Rr, Rr, Rr, Rr, Rr, Rr, Rr, Rr, Rr, Urb, Urb^Ii, Urb, Urb, Xu, Xoc, Xos, Xos, Xos, Xu, Xuc, Xu, Xu, Xos, Xos, Xos, Xos, Xos, Xos, Xos^Efs, Urb, Urb, Urb, Rr^Cov, Rr^Cov, 1 Rr^Kov, Rr^Cov, Urb^Cov, Urb, Urb, Urb^Eb, Xoc, Xos^Efs, Xos, Xos, Xos, Xos, Xu, Xu, Xu, Xos, Xos, Xos, Xos, Xos, Xos, Xos, Xos, Xos, Xos, Xos, Xos, Xos
Xos, Xos, Xos, Xos, Xoc, Xos, Xoc, Urb, Rr, Rr, Rr, Rr, Rr, Rr, Rr, Rr^Ii, Rr, Rr, Rr, Rr, Rr, Rr, Urb, Urb, Urb, Urb, Xu, Xu, Xu, Xos, Uu, Uu^Uf, Wwf, Xuc, Xu, Xu, Xos, Xos, Xos, Xos, Xos, Xos, Xos, Urb^Eb, Urb, Urb, Urb, Rr^Cov, Rr, Rr, Rr, Urb, Urb, Urb, Urb^Eb, Xos^Efs, Xoc, Xos, Xos, Xos, Xos, Xos, Xos, Xos, Xos, Xos, Xos, Xos, Xos, Xos, Xos, Xos, Xos, Xos, Xos
Xos, Xos, Xoc, Xoc, Iwr, Xoc, Xoc, Urb, Urb, Rr, Rr, Rr, Rr, Rr, Rr, Rr, Rr, Rr, Rr, Rr, Rr, Urb^Ii, Urb, Urb, Xu, Urb, Cud, Xu, Uu, Uu, Xu, Uu, Uh, Wwrg, Xu, Xu, Xos, Xos, Xos, Xos, Xos, Xos, Xos, Xos, Xos, Urb^Eb, Urb, Urb, Urb, Rr, Rr, Rr, Rr, Urb, Urb, Urb, Urb^Eb, Xoc^Efs, Xos^Efs, Xos, Xos, Xos, Xos, Xos, Xos, Xos, Xos, Xos, Xos, Xos, Xos, Xos, Xos, Xos, Xos
Xos, Xos, Xoc, Iwr, Ior, Iwr, Cud, Urb, Urb, Rr^Ii, Rr, Rr, Rr, Rr, Rr, Rr, Rr, Rr, Rr, Rr, Urb, Urb, Xu, Xu, Xu, Xu, Xu, Urb, Ur^Br/, Ur^Br/, Uu, Uu, Xuc, Xu, Xu, Xu, Xos, Xos, Xos, Xos, Xos, Xos, Xos, Xos, Xos, Xos, Xos, Urb^Eb, Urb, Urb, Urb, Rr, Rr, Rr, Rr, Urb, Urb, Urb, Urb^Eb, Xos, Xos^Zok, Xos, Xos, Xos, Xos, Xos, Xos, Xos, Xos, Xos, Xos, Xos, Xos, Xos, Xos
Xos, Xos, Xoc, Iwr, Ior, Iwr, Xoc, Xoc, Xoc, Urb, Urb, Rr, Rr, Rr, Rr, Rr, Rr^Ii, Rr, Urb, Urb, Xoc, Xu, Xu, Xu, Xu, Xuc, Uu, Uu, Uu^Br|, Uu, Uh, Uh, Xuc, Xu, Xu, Xos, Xos, Xos, Xos, Xos, Xos, Xos, Xos, Xos, Xos, Xos, Xos, Xos, Xos, Urb^Eb, Urb, Urb, Urb, Rr, Rr, Rr, Rr, Urb, Rb^Zok, Urb^Zok, Xos^Zok, Xos^Zok, Xos, Xos, Xos, Xos, Xos, Xos, Xos, Xos, Xos, Xos, Xos, Xos, Xos
Xos, Xos, Xos, Xoc, Iwr, Xoc, Ior, Xoc, Xoc, Xoc, Xoc, Urb, Urb, Urb, Urb, Urb, Urb, Urb, Xoc, Xoc, Xos, Xu, Xu^Zok, Xu^Zok, Uu^Zok, Uu, Uu^Br/, Ur^Br/, Uu, Uu^Uf, Xos, Xu, Xu, Xu, Xos, Xos, Xos, Xos, Xos, Xos, Xos, Xos, Xos, Xos, Xos, Xos, Xos, Xos, Xos, Xos, Xos, Urb^Eb, Urb, Urb, Urb, Rr, Rr^Zok, Rr^Zok, Xos^Zok, Xos^Zok, Xos, Xos, Xos, Xos, Xos, Xos, Xos, Xos, Xos, Xos, Xos, Xos, Xos, Xos, Xos
Xos, Xos, Xos, Xoc, Xoc, Ior, Ior, Iwr, Ior, Xoc, Xoc, Xoc, Xoc, Xoc, Xoc, Xoc, Xoc, Xoc, Xos, Xos, Xos, Xos, Xos, Xos^Zok, Xos^Zok, Uu^Zok, Uu^Zok, Uu, Xos, Xos, Xos, Xos, Xos, Xos, Xos, Xos, Xos, Xos, Xos, Xos, Xos, Xos, Xos, Xos, Xos, Xos, Xos, Xos, Xos, Xos, Xos, Xos, Xos, Urb^Eb, Urb^Zok, Rb^Zok, Xos^Zok, Xos^Zok, Xos, Xos, Xos, Xos, Xos, Xos, Xos, Xos, Xos, Xos, Xos, Xos, Xos, Xos, Xos, Xos, Xos
Xos, Xos, Xos, Xos, Xoc, Ior, Iwr, Iwr, Ior, Iwr, Iwr, Xoc, Xos, Xos, Xos, Xos, Xos, Xos, Xos, Xos, Xos, Xos, Xos, Xos, Xos, Xos^Zok, Xos^Zok, Xos^Zok, Xos, Xos, Xos, Xos, Xos, Xos, Xos, Xos, Xos, Xos, Xos, Xos, Xos, Xos, Xos, Xos, Xos, Xos, Xos, Xos, Xos, Xos, Xos, Xos, Xos, Xos^Zok, Xos^Zok, Xos^Zok, Xos, Xos, Xos, Xos, Xos, Xos, Xos, Xos, Xos, Xos, Xos, Xos, Xos, Xos, Xos, Xos, Xos, Xos, Xos
Xos, Xos, Xos, Xos, Xos, Xoc, Xoc, Ior, Iwr, Ior, Xoc, Xoc, Xos, Xos, Xos, Xos, Xos, Xos, Xos, Xos, Xos, Xos, Xos, Xos, Xos, Xos, Xos, Xos, Xos, Xos, Xos, Xos, Xos, Xos, Xos, Xos, Xos, Xos, Xos, Xos, Xos, Xos, Xos, Xos, Xos, Xos, Xos, Xos, Xos, Xos, Xos, Xos, Xos, Xos, Xos, Xos, Xos, Xos, Xos, Xos, Xos, Xos, Xos, Xos, Xos, Xos, Xos, Xos, Xos, Xos, Xos, Xos, Xos, Xos, Xos
Xos, Xos, Xos, Xos, Xos, Xos, Xos, Xoc, Xoc, Xoc, Xos, Xos, Xos, Xos, Xos, Xos, Xos, Xos, Xos, Xos, Xos, Xos, Xos, Xos, Xos, Xos, Xos, Xos, Xos, Xos, Xos, Xos, Xos, Xos, Xos, Xos, Xos, Xos, Xos, Xos, Xos, Xos, Xos, Xos, Xos, Xos, Xos, Xos, Xos, Xos, Xos, Xos, Xos, Xos, Xos, Xos, Xos, Xos, Xos, Xos, Xos, Xos, Xos, Xos, Xos, Xos, Xos, Xos, Xos, Xos, Xos, Xos, Xos, Xos, Xos
Xos, Xos, Xos, Xos, Xos, Xos, Xos, Xos, Xos, Xos, Xos, Xos, Xos, Xos, Xos, Xos, Xos, Xos, Xos, Xos, Xos, Xos, Xos, Xos, Xos, Xos, Xos, Xos, Xos, Xos, Xos, Xos, Xos, Xos, Xos, Xos, Xos, Xos, Xos, Xos, Xos, Xos, Xos, Xos, Xos, Xos, Xos, Xos, Xos, Xos, Xos, Xos, Xos, Xos, Xos, Xos, Xos, Xos, Xos, Xos, Xos, Xos, Xos, Xos, Xos, Xos, Xos, Xos, Xos, Xos, Xos, Xos, Xos, Xos, Xos
