border_size=1
usage=map

Xos         , Xos         , Xos         , Xos         , Xos         , Xos         , Xos         , Xos         , Xos         , Xos         , Xos         , Xos         , Xos         , Xos         , Xos         , Xos         , Qxv         , Qxv         , Xos         , Xos         , Qxv         , Qxv         , Qxv         , Qxv         , Qxv         , Qxv         , Qxv         , Qxv         , Qxv         , Qxv         , Yl          , Ryd         , Ryd         , Qxv         , Qxv         , Qxv         , Qxv         , Qxv         , Qxv         , Qxv         , Qxv         , Qxv         
Xos         , Xos         , Qxv         , Qxv         , Xos         , Qxv         , Qxv         , Qxv         , Xos         , Xos         , Qxv         , Xos         , Xos         , Qxv         , Qxv         , Xos         , Xos         , Xos         , Qxv         , Qxv         , Xos         , Qxv         , Qxv         , Qxv         , Uu^Ii       , Qxv         , Qxv         , Uu^Ii       , Qxv         , Qxv         , Yl          , Ryd         , Yl          , Qxv         , Qxv         , Uu^Ii       , Qxv         , Qxv         , Uu^Ii       , Qxv         , Qxv         , Qxv         
Xos         , Qxv         , Xos         , Xos         , Qxv         , Xos         , Xos         , Xos         , Qxv         , Qxv         , Xos         , Xos         , Qxv         , Xos         , Xos         , Qxv         , Xos         , Xos         , Xos         , Xos         , Qxv         , Qxv         , Xos         , Qxv         , Qxv         , Qxv         , Uu^Ii       , Qxv         , Uu^Ii       , Qxv         , Ryd         , Ryd         , Yl          , Qxv         , Uu^Ii       , Qxv         , Uu^Ii       , Qxv         , Qxv         , Qxv         , Qxv         , Qxv         
Xos         , Xos         , Qxv         , Qxv         , Xos         , Xos         , Qxv         , Xos         , Xos         , Xos         , Qxv         , Qxv         , Xos         , Xos         , Qxv         , Xos         , Xos         , Qxv         , Qxv         , Xos         , Xos         , Xos         , Qxv         , Qxv         , Xos         , Qxv         , Qxv         , Qxv         , Qxv         , Qxv         , Yl          , Ryd         , Ryd         , Qxv         , Qxv         , Qxv         , Qxv         , Qxv         , Qxv         , Qxv         , Xu          , Qxv         
Xos         , Xos         , Xos         , Xos         , Qxv         , Xos         , Xos         , Qxv         , Qxv         , Xos         , Xos         , Xos         , Qxv         , Qxv         , Xos         , Xos         , Qxv         , Xos         , Xos         , Qxv         , Xos         , Xos         , Xos         , Xos         , Qxv         , Qxv         , Xos         , Qxv         , Qxv         , Qxv         , Yl          , Ryd         , Yl          , Qxv         , Qxv         , Qxv         , Qxv         , Qxv         , Xu          , Qxv         , Qxv         , Xu          
Xos         , Xos         , Qxv         , Xos         , Xos         , Qxv         , Qxv         , Xos         , Xos         , Xos         , Qxv         , Xos         , Xos         , Xos         , Qxv         , Qxv         , Xos         , Xos         , Qxv         , Xos         , Xos         , Qxv         , Xos         , Xos         , Xos         , Xos         , Xos         , Xos         , Xos         , Qxv         , Xg^Zsw      , Ryd         , Yl          , Qxv         , Qxv         , Qxv         , Xu          , Qxv         , Qxv         , Xu          , Xu          , Xu          
Xos         , Xos         , Xos         , Qxv         , Qxv         , Xos         , Xos         , Xos         , Qxv         , Qxv         , Xos         , Xos         , Xos         , Xos         , Xos         , Xos         , Qxv         , Qxv         , Xos         , Xos         , Qxv         , Qxv         , Xos         , Xos         , Qxv         , Qxv         , Qxv         , Qxv         , Qxv         , Xos         , Yl          , Xg^Zsw      , Xg^Zsw      , Qxv         , Xu          , Qxv         , Qxv         , Xu          , Xu          , Xu          , Xu          , Xu          
Xos         , Xos         , Qxv         , Xos         , Xos         , Xos         , Qxv         , Xos         , Xos         , Xos         , Xos         , Qxv         , Qxv         , Xos         , Xos         , Xos         , Xos         , Xos         , Xos         , Xos         , Xos         , Xos         , Xos         , Qxv         , Qxv         , Qxv         , Qxv         , Qxv         , Ryd         , Yl          , Ryd         , Ryd         , Yl          , Xu          , Xu          , Xu          , Xu          , Xu          , Xu          , Xu          , Qxv         , Qxv         
Xos         , Xos         , Qxv         , Xos         , Qxv         , Qxv         , Xos         , Xos         , Qxv         , Xos         , Qxv         , Qxv         , Qxv         , Xos         , Qxv         , Xos         , Qxv         , Qxv         , Qxv         , Qxv         , Qxv         , Qxv         , Qxv         , Xos         , Xos         , Qxv         , Qxv         , Yl          , Ryd         , Ryd         , Yl          , Ryd         , Xg^Zse      , Xg^Zse      , Yl          , Xu          , Xu          , Xu          , Qxv         , Qxv         , Qxv         , Qxv         
Xos         , Xos         , Qxv         , Xos         , Xos         , Xos         , Ryd         , Ryd         , Xg^Zse      , Xos         , Ryd         , Ryd         , Ryd         , Xos         , Qxv         , Xos         , Xos         , Qxv         , Qxv         , Qxv         , Qxv         , Qxv         , Uu^Ii       , Xos         , Xos         , Qxv         , Xos         , Qxv         , Xos         , Yl          , Xg^Zse      , Xg^Zse      , Ryd         , Yl          , Xz          , Xu          , Xu          , Qxv         , Qxv         , Qxv         , Qxv         , Qxv         
Xos         , Xos         , Xos         , Xos         , Xos         , Uu^Ii       , Qxv         , Xos         , Xos         , Ryd         , Ryd         , Xos         , Xos         , Uu^Ii       , Xos         , Xos         , Uu^Ii       , Xos         , Qxv         , Uu^Ii       , Ryd         , Ryd         , Xos         , Xos         , Xos         , Xos         , Uu^Ii       , Xos         , Xos         , Xos         , Xos         , Yl          , Xz          , Xz          , Yl          , Xu          , Xu          , Qxv         , Qxv         , Qxv         , Qxv         , Qxv         
Xos         , Xos         , Qxv         , Qxv         , Xos         , Qxv         , Xos         , Xos         , Ryd         , Xg^Zsw      , Xos         , Ryd         , Xg^Zse      , Xos         , Ryd         , Ryd         , Xg^Zse      , Xos         , Ryd         , Ryd         , Ryd         , Xos         , Xos         , Uu^Ii       , Ryd         , Xg^Zsw      , Xos         , Xos         , Xos         , Xos         , Xos         , Xz          , Yr          , Yl          , Rr          , Yrh         , Yr          , Uu^Vu       , Qxv         , Qxv         , Qxv         , Qxv         
Xos         , Qxv         , Xos         , Xos         , Qxv         , Xos         , Xos         , Uu^Ii       , Xos         , Xos         , Yrh         , Xos         , Xos         , Yr          , Ryd         , Xos         , Qxv         , Ryd         , Xos         , Xos         , Xos         , Ryd         , Ryd         , Ryd         , Xos         , Xg^Zse      , Ryd         , Xos         , Xos         , Xos         , Uu^Vu       , Yr          , Yl          , Ryd         , Ryd         , Yr          , Rr          , Ryd         , Yr          , Qxv         , Qxv         , Qxv         
Xos         , Xos         , Xos         , Xos         , Xos         , Qxv         , Qxv         , Xos         , Qxv         , Qxv         , Qxv         , Yr          , Ryd         , Ryd         , Ryd         , Xos         , Xos         , Xos         , Ryd         , Uu^Ii       , Xos         , Uu^Ii       , Xos         , Xos         , Xg^Zsw      , Ryd         , Xg^Zse      , Xos         , Xos         , Xos         , Yl          , Yrh         , Rr          , Rr          , Rr          , Yr          , Yl          , Ryd         , Rr          , Yl          , Qxv         , Qxv         
Xos         , Xos         , Yr          , Yr          , Yrh         , Xos         , Xos         , Qxv         , Xos         , Xos         , Xos         , Yr          , Ryd         , Rr          , Rr          , Ryd         , Ryd         , Ryd         , Xos         , Xg^Zse      , Uu^Ii       , Xos         , Xos         , Uu^Ii       , Xos         , Xos         , Xos         , Uu^Ii       , Xos         , Yr          , Rr          , Rr          , Rr          , Rr          , Rr          , Rr          , Rr          , Yr          , Yrh         , Yl          , Qxv         , Qxv         
Xos         , Yrh         , Rr          , Uu^Ii       , Yrh         , Qxv         , Qxv         , Xos         , Xos         , Uu^Ii       , Xg^Zse      , Xos         , Ryd         , Rr          , Rr          , Ryd         , Xos         , Xg^Zse      , Ryd         , Xos         , Xos         , Xos         , Xos         , Xos         , Ryd         , Yr          , Ryd         , Xos         , Yl          , Yr          , Rr          , Rr          , Rr          , Rr          , Rr          , Rr          , Rr          , Yr          , Ryd         , Rr          , Qxv         , Qxv         
Xos         , Yr          , Rr          , Yr          , Yr          , Qxv         , Qxv         , Qxv         , Xos         , Xos         , Ryd         , Ryd         , Xos         , Ryd         , Rr          , Ryd         , Ryd         , Xos         , Xos         , Uu^Ii       , Xos         , Xos         , Yrh         , Yr          , Ryd         , Ryd         , Ryd         , Ryd         , Ryd         , Yr          , Yrh         , Rr          , Rr          , Rr          , Rr          , Rr          , Ryd         , Yr          , Ryd         , Yr          , Qxv         , Qxv         
Xos         , Yr          , Rr          , Yrh         , Qxv         , Qxv         , Xos         , Xos         , Xg^Zsw      , Ryd         , Xg^Zse      , Xos         , Xos         , Ryd         , Ryd         , Rr          , Ryd         , Xos         , Xos         , Xos         , Qxv         , Qxv         , Yr          , Yr          , Qxv         , Qxv         , Xos         , Uu^Vu       , Xos         , Xos         , Yl          , Yr          , Yr          , Yl          , Yl          , Ryd         , Yrh         , Yl          , Ryd         , Rr          , Qxv         , Qxv         
Qxv         , Qxv         , Rr          , Qxv         , Qxv         , Qxv         , Xos         , Uu^Ii       , Xos         , Xos         , Xos         , Uu^Ii       , Xos         , Xos         , Xz          , Xz          , Xz          , Xos         , Xos         , Xos         , Ryd         , Yr          , Yr          , Yr          , Qxv         , Qxv         , Xos         , Xos         , Ryd         , Xos         , Xos         , Rr          , Yr          , Rr          , Ryd         , Rr          , Yr          , Rr          , Qxv         , Qxv         , Qxv         , Qxv         
Qxv         , Qxv         , Rr          , Qxv         , Qxv         , Qxv         , Qxv         , Xos         , Qxv         , Qxv         , Qxv         , Xos         , Xos         , Xos         , Ryd         , Rr          , Ryd         , Xos         , Xz          , Yr          , Ryd         , Yr          , Qxv         , Qxv         , Xos         , Xos         , Ryd         , Xg^Zsw      , Xos         , Xos         , Xos         , Xos         , Xos         , Qxv         , Qxv         , Qxv         , Qxv         , Qxv         , Qxv         , Qxv         , Qxv         , Qxv         
Qxv         , Qxv         , Rr          , Qxv         , Qxv         , Qxv         , Qxv         , Qxv         , Qxv         , Qxv         , Qxv         , Qxv         , Ryd         , Ryd         , Ryd         , Rr          , Rr          , Ryd         , Ryd         , Xz          , Xos         , Qxv         , Qxv         , Xos         , Ryd         , Xg^Zsw      , Xos         , Ryd         , Xg^Zse      , Xos         , Ryd         , Ryd         , Ryd         , Xos         , Xos         , Qxv         , Xos         , Qxv         , Xos         , Xos         , Xos         , Qxv         
Qxv         , Qxv         , Rr          , Ryd         , Ryd         , Qxv         , Ryd         , Qxv         , Rr          , Qxv         , Rr          , Qxv         , Qxv         , Ryd         , Rr          , Rr          , Ryd         , Rr          , Rr          , Ryd         , Xos         , Qxv         , Xos         , Xos         , Xu          , Xos         , Xu          , Xu          , Ryd         , Rr          , Rr          , Rr          , Rr          , Ryd         , Xos         , Xos         , Yrh         , Xos         , Qxv         , Xos         , Xos         , Xos         
Qxv         , Qxv         , Qxv         , Rr          , Rr          , Ryd         , Rr          , Rr          , Xos         , Rr          , Xos         , Rr          , Rr          , Rr          , Xos         , Xos         , Xos         , Ryd         , Rr          , Ryd         , Uu^Vu       , Xos         , Xu          , Xu          , Yr          , Xu          , Xu          , Xu          , Ryd         , Rr          , Rr          , Rr          , Rr          , Ryd         , Xos         , Yrh         , Zw          , Yrh         , Qxv         , Qxv         , Qxv         , Xos         
Qxv         , Qxv         , Qxv         , Qxv         , Rr          , Rr          , Xos         , Ryd         , Uu^Vu       , Xos         , Xos         , Xos         , Xos         , Xos         , Xos         , Xos         , Xos         , Ryd         , Ryd         , Rr          , Ryd         , Xu          , Zw          , Zw          , Xu          , Xu          , Xu          , Ryd         , Ryd         , Rr          , Rr          , Rr          , Ryd         , Ryd         , Xos         , Xos         , Yr          , Zw          , Qxv         , Qxv         , Yrh         , Qxv         
Qxv         , Qxv         , Qxv         , Rr          , Ryd         , Ryd         , Xos         , Xos         , Xos         , Xos         , Ryd         , Xos         , Ryd         , Xos         , Uu^Vu       , Xos         , Ryd         , Xos         , Ryd         , Rr          , Ryd         , Yr          , Yr          , Zw          , Yr          , Xu          , Xu          , Ryd         , Ryd         , Rr          , Rr          , Rr          , Ryd         , Xos         , Yrh         , Xos         , Yr          , Yr          , Yr          , Zw          , Qxv         , Qxv         
Qxv         , Qxv         , Ryd         , Rr          , Xos         , Xos         , Xos         , Xos         , Ryd         , Ryd         , Rr          , Ryd         , Rr          , Ryd         , Rr          , Ryd         , Rr          , Ryd         , Ryd         , Rr          , Ryd         , Yr          , Qxv         , Xu          , Xu          , Xu          , Xu          , Xu          , Xu          , Ryd         , Rr          , Ryd         , Ryd         , Xos         , Qxv         , Zw          , Yr          , Rr          , Rr          , Yr          , Qxv         , Qxv         
Qxv         , Qxv         , Ryd         , Rr          , Qxv         , Xos         , Xos         , Ryd         , Rr          , Rr          , Ryd         , Rr          , Ryd         , Rr          , Ryd         , Rr          , Ryd         , Rr          , Rr          , Rr          , Ryd         , Yr          , Qxv         , Qxv         , Xu          , Xu          , Xu          , Xu          , Uu^Vu       , Ryd         , Rr          , Ryd         , Xos         , Xos         , Qxv         , Qxv         , Uu^Vu       , Ryd         , Rr          , Ryd         , Qxv         , Qxv         
Qxv         , Qxv         , Ryd         , Rr          , Qxv         , Qxv         , Qxv         , Ryd         , Rr          , Ryd         , Qxv         , Ryd         , Qxv         , Ryd         , Xu          , Ryd         , Xu          , Ryd         , Ryd         , Ryd         , Xu          , Qxv         , Qxv         , Qxv         , Xu          , Xu          , Xu          , Xu          , Xu          , Ryd         , Rr          , Ryd         , Xos         , Qxv         , Qxv         , Qxv         , Qxv         , Ryd         , Rr          , Ryd         , Qxv         , Qxv         
Xos         , Qxv         , Ryd         , Rr          , Qxv         , Qxv         , Qxv         , Ryd         , Rr          , Ryd         , Qxv         , Qxv         , Qxv         , Qxv         , Qxv         , Xu          , Xu          , Xu          , Xu          , Xu          , Xu          , Qxv         , Qxv         , Xu          , Xu          , Yrh         , Zw          , Xu          , Xu          , Ryd         , Rr          , Ryd         , Ryd         , Xos         , Xos         , Qxv         , Xos         , Xos         , Xg^Zsw      , Ryd         , Qxv         , Qxv         
Xos         , Xos         , Ryd         , Rr          , Ryd         , Qxv         , Ryd         , Ryd         , Rr          , Ryd         , Ryd         , Qxv         , Ryd         , Qxv         , Ryd         , Qxv         , Uu^Vu       , Xu          , Xu          , Xu          , Xu          , Xu          , Xu          , Xu          , Xu          , Xu          , Xu          , Xg^Zse      , Ryd         , Ryd         , Rr          , Rr          , Rr          , Ryd         , Xg^Zse      , Xos         , Ryd         , Ryd         , Rr          , Xg^Zsw      , Xos         , Qxv         
Qxv         , Xos         , Ryd         , Rr          , Rr          , Ryd         , Rr          , Rr          , Rr          , Rr          , Rr          , Ryd         , Rr          , Ryd         , Rr          , Ryd         , Rr          , Ryd         , Ryd         , Xu          , Xu          , Yrh         , Zw          , Xu          , Xu          , Xu          , Ryd         , Ryd         , Rr          , Rr          , Ryd         , Ryd         , Xg^Zse      , Xg^Zse      , Rr          , Ce          , Ryd         , Ryd         , Rr          , Ce          , Ryd         , Xos         
Xos         , Qxv         , Ryd         , Rr          , Rr          , Rr          , Rr          , Rr          , Rr          , Rr          , Rr          , Rr          , Rr          , Rr          , Rr          , Rr          , Rr          , Rr          , Ryd         , Xu          , Xu          , Xu          , Xu          , Xg^Zse      , Ryd         , Ryd         , Rr          , Rr          , Ryd         , Ryd         , Xos         , Xos         , Xos         , Ryd         , Ryd         , Rr          , Rr          , 1 Ryd       , Rr          , Ryd         , Ryd         , Ryd         
Xos         , Xos         , Uu^Vu       , Rr          , Rr          , Rr          , Rr          , Rr          , Rr          , Rr          , Rr          , Rr          , Rr          , Rr          , Rr          , Rr          , Rr          , Rr          , Rr          , Ryd         , Xu          , Xu          , Ryd         , Ryd         , Rr          , Rr          , Ryd         , Ryd         , Xg^Zse      , Xu          , Xu          , Xos         , Xos         , Uu^Vu       , Ryd         , Ryd         , Ce          , Rr          , Rr          , Ce          , Rr          , Rr          
Xos         , Xos         , Ryd         , Rr          , Rr          , Rr          , Rr          , Rr          , Rr          , Rr          , Rr          , Rr          , Rr          , Rr          , Rr          , Rr          , Rr          , Rr          , Rr          , Ryd         , Ryd         , Ryd         , Rr          , Rr          , Ryd         , Ryd         , Xu          , Xu          , Xu          , Zw          , Yrh         , Xu          , Xu          , Xos         , Xos         , Ryd         , Ryd         , Ryd         , Ryd         , Rr          , Rr          , Rr          
Qxv         , Xos         , Ryd         , Rr          , Rr          , Rr          , Rr          , Rr          , Rr          , Rr          , Rr          , Rr          , Rr          , Rr          , Rr          , Rr          , Rr          , Rr          , Rr          , Rr          , Rr          , Rr          , Ryd         , Ryd         , Xu          , Xg^Zse      , Zw          , Xu          , Xu          , Xu          , Xu          , Xu          , Xu          , Xu          , Xu          , Xos         , Xos         , Ryd         , Ryd         , Ryd         , Rr          , Rr          
Qxv         , Qxv         , Ryd         , Rr          , Rr          , Rr          , Rr          , Rr          , Rr          , Rr          , Rr          , Rr          , Rr          , Rr          , Rr          , Rr          , Rr          , Rr          , Rr          , Rr          , Ryd         , Ryd         , Xu          , Xu          , Xu          , Xu          , Xu          , Yrh         , Xu          , Xu          , Yr          , Uu^Vu       , Yrh         , Xu          , Xu          , Xos         , Xos         , Xos         , Xos         , Ryd         , Ryd         , Rr          
Qxv         , Qxv         , Ryd         , Rr          , Rr          , Rr          , Rr          , Rr          , Rr          , Rr          , Rr          , Rr          , Rr          , Rr          , Rr          , Rr          , Rr          , Rr          , Rr          , Ryd         , Xu          , Xu          , Xu          , Xu          , Xu          , Xu          , Xu          , Xu          , Yr          , Yr          , Yr          , Yr          , Xu          , Xg^Zse      , Yr          , Xu          , Qxv         , Xos         , Xos         , Xos         , Xos         , Ryd         
Xos         , Qxv         , Ryd         , Rr          , Rr          , Rr          , Rr          , Rr          , Rr          , Rr          , Rr          , Rr          , Rr          , Rr          , Rr          , Rr          , Rr          , Rr          , Rr          , Ryd         , Ryd         , Xu          , Ryd         , Xu          , Xg^Zse      , Xu          , Ryd         , Xg^Zsw      , Xg^Zsw      , Yr          , Xu          , Xu          , Qxv         , Xu          , Xu          , Xu          , Uu^Vu       , Qxv         , Qxv         , Xos         , Xos         , Xos         
Xos         , Qxv         , Ryd         , Rr          , Rr          , Rr          , Rr          , Rr          , Rr          , Rr          , Rr          , Rr          , Rr          , Rr          , Rr          , Rr          , Rr          , Rr          , Rr          , Rr          , Ryd         , Ryd         , Xg^Zse      , Xg^Zse      , Ryd         , Ryd         , Ryd         , Ryd         , Xg^Zse      , Xu          , Yrh         , Qxv         , Yr          , Qxv         , Yr          , Yrh         , Zw          , Qxv         , Qxv         , Qxv         , Qxv         , Xos         
Xos         , Xos         , Ryd         , Rr          , Rr          , Rr          , Rr          , Rr          , Rr          , Rr          , Rr          , Rr          , Rr          , Rr          , Rr          , Rr          , Rr          , Rr          , Rr          , Ryd         , Xos         , Xg^Zse      , Xu          , Ryd         , Xu          , Ryd         , Xu          , Xg^Zse      , Ryd         , Ryd         , Ryd         , Yr          , Yrh         , Yr          , Yr          , Yr          , Zw          , Yrh         , Yr          , Qxv         , Qxv         , Qxv         
Qxv         , Qxv         , Ryd         , Ryd         , Ryd         , Ryd         , Uu^Vu       , Ryd         , Ryd         , Ryd         , Ryd         , Ryd         , Ryd         , Ryd         , Ryd         , Ryd         , Uu^Vu       , Ryd         , Ryd         , Ryd         , Xos         , Xu          , Qxv         , Xu          , Qxv         , Xu          , Qxv         , Qxv         , Qxv         , Zw          , Zw          , Ryd         , Zw          , Zw          , Zw          , Zw          , Yrh         , Zw          , Zw          , Zw          , Yrh         , Qxv         
Qxv         , Qxv         , Xos         , Xos         , Xos         , Xos         , Xos         , Xos         , Xos         , Xos         , Xos         , Xos         , Xos         , Xos         , Xos         , Xos         , Xos         , Xos         , Xos         , Xos         , Qxv         , Qxv         , Qxv         , Qxv         , Qxv         , Qxv         , Qxv         , Qxv         , Qxv         , Yr          , Yrh         , Zw          , Zw          , Zw          , Zw          , Zw          , Zw          , Zw          , Yr          , Yr          , Yr          , Yr          
