Xu, Xu, Xu, Xu, Xu, Xu, Xu, Xu, Xu, Xu, Xu, Xu, Xu, Xu, Xu, Xu, Xu, Xu, Xu, Xu, Xu, Xu, Xu, Xu, Qxv, Qxv, Qxv, Xu, Xu, Xu, Xos, Xos, Xos, Xu, Xu, Xu, Xu, Xu, Xu, Xu, Xu, Xu, Xu, Xu, Xu, Xu, Wog, Wog, Wog, Wog, Wog, Xu, Xu, Xu, Xu, Xu, Xu, Xu, Xu, Xu, Xu, Xu, Xu, Xu, Xu
Xu, Xu, Xu, Xu, Xu, Xu, Xu, Xu, Xu, Xue, Xue, Xu, Xu, Xu, Xu, Xu, Xu, Xu, Xu, Xu, Xu, Xu, Xu, Xu, Qxv, Qxv, Xu, Xu, Xu, Xu, Xu, Xos, Xu, Xu, Xu, Xu, Xu, Xu, Xu, Xu, Xu, Xu, Xu, Xu, Xu, Xu, Xu, Wog, Wog, Wog, Wog, Xu, Xu, Xu, Xu, Xu, Xu, Xu, Xu, Xu, Xu, Xu, Xu, Xu, Xu
Xu, Xu, Xu, Xu, Xu, Xu, Xu, Xu, Xue, Xu, Xue, Xue, Xu, Xu, Xu, Xu, Xu, Xu, Xu, Xu, Qxv, Xu, Uh, Xu, Qxv^Xo, Qxv, Xu, Xu, Xu, Xu, Wwf, Uh, Xu, Xu, Xu, Xu, Xu, Xu, Xu, Xu, Xu, Xu, Xu, Xu, Xu, Xu, Xu, Xu, Wog, Wog, Wog, Wog, Xu, Xu, Xu, Xu, Xu, Xu, Xu, Xu, Xu, Xu, Xu, Xu, Xu
Xu, Xu, Xu, Xu, Xu, Xu, Xu, Xu, Xue, Xue, Xue, Xue, Xue, Yhr^Xp, Uu, Xu, Xu, Xu, Xu, Qxv, Qxv^Xo, Qxv^Xo, Qxv, Qxv, Qxv, Xu, Xu, Xu, Xu, Uh, Wwf, Wwf, Xu, Xu, Xu, Xu, Xos, Xu, Xu, Xu, Xu, Xu, Xu, Xu, Xu, Xu, Xu, Xu, Wog, Wog, Wog, Wog, Xu, Xu, Xu, Xu, Xu, Xu, Xu, Xu, Xu, Xu, Xu, Xu, Xu
Xu, Xu, Xu, Xu, Xu, Xu, Xos, Xos, Xos, Xue, Xue, Xue, Uhe, Uue, Uue, Uu, Yhr^Xp, Xu, Xu, Qxv, Qxv^Xo, Uh, Uu, Qxv, Uu, Qxv, Xos, Xu, Xu, Xu, Uh, Wwf, Wwf, Xu, Xu, Xos, Xos, Xos, Xos, Xu, Xu, Xu, Xu, Xu, Xu, Xu, Xu, Xu, Xu, Wog, Wog, Wog, Wog, Xu, Xu, Xu, Xu, Xu, Xu, Xu, Xu, Xu, Xu, Xu, Xu
Xu, Xu, Qxv, Xu, Xu, Xos, Xos, Xos, Xos, Xos, Uh, Uhe, Uue, Uue, Uue, Uu, Xos, Xos, Xu, Qxv^Xo, Uu, Ur^Br\, Ur^Br\, Tb^Tf, Tb^Tf, Uh, Xos, Xos, Xos, Xu, Uu, Wwf, Wwf, Wwf, Uh, Uh, Xu, Xos, Xos, Xos, Xos, Xu, Xu, Xu, Xu, Xu, Xu, Xu, Xu, Xu, Wog, Wog, Wog, Xu, Xu, Xu, Xu, Xu, Xu, Xu, Xu, Xu, Xu, Xu, Xu
Qxv, Qxv, Qxv, Xu, Xu, Xos, Xos, Xos, Xos, Uh, Uh, Uue, Uue, Uue, Uhe, Yhr^Xp, Xos, Xos, Xu, Xu, Xu, Uu, Uh, Ur^Br\, Ur^Br\, Uu, Xos, Xos, Xos, Uu, Uu, Uu, Wwf, Wwf, Uh, Uh, Wwf, Xu, Xu, Xos, Xos, Xos, Xos, Xu, Xu, Xu, Xu, Xu, Xu, Xu, Wog, Wog, Wog, Wog, Xu, Xu, Xu, Xu, Xu, Xu, Xu, Xu, Xu, Xu, Xu
Qxv, Qxv, Qxv, Qxv, Qxv, Qxv, Xu, Xos, Xos, Uu, Uu, Uu, Xos, Yhr^Xp, Xos, Xos, Xos, Xos, Xu, Xu, Xu, Xu, Xu, Uu, Xos, Ur^Br\, Ur^Pr/, Xos, Uu, Uu, Xuc, Wwf, Wwf, Wwf, Wwf, Wwf, Wwf, Xu, Xu, Xu, Xu, Xos, Xos, Xos, Xos, Xu, Xu, Xu, Xu, Xu, Wog, Wog, Wog, Wog, Xu, Xu, Xu, Xu, Xu, Xu, Xu, Xu, Xu, Xu, Xu
Qxv, Qxv, Xu, Qxv, Qxv, Qxv, Xu, Xu, Uu, Urb, Urb, Uu, Xos, Xos, Xos, Xos, Ss, Yhr^Xp, Yhr^Xp, Xu, Xu, Xu, Xu, Xos, Xos, Xos, Uu, Ur^Br\, Ur^Br\, Uu, Xu, Xu, Xu, Uu, Uu, Uh, Uh, Xu, Xu, Xu, Xos, Xos, Xos, Xos, Xu, Xu, Xu, Xu, Wog, Wog^Xo, Wog^Xo, Wog, Wog, Xu, Xu, Xu, Xu, Xu, Xu, Xu, Xu, Xu, Xu, Xu, Xu
Qxv, Qxv, Qxv, Qxv, Uh, Uh, Uu, Uu, Uu, Urb, Urb, Urb, Urb, Xos, Xos, Ss, Ss, Ss, Ss, Yhr^Xp, Yhr^Xp, Xu, Xu, Xu, Xu, Xu, Xuc, Uu, Ur^Br|, Uh, Uh, Xuc, Xuc, Yhr, Yhr^Tf, Uu^Ii, Uu^Ii, Xu, Uu, Uh, Uh, Xos, Xos, Xos, Xu, Xu, Wwf, Wog, Wog, Wog, Wog, Wog^Xo, Xu, Xu, Xu, Xu, Xu, Xu, Xu, Xu, Xu, Xu, Xu, Xu, Xu
Uu, Qxv, Uh, Uu, Uu, Uu, Uu, Uu, Urb, Urb, Uu, Urb, Urb^Pr/, Urb^Pr/, Urb, Xos^Efs, Uu, Ss, Ss, Ss, Xos, Xos, Xu, Xu, Xuc, Xuc, Xuc, Uu^Ii, Uu^Ii, Ur^Br\, Ur^Br\, Uu, Uu, Uh, Yhr, Yhr^Xp, Uu, Uu, Urb, Uu, Uu, Uh, Uh, Xu, Wwf, Wwg, Wwg, Wog, Wwg, Wwg, Wog, Wog, Xu, Xu, Xu, Xu, Xu, Xu, Xu, Xu, Xu, Xu, Xu, Xu, Xu
Uu, Uu, Uu, Uu, Urb, Urb, Urb, 1 Urb, Uu, Uu, Xos, Xos, Uu, Urb, Urb, Uu, Uu, Xos^Efs, Xos^Efs, Xos, Xu, Xu, Xu, Xu, Xu, Uh, Uu^Vu, Uu^Ii, Xu, Ur^Br|, Ur^Br\, Ur^Br\, Xos, Xos, Yhr^Xp, Yhr^Tf, Uh, Uu, Urb, Uu^Vud, Uu, Uh, Wwf, Wwg, Wwg, Wwf, Wwg, Wwg, Wwf, Wwg, Xu, Xu, Xos, Xu, Xos, Xu, Xu, Xu, Xu, Xu, Xu, Xu, Xu, Xu, Xu
Urb, Urb, Urb, Urb, Uu, Uu, Uu, Uu, Uu, Uu, Xos, Xos, Xos, Uu, Uu, Urb, Urb, Uu, Xos, Xos, Xu, Xu, Uh, Xu, Uu^Dr, Uu^Tf, Uu, Ur, Uu, Uu, Uh, Xom, Xos, Xos, Xos, Xu, Xu, Uh, Urb, Urb, Uh, Wwg, Wwg, Wwg, Wwf, Wwg, Wwf, Uu, Uu, Xu, Xu, Xos, Xos, Xos, Xos, Xos, Xu, Xu, Xu, Xu, Xu, Xu, Xu, Xu, Xu
Uu, Uu, Uu, Uu, Xu, Uu, Uh, Uu, Xu, Xu, Xos, Xos, Xos, Xos, Xos, Uu, Urb, Urb, Xos, Xos, Xu, Uh, Tb^Tf, Tb^Tf, Uh, Uu, Ur, Uu, Uu, Uu, Uh, Xom, Xos, Xos, Xos, Xu, Xu, Uh, Uu, Urb, Wwf, Wwg, Wog, Wwg, Xu, Wwg, Wwf, Ur, Ur, Xu, Uh, Uh, Uh, Xu, Xos, Xos, Xu, Xu, Xu, Xu, Xu, Xu, Xu, Xu, Xu
Xu, Uh, Xu, Xu, Xu, Uh, Xu, Uh, Xu, Xu, Xos, Xos, Xos, Xos, Xos, Xos, Xos, Urb^Pr/, Urb, Xos, Uu, Uh, Uu, Uh, Ur, Ur, Uh, Uu, Uu, Ur, Ur, Uh, Uh, Xom, Xom, Xos, Uh, Wwg, Wwf, Wwg, Wwf, Wwg, Wog, Xu, Xos, Xu, Tb^Tf, Uu, Ur, Uu, Uu, Tb^Tf, Tb^Tf, Uh, Xos, Xos, Xu, Xu, Xu, Xu, Xu, Xu, Xu, Xu, Xu
Xu, Xu, Xu, Xu, Xu, Yhr^Xp, Xu, Yhr^Xp, Xos, Xos, Xos, Xos, Xu, Xos, Xos, Xos, Xos, Urb, Ur, Ur, Ur, Uu, Ur, Uu^Ii, Uu, Uu, Xu, Xu, Xu, Uu, Uu, Uu, Urb, Uu^Tfi, Uu, Uh, Urb, Wwg, Wwg, Wwg, Wwg, Wwg, Xu, Xu, Xos, Uh, Uh, Xu, Uu, Uu^Ii, Uu^Vu, Uu^Tf, Xu, Uh, Xos, Xos, Xu, Xu, Xu, Xu, Xu, Xu, Xu, Xu, Xu
Xu, Xu, Xu, Xu, Xu, Xos, Xos, Xos, Xos, Xos, Xu, Xu, Xu, Xu, Xu, Xos, Qxv, Uu, Uu, Ur, Uu, Uu, Uh, Uh, Qxv, Qxv, Qxv^Xo, Xu, Xu, Xu, Xu, Uu, Uu, Uu, Urb, Urb, Uh, Wwf, Wwg, Wwg, Wog, Xu, Xu, Xu, Xu, Xu, Uh, Uu^Tf, Tb^Tf, Ur, Tb^Tf, Uh, Uh, Uh, Xos, Xos, Xu, Xu, Xu, Xu, Xu, Xu, Xu, Xu, Xu
Xu, Xu, Xu, Xu, Xu, Xos, Xos, Xos, Xu, Xu, Xu, Xu, Xu, Xu, Xu, Xu, Qxv^Xo, Qxv, Qxv, Qxv, Qxv, Qxv, Qxv, Qxv, Qxv^Xo, Qxv^Xo, Qxv, Xu, Xu, Xu, Xu, Xos, Xos, Uu^Tf, Uu, Uu, Xuc, Xu, Xu, Wwg, Wog, Wog, Xu, Xu, Xu, Xu, Xu, Uh, Uh, Uh, Uh, Xu, Xu, Xu, Xos, Xos, Xu, Xu, Xu, Xu, Xu, Xu, Xu, Xu, Xu
Xu, Xu, Xu, Xu, Xu, Xu, Xu, Xu, Xu, Xu, Xu, Xu, Xu, Xu, Xu, Xu, Qxv, Qxv^Xo, Qxv^Xo, Qxv^Xo, Qxv^Xo, Qxv^Xo, Qxv^Xo, Qxv^Xo, Qxv, Qxv, Qxv, Qxv, Xos, Xos, Xos, Xos, Xos, Uh, Uu^Tf, Urb, Uh, Xu, Xu, Wog, Wog, Wog, Xu, Xu, Xu, Xu, Xu, Uh, Xu, Xu, Xu, Uh, Xos, Xos, Xos, Xos, Xu, Xu, Xu, Xu, Xu, Xu, Xu, Xu, Xu
Xu, Xu, Xu, Xu, Xu, Xu, Xu, Xu, Xu, Ql, Xu, Xu, Xu, Xu, Xu, Xu, Xu, Qxv, Qxv, Qxv, Qxv, Qxv, Qxv, Qxv, Qxv, Qxv, Xos, Xos, Xos, Xos, Xu, Xu, Xu, Xu, Uh, Urb, Uu, Xuc, Xu, Wog, Wog^Xo, Wog^Xo, Wwg, Xu, Xu, Xu, Xu, Xos, Xos, Xu, Xos, Xos, Xos, Xos, Xu, Xu, Xu, Xu, Xu, Xu, Xu, Xu, Xu, Xu, Xu
Xu, Xu, Xu, Xu, Xu, Xu, Xu, Xu, Xu, Ql, Ql^Xo, Xu, Xu, Xu, Xu, Xu, Xu, Xu, Xu, Qxv, Qxv, Qxv, Qxv, Qxv, Xos, Xos, Xos, Xos, Xu, Cud, Cud, Xu, Xu, Xu, Urb^Pr\, Urb, Uu, Xu, Xu, Wog^Xo, Wog, Wog, Wog, Wwg, Wwg, Xu, Xu, Xos, Xos, Xos, Xos, Xos, Xu, Xu, Xu, Xu, Xu, Xu, Xu, Xu, Xu, Xu, Xu, Xu, Xu
Xu, Xu, Xu, Xu, Xu, Xu, Xu, Xu, Xu, Xu, Ql, Xu, Xu, Xu, Xu, Xu, Ql, Xu, Xu, Xu, Xu, Qxv, Xos, Xos, Xos, Xos, Yhr, Xu, Xu, Cud, Cud, Cud, Uu, Uu^Eb, Urb, Urb^Pr\, Xu, Xu, Xu, Xu, Wog, Wog, Wog, Wwg, Wwg, Xu, Xu, Xu, Xu, Xos, Xu, Xu, Xu, Xu, Xu, Xu, Xu, Xu, Xu, Xu, Xu, Xu, Xu, Xu, Xu
Xu, Xu, Xu, Xu, Xu, Xu, Ql, Xu, Ql, Xu, Ql, Ql, Xu, Xu, Xu, Xu, Ql^Xo, Xu, Xu, Xu, Xu, Xos, Xos, Xos, Xu, Xu, Xu, Yhr^Xo, Yhr^Xp, Xu, Uu, Uu, Urb, Urb, Uu, Uu^Eb, Xu, Xu, Xu, Xu, Xu, Wog, Wog, Wog, Wog, Wog, Wog, Xu, Xu, Xu, Xu, Xu, Xu, Xu, Xu, Xu, Xu, Xu, Xu, Xu, Xu, Xu, Xu, Xu, Xu
Xu, Xu, Xu, Xu, Xu, Xu, Xu, Ql^Xo, Ql, Ql, Ql, Ql, Ql, Ql, Ql, Ql, Ql, Xu, Xu, Xu, Xu, Xu, Xu, Yhr, Yhr^Xo, Xu, Yhr^Xp, Yhr, Uu, Uu, Urb, Urb, Xu, Uu, Cud, Cud, Cud, Xu, Xu, Xu, Xu, Xu, Xu, Wog, Wog, Wog, Wog, Wog, Xu, Xu, Xu, Xu, Xu, Xu, Xu, Xu, Xu, Xu, Xu, Xu, Xu, Xu, Xu, Xu, Xu
Xu, Xu, Xu, Xu, Xu, Xu, Xu, Xu, Ql, Ql, Ql, Xu, Xu, Xu, Xu, Xu, Ql, Ql, Ql, Xu, Xu, Xu, Xu, Xu, Xu, Yhr, Uu, Uu, Urb, Urb, Uu, Uu, Yhr^Xp, Xu, Xu, Cud, Cud, Cud, Xos, Xu, Xu, Xu, Xu, Xu, Wog, Wog, Wog, Wwg, Xu, Xu, Xu, Xu, Xu, Xu, Xu, Xu, Xu, Xu, Xu, Xu, Xu, Xu, Xu, Xu, Xu
Xu, Xu, Xu, Xu, Xu, Xu, Ql, Ql^Xo, Xu, Ql, Ql, Xu, Xu, Xu, Xue, Xos, Xos, Ql, Ql, Ql, Xu, Xuc, Xuc, Xuc, Uu^Pr\, Uu, Urb, Urb, Uu, Uu, Yhr, Yhr^Xp, Xu, Yhr^Xp, Yhr^Xo, Xu, Xos, Xos, Xos, Xu, Xu, Xu, Xu, Xu, Xu, Wog, Wog, Wwg, Xu, Xu, Xu, Xu, Xu, Xu, Xu, Xu, Xu, Xu, Xu, Xu, Xu, Xu, Xu, Xu, Xu
Xu, Xu, Xu, Xu, Xu, Xu, Xu, Xu, Xu, Xu, Ql, Ql, Xue, Xu, Xue, Xos, Uh, Uu, Uu, Ql, Uu, Uu, Uu, Uu^Eb, Urb, Urb^Pr\, Uu^Pr\, Uu, Xu, Yhr^Xp, Yhr^Xp, Xu, Xu, Xu, Xu, Yhr, Xos, Xos, Xu, Xu, Xu, Xu, Xu, Xu, Xu, Wwg, Wog, Wog, Wog, Xu, Xu, Xu, Xu, Xu, Xu, Xu, Xu, Xu, Xu, Xu, Xu, Xu, Xu, Xu, Xu
Xu, Xu, Xu, Xu, Xu, Xu, Xu, Xu, Ql, Ql, Ql, Ql, Xue, Xue, Uhe, Xue, Uhe, Uh, Cud, Uu, Uu, Uh, Urb, Urb, Urb, Uu^Eb, Xuc, Xu, Xu, Xu, Xu, Yhr^Xo, Yhr, Xu, Xos, Xos, Xos, Xos, Xu, Xu, Xu, Xu, Xu, Xu, Xu, Wwg, Wwg, Wog, Wog, Xu, Xu, Xu, Xu, Xu, Xu, Xu, Xu, Xu, Xu, Xu, Xu, Xu, Xu, Xu, Xu
Xu, Xu, Xu, Xu, Xu, Xu, Xu, Xu, Ql, Ql, Ql, Ql, Uhe, Uue^Tf, Uhe, Uhe, Uhe, Tb^Tf, Uu, Uu, Urb, Rb, Uu, Uu, Urb, Uu, Uu, Xuc, Yhr^Xp, Xuc, Xuc, Xu, Xos, Xos, Xu, Xos, Xos, Xos, Xos, Xu, Xu, Xu, Xu, Xu, Xu, Wwg, Wog, Wog, Wog, Wog, Wog, Xu, Xu, Xu, Xu, Xu, Xu, Xu, Xu, Xu, Xu, Xu, Xu, Xu, Xu
Xu, Xu, Xu, Xu, Xu, Xu, Xu, Ql, Ql, Ql, Uhe, Uue, Uue, Tb^Tf, Tb^Emf, Tb^Tf, Ur^Em, Yhr^Xp, Uu, Rb, Uu, Uu, Uh, Uu, Uu, Uu, Uh, Yhr, Yhr^Xp, Uu^Tf, Xuc, Xu, Xu, Xu, Xuc, Xu, Yhr, Xos, Xu, Xu, Xu, Xu, Xu, Xu, Xu, Xu, Wog, Wog, Wog^Xo, Wog, Wog^Xo, Xu, Xu, Xu, Uu, Xu, Xuc, Xu, Xu, Xu, Xu, Xu, Xu, Xu, Xu
Xu, Xu, Xu, Xu, Xu, Xu, Xu, Ql, Ql, Ql, Cud, Cud, Cud, Uue^Em, Uu^Em, Ur^Em, Ur^Em, Yhr^Xp, Yhr^Xp, Uu^Tf, Xu, Rb^Tf, Cud, Uh, Uue^Tf, Rb^Es, Uu, Uh, Cud, Uu^Tf, Xu, Xos, Xu, Xu, Yhr^Xp, Yhr^Xo, Xu, Xu, Xu, Xu, Xos, Xu, Xu, Xu, Xu, Xu, Xu, Wog^Xo, Wog, Wog^Xo, Wwg, Xuc, Xu, Xu, Uh, Uh, Uh, Xuc, Xu, Xu, Xu, Xu, Xu, Xu, Xu
Xu, Xu, Xu, Xu, Xu, Xu, Xu, Xu, Ql, Urb^Es, Cud, 2 Xu, Cud, Urb, Yhr^Xp, Ur^Em, Uu, Ur, Ur, Xu, 3 Xu, Xuc, Uhe, Tb^Tf, Tb^Tf, Rb^Em, Ur, Yhr^Xp, Uu, Uh, Yhr^Xp, Uh, Uu^Tf, Yhr, Xu, Xu, Xu, Xu, Xos, Xos, Xos, Xos, Xu, Xu, Xuc, Xu, Xuc, Wog, Wog, Wog, Wwg, Wwf, Uu, Uu, Rb, Uu^Ii, Uh^Ii, Xuc, Xu, Xu, Xu, Xu, Xu, Xu, Xu
Xu, Xu, Xu, Xu, Ql, Xu, Ql, Ql, Ql, Ql, Uu^Es, Cud, Urb, Urb, Yhr, Yhr, Uh, Uu, Ur, Uu^Tf, Xuc, Uue^Tf, Uue^Emf, Uue^Tf, Re^Em, Uu, Uu, Ur, Uu, Uh, Uu, Yhr^Xp, Uh, Xu, Xu, Xu, Xos, Xos, Xos, Xos, Xos, Xos, Xu, Xuc, Uu, Uh, Uh, Wwg, Wwg, Wog, Wog, Wwg, Uh, Uu^Ii, Rb, Uu^Ii, Tb^Tfi, Uh, Xuc, Xu, Xu, Xu, Xu, Xu, Xu
Xu, Xu, Xu, Ql, Ql, Ql^Xo, Ql, Ql, Ql, Uu, Urb, Urb, Urb, Tb^Tf, Ur^Es, Uu, Ur, Uu^Tf, Ur, Yhr^Xp, Yhr^Xp, Xuc, Rb, Re, Yhr^Xp, Uu, Uu, Ur, Ur, Ur, Ur, Uu, Uu, Xu, Xos^Efs, Xos, Xos, Xos, Xu, Xu, Xu, Uh, Uh, Uu, Uu^Ii, Uh, Uu, Rb^Em, Wwf, Wwg, Wog, Wwg, Wwg, Wwf, Wwf, Uu, Uh, Uh, Xu, Xu, Xu, Xu, Xu, Xu, Xu
Xu, Xu, Xu, Ql, Xu, Ql^Xo, Ql, Ql, Ql, Urb, Uu, Uu^Es, Ql, Uu, Uu, Ur, Uu, Uu, Uu, Yhr^Xp, Tb^Tf, Rb, Tb^Tf, Uu^Tf, Yhr, Xuc, Yhr, Uu, Uh, Uu, Uu, Urb, Ur, Ur, Urb, Xos^Efs, Xos, Xos, Xu, Xu, Uu, Uu, Uu, Uu, Uu, Uu, Uu^Vu, Rb^Em, Uu, Wwg, Wwg, Wog, Wwg, Wwg, Wwg, Wwg, Wog, Wog, Wog, Wog^Xo, Wog, Wog, Wwg, Xu, Xu
Xu, Xu, Xu, Xu, Xu, Xu, Xu, Ql, Ql, Ql, Ql, Ql, Ql, Uh, Uh, Uu, Xuc, Xu, Uh, Uu, Uu, Cud, Uhe, Tb^Tf, Uue, Yhr, Uue, Ql, Ql, Ql, Ql, Ur, Ur, Urb, Urb^Zz/, Urb^Zz/, Urb, Xu, Xu, Xu, Ur, Uu, Uu, Rb, Uu, Ur, Ur, Uu, Uu, Rb, Wwg, Wog, Wog, Wog, Wog, Wog, Wog, Wog, Wog, Wog^Xo, Wog, Wog, Wog, Wwg, Xu
Xu, Xu, Xu, Xu, Xu, Xu, Xu, Ql, Ql, Ql, Ql, Ql, Uu, Uh, Uh, Uh, Xu, Xu, Ql, Ql, Uh, Uh, Uhe, Uhe, Uue, Uue, Uue, Uue, Cud, Ql, Ql, Xos, Xos, Urb^Zz/, Urb, Urb, Urb, Uu, Uu, Ur, Ur, Uu, Ql, Uu, Uh, Uu, Uu, Rb, Rb, Uu, Urb, Wwg, Xu, Wog, Xos, Wog, Xu, Xu, Xu, Wog^Xo, Wog, Wog, Wog, Wog, Wog
Xu, Xu, Xu, Xu, Xu, Xu, Ql^Xo, Ql, Ql, Ql, Xu, Xu, Xu, Uu, Ql, Ql, Xu, Xu, Xu, Ql, Ql, Uh, Ql, Uhe, Xu, Ql, Ql, Uue, Ql, Ql, Ql, Xos, Xos, Xos, Xos, Urb, Urb, Urb, Uu, Ql, Ur, Uu, Ql, Ql, Ql, Uh, Xu, Uu, Urb, Urb, Uu, Xu, Xu, Xos, Xos, Xos, Xos, Xu, Xu, Xu, Xu, Wwg, Wwg, Wog, Wog
Xu, Xu, Xu, Xu, Ql, Ql, Xu, Xu, Ql, Ql, Xu, Xu, Ql, Uu, Ql, Xu, Ql, Xu, Ql, Ql, Ql, Ql, Xu, Xu, Xu, Ql, Ql, Ql, Xu, Ql, Ql, Xos, Xos, Xos, Xos, Xu, Xu, Ql, Ql, Ql, Uu, Ql, Ql, Ql, Xu, Xu, Xu, Xu, Cud, Urb, Xu, Xu, Xu, Xu, Xos, Xos, Xos, Xos, Xos, Xu, Xu, Wwg, Wog, Wog, Wog
Xu, Xu, Xu, Xu, Xu, Xu, Xu, Xu, Xu, Ql^Xo, Xu, Xu, Ql, Ql, Ql, Ql, Ql, Ql, Ql, Ql, Ql, Ql, Xu, Xu, Ql, Ql, Ql, Ql, Ql, Ql, Ql, Xos, Xos, Xos, Xu, Xu, Xue, Xue, Ql, Ql, Ql, Ql, Ql, Xu, Xu, Xu, Xu, Xu, Uu, Cud, Xu, Xu, Xuc, Xu, Yhr^Xp, Xom, Xom^Xzm\, Xos, Xos, Xos, Xos, Wog, Wog, Wog, Xu
Xu, Xu, Xu, Xu, Xu, Xu, Xu, Xu, Ql, Ql, Xu, Xu, Xu, Xu, Xu, Xu, Xu, Xu, Ql^Xo, Ql, Ql, Ql, Xu, Xu, Ql, Ql, Ql, Xu, Xu, Ql, Xu, Xos, Xu, Xu, Xu, Xu, Xue, Xue, Xue, Ql, Ql, Ql, Ql, Xue, Xu, Xu, Xuc, Uu, Ur, Ur, Xu, Xu, Yhr, Yhr, Yhr, Yhr, Yhr^Tf, Xos^Xzm\, Xos, Xos, Wog^Xo, Wog, Wog, Wog, Xu
Xu, Xu, Xu, Xu, Xu, Xu, Xu, Xu, Xu, Xu, Xu, Xu, Xu, Xu, Xu, Xu, Xu, Ql, Ql, Xu, Xu, Xu, Xu, Xu, Xu, Ql, Ql, Ql, Xu, Xu, Xu, Xu, Xu, Xu, Xu, Xu, Xue, Xue, Uhe, Uhe, Uhe, Ql, Uhe, Xue, Xue, Xuc, Uu, Urb, Uu, Uu, Uu, Uu, Yhr, Yhr^Xp, Yhr^Xp, Tb^Tf, Tb^Tf, Uu, Wwg, Wog, Wog, Wog^Xo, Wog^Xo, Xu, Xu
Xu, Xu, Xu, Xu, Xu, Xu, Xu, Xu, Xu, Xu, Xu, Xu, Xu, Xu, Xu, Xu, Xu, Ql, Xu, Xu, Xu, Xu, Xu, Xu, Xu, Xu, Xu, Ql^Xo, Ql, Xu, Xu, Xu, Xu, Xu, Xu, Xu, Xu, Xue, Xue, Uhe, Uhe, Uhe, Uue, Uhe, Xu, Xu, Uu, Urb, Uu^Ii, Uu, Uu, Uu, Xu, Yhr, Uu^Tf, Tb^Tf, Uu, Tb^Tf, Wwg, Wwg, Wog, Wog, Xu, Xu, Xu
Xu, Xu, Xu, Xu, Xu, Xu, Xu, Xu, Xu, Xu, Xu, Xu, Xu, Xu, Xu, Xu, Xu, Xu, Xu, Xu, Xu, Xu, Xu, Xu, Xu, Xu, Xu, Xu, Xu, Ql, Xu, Xu, Xu, Xu, Xu, Xu, Xu, Xue, Xue, Xue, Uue, Uue^Tf, Uue, Uu, Ur, Uu, Ur^Em, Ur, Uu, Uu^Tf, Uu, Xu, Xu, Uh, Uh, Tb^Tf, Yhr^Em, Uu^Tf, Wwg, Wog, Wog, Xu, Xu, Xu, Xu
Xu, Xu, Xu, Xu, Xu, Xu, Xu, Xu, Xu, Xu, Xu, Xu, Xu, Xu, Xu, Xu, Xu, Xu, Xu, Xu, Xu, Xu, Xu, Xu, Xu, Xu, Xu, Xu, Xu, Xu, Xu, Xu, Xu, Xu, Xu, Xu, Xue, Xue, Xue, Uue, Uhe, Uue^Tf, Yhr, Yhr^Xp, Uue^Tf, Tb^Tf, Uu, Ur, Uu, Uu, Tb^Tf, Xu, Xu, Xu, Xu, Yhr^Xp, Yhr^Xp, Yhr, Wog, Wog, Wog, Wog, Xu, Xu, Xu
Xu, Xu, Xu, Xu, Xu, Xu, Xu, Xu, Xu, Xu, Xu, Xu, Xu, Xu, Xu, Xu, Xu, Xu, Xu, Xu, Xu, Xu, Xu, Xu, Xu, Xu, Xu, Xu, Xu, Xu, Xu, Xu, Xu, Xu, Xu, Xu, Xue, Xue, Ql, Uue, Uhe, Yhr^Xp, Yhr^Tf, Yhr, Xu, Tb^Tf, Uu, Uu, Uu, Uh, Uu, Tb^Tf, Xuc, Xu, Xu, Xos, Xos, Xu, Xu, Wog, Wog^Xo, Wog^Xo, Wog, Xu, Xu
Xu, Xu, Xu, Xu, Xu, Xu, Xu, Xu, Xu, Xu, Xu, Xu, Xu, Xu, Xu, Xu, Xu, Xu, Xu, Xu, Xu, Xu, Xu, Xu, Xu, Xu, Xu, Xu, Xu, Xu, Xu, Xu, Xu, Xu, Xu, Xu, Xue, Xue, Ql, Ql, Uhe, Uhe, Tb^Tf, Yhr^Tf, Xu, Uu, Uu^Tf, Ur, Ur, Uh, Uu, Uh, Xu, Xu, Xu, Xos, Xos, Xos, Xos, Xu, Xu, Wog, Wog, Wog, Xu
Xu, Xu, Xu, Xu, Xu, Xu, Xu, Xu, Xu, Xu, Xu, Xu, Xu, Xu, Xu, Xu, Xu, Xu, Xu, Xu, Xu, Xu, Xu, Xu, Xu, Xu, Xu, Xu, Xu, Xu, Xu, Xu, Xu, Xu, Xu, Xu, Xu, Xue, Xue, Ql, Xue, Uhe, Xu, Yhr, Xu, Xuc, Uh, Uu, Ur, Uu, Uu, Xu, Xu, Xu, Xu, Xu, Xu, Xos, Xos, Xu, Xu, Wog, Wog, Wog, Wog
Xu, Xu, Xu, Xu, Xu, Xu, Xu, Xu, Xu, Xu, Xu, Xu, Xu, Xu, Xu, Xu, Xu, Xu, Xu, Xu, Xu, Xu, Xu, Xu, Xu, Xu, Xu, Xu, Xu, Xu, Xu, Xu, Xu, Xu, Xu, Xu, Xu, Xu, Xu, Xue, Xu, Xu, Xu, Xu, Xu, Xuc, Xu, Uu, Uu, Uu, Ur, Uu, Xu, Xu, Xu, Xu, Xu, Xu, Xu, Xu, Xu, Xu, Wog, Wog, Wog
Xu, Xu, Xu, Xu, Xu, Xu, Xu, Xu, Xu, Xu, Xu, Xu, Xu, Xu, Xu, Xu, Xu, Xu, Xu, Xu, Xu, Xu, Xu, Xu, Xu, Xu, Xu, Xu, Xu, Xu, Xu, Xu, Xu, Xu, Xu, Xu, Xu, Xu, Xu, Xu, Xu, Xu, Xu, Xu, Xu, Xu, Xu, Uh, Uu, Ur, Ur, Uu, Uu, Xu, Xu, Xu, Xu, Xu, Xu, Xu, Xu, Xu, Xu, Wog, Wog
