border_size=1
usage=map

Xu          , Xu          , Xu          , Xu          , Xu          , Xu          , Xu          , Xu          , Xu          , Xu          , Xu          , Xu          , Xu          , Xu          , Xu          , Xu          , Qxv         , Qxv         , Xu          , Xu          , Qxv         , Qxv         , Qxv         , Qxv         , Qxv         , Qxv         , Qxv         , Qxv         , Qxv         , Qxv         , Yl          , Ryd         , Ryd         , Qxv         , Qxv         , Qxv         , Qxv         , Qxv         , Qxv         , Qxv         , Qxv         , Qxv         
Xu          , Xu          , Qxv         , Qxv         , Xu          , Qxv         , Qxv         , Qxv         , Xu          , Xu          , Qxv         , Xu          , Xu          , Qxv         , Qxv         , Xu          , Xu          , Xu          , Qxv         , Qxv         , Xu          , Qxv         , Qxv         , Qxv         , Uu^Ii       , Qxv         , Qxv         , Uu^Ii       , Qxv         , Qxv         , Yl          , Ryd         , Yl          , Qxv         , Qxv         , Uu^Ii       , Qxv         , Qxv         , Uu^Ii       , Qxv         , Qxv         , Qxv         
Xu          , Qxv         , Xu          , Xu          , Qxv         , Xu          , Xu          , Xu          , Qxv         , Qxv         , Xu          , Xu          , Qxv         , Xu          , Xu          , Qxv         , Xu          , Xu          , Xu          , Xu          , Qxv         , Qxv         , Xu          , Qxv         , Qxv         , Qxv         , Uu^Ii       , Qxv         , Uu^Ii       , Qxv         , Ryd         , Ryd         , Yl          , Qxv         , Uu^Ii       , Qxv         , Uu^Ii       , Qxv         , Qxv         , Qxv         , Qxv         , Qxv         
Xu          , Xu          , Qxv         , Qxv         , Xu          , Xu          , Qxv         , Xu          , Xu          , Xu          , Qxv         , Qxv         , Xu          , Xu          , Qxv         , Xu          , Xu          , Qxv         , Qxv         , Xu          , Xu          , Xu          , Qxv         , Qxv         , Xu          , Qxv         , Qxv         , Qxv         , Qxv         , Qxv         , Yl          , Ryd         , Ryd         , Qxv         , Qxv         , Qxv         , Qxv         , Qxv         , Qxv         , Qxv         , Xu          , Qxv         
Xu          , Xu          , Xu          , Xu          , Qxv         , Xu          , Xu          , Qxv         , Qxv         , Xu          , Xu          , Xu          , Qxv         , Qxv         , Xu          , Xu          , Qxv         , Xu          , Xu          , Qxv         , Xu          , Xu          , Xu          , Xu          , Qxv         , Qxv         , Xu          , Qxv         , Qxv         , Qxv         , Yl          , Ryd         , Yl          , Qxv         , Qxv         , Qxv         , Qxv         , Qxv         , Xu          , Qxv         , Qxv         , Xu          
Xu          , Xu          , Qxv         , Xu          , Xu          , Qxv         , Qxv         , Xu          , Xu          , Xu          , Qxv         , Xu          , Xu          , Xu          , Qxv         , Qxv         , Xu          , Xu          , Qxv         , Xu          , Xu          , Qxv         , Xu          , Xu          , Xu          , Xu          , Xu          , Xu          , Xu          , Qxv         , Xg^Zsw      , Ryd         , Yl          , Qxv         , Qxv         , Qxv         , Xu          , Qxv         , Qxv         , Xu          , Xu          , Xu          
Xu          , Xu          , Xu          , Qxv         , Qxv         , Xu          , Xu          , Xu          , Qxv         , Qxv         , Xu          , Xu          , Xu          , Xu          , Xu          , Xu          , Qxv         , Qxv         , Xu          , Xu          , Qxv         , Qxv         , Xu          , Xu          , Qxv         , Qxv         , Qxv         , Qxv         , Qxv         , Xu          , Yl          , Xg^Zsw      , Xg^Zsw      , Qxv         , Xu          , Qxv         , Qxv         , Xu          , Xu          , Xu          , Xu          , Xu          
Xu          , Xu          , Qxv         , Xu          , Xu          , Xu          , Qxv         , Xu          , Xu          , Xu          , Xu          , Qxv         , Qxv         , Xu          , Xu          , Xu          , Xu          , Xu          , Xu          , Xu          , Xu          , Xu          , Xu          , Qxv         , Qxv         , Qxv         , Qxv         , Qxv         , Ryd         , Yl          , Ryd         , Ryd         , Yl          , Xu          , Xu          , Xu          , Xu          , Xu          , Xu          , Xu          , Qxv         , Qxv         
Xu          , Xu          , Qxv         , Xu          , Qxv         , Qxv         , Xu          , Xu          , Qxv         , Xu          , Qxv         , Qxv         , Qxv         , Xu          , Qxv         , Xu          , Qxv         , Qxv         , Qxv         , Qxv         , Qxv         , Qxv         , Qxv         , Xu          , Xu          , Qxv         , Qxv         , Yl          , Ryd         , Ryd         , Yl          , Ryd         , Xg^Zse      , Xg^Zse      , Yl          , Xu          , Xu          , Xu          , Qxv         , Qxv         , Qxv         , Qxv         
Xu          , Xu          , Qxv         , Xu          , Xu          , Xu          , Ryd         , Ryd         , Xg^Zse      , Xu          , Ryd         , Ryd         , Ryd         , Xu          , Qxv         , Xu          , Xu          , Qxv         , Qxv         , Qxv         , Qxv         , Qxv         , Uu^Ii       , Xu          , Xu          , Qxv         , Xu          , Qxv         , Xu          , Yl          , Xg^Zse      , Xg^Zse      , Ryd         , Yl          , Xz          , Xu          , Xu          , Qxv         , Qxv         , Qxv         , Qxv         , Qxv         
Xu          , Xu          , Xu          , Xu          , Xu          , Uu^Ii       , Qxv         , Xu          , Xu          , Ryd         , Ryd         , Xu          , Xu          , Uu^Ii       , Xu          , Xu          , Uu^Ii       , Xu          , Qxv         , Uu^Ii       , Ryd         , Ryd         , Xu          , Xu          , Xu          , Xu          , Uu^Ii       , Xu          , Xu          , Xu          , Xu          , Yl          , Xz          , Xz          , Yl          , Xu          , Xu          , Qxv         , Qxv         , Qxv         , Qxv         , Qxv         
Xu          , Xu          , Qxv         , Qxv         , Xu          , Qxv         , Xu          , Xu          , Ryd         , Xg^Zsw      , Xu          , Ryd         , Xg^Zse      , Xu          , Ryd         , Ryd         , Xg^Zse      , Xu          , Ryd         , Ryd         , Ryd         , Xu          , Xu          , Uu^Ii       , Ryd         , Xg^Zsw      , Xu          , Xu          , Xu          , Xu          , Xu          , Xz          , Yr          , Yl          , Rr          , Yrh         , Yr          , Uu^Vu       , Qxv         , Qxv         , Qxv         , Qxv         
Xu          , Qxv         , Xu          , Xu          , Qxv         , Xu          , Xu          , Uu^Ii       , Xu          , Xu          , Yrh         , Xu          , Xu          , Yr          , Ryd         , Xu          , Qxv         , Ryd         , Xu          , Xu          , Xu          , Ryd         , Ryd         , Ryd         , Xu          , Xg^Zse      , Ryd         , Xu          , Xu          , Xu          , Uu^Vu       , Yr          , Yl          , Ryd         , Ryd         , Yr          , Rr          , Ryd         , Yr          , Qxv         , Qxv         , Qxv         
Xu          , Xu          , Xu          , Xu          , Xu          , Qxv         , Qxv         , Xu          , Qxv         , Qxv         , Qxv         , Yr          , Ryd         , Ryd         , Ryd         , Xu          , Xu          , Xu          , Ryd         , Uu^Ii       , Xu          , Uu^Ii       , Xu          , Xu          , Xg^Zsw      , Ryd         , Xg^Zse      , Xu          , Xu          , Xu          , Yl          , Yrh         , Rr          , Rr          , Rr          , Yr          , Yl          , Ryd         , Rr          , Yl          , Qxv         , Qxv         
Xu          , Xu          , Yr          , Yr          , Yrh         , Xu          , Xu          , Qxv         , Xu          , Xu          , Xu          , Yr          , Ryd         , Rr          , Rr          , Ryd         , Ryd         , Ryd         , Xu          , Xg^Zse      , Uu^Ii       , Xu          , Xu          , Uu^Ii       , Xu          , Xu          , Xu          , Uu^Ii       , Xu          , Yr          , Rr          , Rr          , Rr          , Rr          , Rr          , Rr          , Rr          , Yr          , Yrh         , Yl          , Qxv         , Qxv         
Xu          , Yrh         , Rr          , Uu^Ii       , Yrh         , Qxv         , Qxv         , Xu          , Xu          , Uu^Ii       , Xg^Zse      , Xu          , Ryd         , Rr          , Rr          , Ryd         , Xu          , Xg^Zse      , Ryd         , Xu          , Xu          , Xu          , Xu          , Xu          , Ryd         , Yr          , Ryd         , Xu          , Yl          , Yr          , Rr          , Rr          , Rr          , Rr          , Rr          , Rr          , Rr          , Yr          , Ryd         , Rr          , Qxv         , Qxv         
Xu          , Yr          , Rr          , Yr          , Yr          , Qxv         , Qxv         , Qxv         , Xu          , Xu          , Ryd         , Ryd         , Xu          , Ryd         , Rr          , Ryd         , Ryd         , Xu          , Xu          , Uu^Ii       , Xu          , Xu          , Yrh         , Yr          , Ryd         , Ryd         , Ryd         , Ryd         , Ryd         , Yr          , Yrh         , Rr          , Rr          , Rr          , Rr          , Rr          , Ryd         , Yr          , Ryd         , Yr          , Qxv         , Qxv         
Xu          , Yr          , Rr          , Yrh         , Qxv         , Qxv         , Xu          , Xu          , Xg^Zsw      , Ryd         , Xg^Zse      , Xu          , Xu          , Ryd         , Ryd         , Rr          , Ryd         , Xu          , Xu          , Xu          , Qxv         , Qxv         , Yr          , Yr          , Qxv         , Qxv         , Xu          , Uu^Vu       , Xu          , Xu          , Yl          , Yr          , Yr          , Yl          , Yl          , Ryd         , Yrh         , Yl          , Ryd         , Rr          , Qxv         , Qxv         
Qxv         , Qxv         , Rr          , Qxv         , Qxv         , Qxv         , Xu          , Uu^Ii       , Xu          , Xu          , Xu          , Uu^Ii       , Xu          , Xu          , Xz          , Xz          , Xz          , Xu          , Xu          , Xu          , Ryd         , Yr          , Yr          , Yr          , Qxv         , Qxv         , Xu          , Xu          , Ryd         , Xu          , Xu          , Rr          , Yr          , Rr          , Ryd         , Rr          , Yr          , Rr          , Qxv         , Qxv         , Qxv         , Qxv         
Qxv         , Qxv         , Rr          , Qxv         , Qxv         , Qxv         , Qxv         , Xu          , Qxv         , Qxv         , Qxv         , Xu          , Xu          , Xu          , Ryd         , Rr          , Ryd         , Xu          , Xz          , Yr          , Ryd         , Yr          , Qxv         , Qxv         , Xu          , Xu          , Ryd         , Xg^Zsw      , Xu          , Xu          , Xu          , Xu          , Xu          , Qxv         , Qxv         , Qxv         , Qxv         , Qxv         , Qxv         , Qxv         , Qxv         , Qxv         
Qxv         , Qxv         , Rr          , Qxv         , Qxv         , Qxv         , Qxv         , Qxv         , Qxv         , Qxv         , Qxv         , Qxv         , Ryd         , Ryd         , Ryd         , Rr          , Rr          , Ryd         , Ryd         , Xz          , Xu          , Qxv         , Qxv         , Xu          , Ryd         , Xg^Zsw      , Xu          , Ryd         , Xg^Zse      , Xu          , Ryd         , Ryd         , Ryd         , Xu          , Xu          , Qxv         , Xu          , Qxv         , Xu          , Qxv         , Qxv         , Qxv         
Qxv         , Qxv         , Rr          , Ryd         , Ryd         , Qxv         , Ryd         , Qxv         , Rr          , Qxv         , Rr          , Qxv         , Qxv         , Ryd         , Rr          , Rr          , Ryd         , Rr          , Rr          , Ryd         , Xu          , Qxv         , Xu          , Xu          , Xu          , Xu          , Xu          , Xu          , Ryd         , Rr          , Rr          , Rr          , Rr          , Ryd         , Xu          , Xu          , Yrh         , Xu          , Qxv         , Xu          , Xu          , Qxv         
Qxv         , Qxv         , Qxv         , Rr          , Rr          , Ryd         , Rr          , Rr          , Xu          , Rr          , Xu          , Rr          , Rr          , Rr          , Xu          , Xu          , Xu          , Ryd         , Rr          , Ryd         , Uu^Vu       , Xu          , Xu          , Xu          , Yr          , Xu          , Xu          , Xu          , Ryd         , Rr          , Rr          , Rr          , Rr          , Ryd         , Xu          , Yrh         , Zw          , Yrh         , Qxv         , Qxv         , Qxv         , Xu          
Qxv         , Qxv         , Qxv         , Qxv         , Rr          , Rr          , Xu          , Ryd         , Uu^Vu       , Xu          , Xu          , Xu          , Xu          , Xu          , Xu          , Xu          , Xu          , Ryd         , Ryd         , Rr          , Ryd         , Xu          , Zw          , Zw          , Xu          , Xu          , Xu          , Ryd         , Ryd         , Rr          , Rr          , Rr          , Ryd         , Ryd         , Xu          , Xu          , Yr          , Zw          , Qxv         , Qxv         , Yrh         , Qxv         
Qxv         , Qxv         , Qxv         , Rr          , Ryd         , Ryd         , Xu          , Xu          , Xu          , Xu          , Ryd         , Xu          , Ryd         , Xu          , Uu^Vu       , Xu          , Ryd         , Xu          , Ryd         , Rr          , Ryd         , Yr          , Yr          , Zw          , Yr          , Xu          , Xu          , Ryd         , Ryd         , Rr          , Rr          , Rr          , Ryd         , Xu          , Yrh         , Xu          , Yr          , Yr          , Yr          , Zw          , Qxv         , Qxv         
Qxv         , Qxv         , Ryd         , Rr          , Xu          , Xu          , Xu          , Xu          , Ryd         , Ryd         , Rr          , Ryd         , Rr          , Ryd         , Rr          , Ryd         , Rr          , Ryd         , Ryd         , Rr          , Ryd         , Yr          , Qxv         , Xu          , Xu          , Xu          , Xu          , Xu          , Xu          , Ryd         , Rr          , Ryd         , Ryd         , Xu          , Qxv         , Zw          , Yr          , Rr          , Rr          , Yr          , Qxv         , Qxv         
Qxv         , Qxv         , Ryd         , Rr          , Qxv         , Xu          , Xu          , Ryd         , Rr          , Rr          , Ryd         , Rr          , Ryd         , Rr          , Ryd         , Rr          , Ryd         , Rr          , Rr          , Rr          , Ryd         , Yr          , Qxv         , Qxv         , Xu          , Xu          , Xu          , Xu          , Uu^Vu       , Ryd         , Rr          , Ryd         , Xu          , Xu          , Qxv         , Qxv         , Uu^Vu       , Ryd         , Rr          , Ryd         , Qxv         , Qxv         
Qxv         , Qxv         , Ryd         , Rr          , Qxv         , Qxv         , Qxv         , Ryd         , Rr          , Ryd         , Qxv         , Ryd         , Qxv         , Ryd         , Xu          , Ryd         , Xu          , Ryd         , Ryd         , Ryd         , Xu          , Qxv         , Qxv         , Qxv         , Xu          , Xu          , Xu          , Xu          , Xu          , Ryd         , Rr          , Ryd         , Xu          , Qxv         , Qxv         , Qxv         , Qxv         , Ryd         , Rr          , Ryd         , Qxv         , Qxv         
Xu          , Qxv         , Ryd         , Rr          , Qxv         , Qxv         , Qxv         , Ryd         , Rr          , Ryd         , Qxv         , Qxv         , Qxv         , Qxv         , Qxv         , Xu          , Xu          , Xu          , Xu          , Xu          , Xu          , Qxv         , Qxv         , Xu          , Xu          , Yrh         , Zw          , Xu          , Xu          , Ryd         , Rr          , Ryd         , Ryd         , Xu          , Xu          , Qxv         , Xu          , Xu          , Xg^Zsw      , Ryd         , Qxv         , Qxv         
Xu          , Xu          , Ryd         , Rr          , Ryd         , Qxv         , Ryd         , Ryd         , Rr          , Ryd         , Ryd         , Qxv         , Ryd         , Qxv         , Ryd         , Qxv         , Uu^Vu       , Xu          , Xu          , Xu          , Xu          , Xu          , Xu          , Xu          , Xu          , Xu          , Xu          , Xg^Zse      , Ryd         , Ryd         , Rr          , Rr          , Rr          , Ryd         , Xg^Zse      , Xu          , Ryd         , Ryd         , Rr          , Xg^Zsw      , Xu          , Qxv         
Qxv         , Xu          , Ryd         , Rr          , Rr          , Ryd         , Rr          , Rr          , Rr          , Rr          , Rr          , Ryd         , Rr          , Ryd         , Rr          , Ryd         , Rr          , Ryd         , Ryd         , Xu          , Xu          , Yrh         , Zw          , Xu          , Xu          , Xu          , Ryd         , Ryd         , Rr          , Rr          , Ryd         , Ryd         , Xg^Zse      , Xg^Zse      , Rr          , Ce          , Ryd         , Ryd         , Rr          , Ce          , Ryd         , Xu          
Xu          , Qxv         , Ryd         , Rr          , Rr          , Rr          , Rr          , Rr          , Rr          , Rr          , Rr          , Rr          , Rr          , Rr          , Rr          , Rr          , Rr          , Rr          , Ryd         , Xu          , Xu          , Xu          , Xu          , Xg^Zse      , Ryd         , Ryd         , Rr          , Rr          , Ryd         , Ryd         , Xu          , Xu          , Xu          , Ryd         , Ryd         , Rr          , Rr          , 1 Ryd       , Rr          , Ryd         , Ryd         , Ryd         
Xu          , Xu          , Uu^Vu       , Rr          , Rr          , Rr          , Rr          , Rr          , Rr          , Rr          , Rr          , Rr          , Rr          , Rr          , Rr          , Rr          , Rr          , Rr          , Rr          , Ryd         , Xu          , Xu          , Ryd         , Ryd         , Rr          , Rr          , Ryd         , Ryd         , Xg^Zse      , Xu          , Xu          , Xu          , Xu          , Uu^Vu       , Ryd         , Ryd         , Ce          , Rr          , Rr          , Ce          , Rr          , Rr          
Xu          , Xu          , Ryd         , Rr          , Rr          , Rr          , Rr          , Rr          , Rr          , Rr          , Rr          , Rr          , Rr          , Rr          , Rr          , Rr          , Rr          , Rr          , Rr          , Ryd         , Ryd         , Ryd         , Rr          , Rr          , Ryd         , Ryd         , Xu          , Xu          , Xu          , Zw          , Yrh         , Xu          , Xu          , Xu          , Xu          , Ryd         , Ryd         , Ryd         , Ryd         , Rr          , Rr          , Rr          
Qxv         , Xu          , Ryd         , Rr          , Rr          , Rr          , Rr          , Rr          , Rr          , Rr          , Rr          , Rr          , Rr          , Rr          , Rr          , Rr          , Rr          , Rr          , Rr          , Rr          , Rr          , Rr          , Ryd         , Ryd         , Xu          , Xg^Zse      , Zw          , Xu          , Xu          , Xu          , Xu          , Xu          , Xu          , Xu          , Xu          , Xu          , Ryd         , Ryd         , Ryd         , Ryd         , Rr          , Rr          
Qxv         , Qxv         , Ryd         , Rr          , Rr          , Rr          , Rr          , Rr          , Rr          , Rr          , Rr          , Rr          , Rr          , Rr          , Rr          , Rr          , Rr          , Rr          , Rr          , Rr          , Ryd         , Ryd         , Xu          , Xu          , Xu          , Xu          , Xu          , Yrh         , Xu          , Xu          , Yr          , Uu^Vu       , Yrh         , Xu          , Xu          , Xu          , Xu          , Ryd         , Ryd         , Ryd         , Ryd         , Rr          
Qxv         , Qxv         , Ryd         , Rr          , Rr          , Rr          , Rr          , Rr          , Rr          , Rr          , Rr          , Rr          , Rr          , Rr          , Rr          , Rr          , Rr          , Rr          , Rr          , Ryd         , Xu          , Xu          , Xu          , Xu          , Xu          , Xu          , Xu          , Xu          , Yr          , Yr          , Yr          , Yr          , Xu          , Xg^Zse      , Yr          , Xu          , Qxv         , Xu          , Xu          , Ryd         , Xu          , Ryd         
Xu          , Qxv         , Ryd         , Rr          , Rr          , Rr          , Rr          , Rr          , Rr          , Rr          , Rr          , Rr          , Rr          , Rr          , Rr          , Rr          , Rr          , Rr          , Rr          , Ryd         , Ryd         , Xu          , Ryd         , Xu          , Xg^Zse      , Xu          , Ryd         , Xg^Zsw      , Xg^Zsw      , Yr          , Xu          , Xu          , Qxv         , Xu          , Xu          , Xu          , Uu^Vu       , Qxv         , Qxv         , Xu          , Qxv         , Xu          
Xu          , Qxv         , Ryd         , Rr          , Rr          , Rr          , Rr          , Rr          , Rr          , Rr          , Rr          , Rr          , Rr          , Rr          , Rr          , Rr          , Rr          , Rr          , Rr          , Rr          , Ryd         , Ryd         , Xg^Zse      , Xg^Zse      , Ryd         , Ryd         , Ryd         , Ryd         , Xg^Zse      , Xu          , Yrh         , Qxv         , Yr          , Qxv         , Yr          , Yrh         , Zw          , Qxv         , Qxv         , Qxv         , Qxv         , Qxv         
Xu          , Xu          , Ryd         , Rr          , Rr          , Rr          , Rr          , Rr          , Rr          , Rr          , Rr          , Rr          , Rr          , Rr          , Rr          , Rr          , Rr          , Rr          , Rr          , Ryd         , Xu          , Xg^Zse      , Xu          , Ryd         , Xu          , Ryd         , Xu          , Xg^Zse      , Ryd         , Ryd         , Ryd         , Yr          , Yrh         , Yr          , Yr          , Yr          , Zw          , Yrh         , Yr          , Qxv         , Qxv         , Qxv         
Qxv         , Qxv         , Ryd         , Ryd         , Ryd         , Ryd         , Uu^Vu       , Ryd         , Ryd         , Ryd         , Ryd         , Ryd         , Ryd         , Ryd         , Ryd         , Ryd         , Uu^Vu       , Ryd         , Ryd         , Ryd         , Xu          , Xu          , Qxv         , Xu          , Qxv         , Xu          , Qxv         , Qxv         , Qxv         , Zw          , Zw          , Ryd         , Zw          , Zw          , Zw          , Zw          , Yrh         , Zw          , Zw          , Zw          , Yrh         , Qxv         
Qxv         , Qxv         , Xu          , Xu          , Xu          , Xu          , Xu          , Xu          , Xu          , Xu          , Xu          , Xu          , Xu          , Xu          , Xu          , Xu          , Xu          , Xu          , Xu          , Xu          , Qxv         , Qxv         , Qxv         , Qxv         , Qxv         , Qxv         , Qxv         , Qxv         , Qxv         , Yr          , Yrh         , Zw          , Zw          , Zw          , Zw          , Zw          , Zw          , Zw          , Yr          , Yr          , Yr          , Yr          
