border_size=1
usage=map

Xu          , Xu          , Xu          , Xu          , Xu          , Xu          , Xu          , Xu          , Ql          , Xos         , Xos         , Xu          , Xu          , Xu          , Xu          , Xu          , Xu          , Xu          , Xu          , Xu          , Xu          , Xu          , Xu          , Xu          , Xu          , Xu          , Xu          , Xu          , Xu          , Xu          , Xu          , Xu          , Xu          , Xu          , Xu          , Xu          , Xu          , Xu          , Xu          , Xu          , Xu          , Xu          , Xu          , Xu          , Wo          , Wo          , Wo          , Wo          , Wo          , Xu          , Xu          , Xu          , Xu          
Xu          , Xu          , Xu          , Xu          , Xu          , Xu          , Xu          , Xos         , Xos         , Ql^Xo       , Ql          , Xos         , Xos         , Xu          , Xu          , Xu          , Xu          , Xu          , Xu          , Xu          , Xu          , Xu          , Xu          , Xu          , Xu          , Xu          , Xu          , Xu          , Xu          , Xu          , Xos         , Xu          , Xu          , Xu          , Xu          , Xu          , Xu          , Xu          , Xu          , Xu          , Xu          , Xu          , Xu          , Xu          , Xu          , Wo          , Wo          , Wo          , Wo          , Xu          , Xu          , Xu          , Xu          
Xu          , Xu          , Xu          , Xu          , Xu          , Xu          , Xu          , Xu          , Xos         , Xos         , Xos         , Ql          , Ql          , Xos         , Xos         , Xu          , Xu          , Xu          , Xu          , Xu          , Xu          , Xu          , Xu          , Xu          , Xu          , Xu          , Xu          , Xu          , Xos         , Xos         , Xos         , Xos         , Xos         , Xu          , Xu          , Xu          , Xu          , Xu          , Xu          , Xu          , Xos         , Xu          , Xos         , Xu          , Xu          , Xu          , Wo          , Wo          , Wo          , Wo          , Xu          , Xu          , Xu          
Xos         , Xu          , Xu          , Xu          , Xu          , Xu          , Xos         , Xos         , Xos         , Xos         , Xos         , Yhr^Xp      , Uh          , Ql          , Ql          , Xos         , Xos         , Xu          , Xu          , Xu          , Xu          , Xu          , Xu          , Xu          , Xu          , Xu          , Xos         , Xos         , Yhr^Xp      , Yhr^Xp      , Xos         , Xos         , Xos         , Xos         , Xos         , Xu          , Xu          , Xu          , Xu          , Xu          , Xos         , Ur          , Ur          , Xos         , Xu          , Xu          , Wo          , Wo          , Wo          , Wo          , Xu          , Xu          , Xu          
Xos         , Xos         , Xos         , Xu          , Xos         , Xos         , Xos         , Xos         , Xos         , Xos         , Yhr^Xp      , Xos         , Uh          , Uh          , Yhr^Xp      , Ql          , Ql          , Xos         , Xos         , Xu          , Xu          , Xu          , Xu          , Xu          , Xos         , Xos         , Yhr^Xp      , Yhr^Xp      , Xos         , Xos         , Yhr^Xp      , Yhr^Xp      , Xos         , Xos         , Xos         , Xos         , Xos         , Xu          , Xu          , Xu          , Xos         , Xos         , Ur          , Xos         , Xu          , Xu          , Xu          , Wo          , Wo          , Wo          , Wo          , Xu          , Xu          
Xu          , Xos         , Xos         , Xos         , Xos         , Xos         , Xos         , Xos         , Xu          , Xos         , Xu          , Uh          , Uh          , Xos         , Xos         , Xos         , Xos         , Ql^Xo       , Ql          , Xos         , Xos         , Xu          , Xos         , Xos         , Ql^Bs/      , Yhr^Xp      , Xos         , Xos         , Yhr^Xp      , Yhr^Xp      , Xos         , Xos         , Yhr^Xp      , Yhr^Xp      , Xos         , Xos         , Xos         , Xos         , Xos         , Xu          , Xos         , Ur          , Xos         , Xos         , Xu          , Xu          , Xu          , Xu          , Wo          , Wo          , Wo          , Xu          , Xu          
Qxv         , Xu          , Xu          , Xos         , Xos         , Xos         , Xos         , Xu          , Uh          , Uh          , Uh          , Uh          , Xos         , Yhr^Xp      , Xos         , Xos         , Xos         , Xos         , Xos         , Xu          , Xu          , Xos         , Xos         , Yhr^Xp      , Yhr^Xp      , Ql          , Ql^Bs/      , Yhr^Xp      , Xos         , Xos         , Yhr^Xp      , Yhr^Xp      , Xos         , Xos         , Yhr^Xp      , Yhr^Xp      , Xos         , Xos         , Xos         , Xos         , Xos         , Ur          , Ur          , Xos         , Xu          , Xu          , Xu          , Xu          , Wo          , Wo          , Wo          , Wo          , Xu          
Qxv         , Qxv         , Qxv         , Qxv         , Xu          , Xos         , Xos         , Uh          , Urb         , Uh          , Xos         , Yhr^Xp      , Xos         , Xos         , Xos         , Xos         , Xos         , Xos         , Xos         , Xu          , Xu          , Xu          , Xos         , Xos         , Yhr^Xo      , Yhr^Xp      , Yhr^Xp      , Ql          , Ql^Bs/      , Yhr^Xp      , Xos         , Xos         , Yhr^Xp      , Yhr^Xp      , Xos         , Xos         , Yhr^Xp      , Yhr^Xp      , Xos         , Xos         , Xos         , Xos         , Ur^Z/       , Xos         , Xu          , Xu          , Xu          , Xu          , Wo          , Wo          , Wo          , Xu          , Xu          
Qxv         , Qxv         , Qxv         , Qxv         , Xu          , Xu          , Uu          , Urb         , Urb         , Xol         , Xol         , Xos         , Xos         , Xos         , Ss          , Yhr^Xp      , Yhr^Xp      , Xos         , Xos         , Xos         , Xos         , Xos         , Yhr^Xp      , Yhr^Xp      , Xos         , Xos         , Yhr^Xo      , Yhr^Xp      , Yhr^Xp      , Ql          , Ql^Bs/      , Yhr^Xp      , Xos         , Xos         , Yhr^Xp      , Yhr^Xp      , Xos         , Xos         , Yhr^Xp      , Yhr^Xp      , Xos         , Xos         , Ur          , Xos         , Xu          , Xu          , Wo          , Wo^Xo       , Wo^Xo       , Wo          , Wo          , Xu          , Xu          
Qxv         , Qxv         , Uh          , Uh          , Uu          , Uu          , Uu          , Urb         , Urb         , Urb         , Urb         , Xos         , Xol         , Ss          , Ss          , Ss          , Ss          , Yhr^Xp      , Yhr^Xp      , Xos         , Xos         , Yhr^Xp      , Xos         , Xos         , Yhr^Xp      , Yhr^Xp      , Xos         , Xos         , Yhr^Xo      , Yhr^Xp      , Yhr^Xp      , Ql          , Ql^Bs/      , Yhr^Xp      , Xos         , Xos         , Yhr^Xp      , Yhr^Xp      , Xos         , Xos         , Xos         , Uu^Uf       , Uu          , Xu          , Wwf         , Wo          , Wo          , Wo          , Wo          , Wo^Xo       , Xu          , Xu          , Xu          
Uh          , Uu          , Uu          , Uu          , Uu          , Uu          , Urb         , Urb         , Uu          , Urb         , Urb^Z/      , Urb^Z/      , Urb         , Xol         , Uu          , Ss          , Ss          , Ss          , Xos         , Xos         , Xu          , Xu          , Xu          , Yhr^Xp      , Xos         , Xos         , Yhr^Xp      , Yhr^Xp      , Xos         , Xos         , Yhr^Xo      , Yhr^Xp      , Yhr^Xp      , Ql          , Ql^Bs/      , Yhr^Xp      , Xos         , Xos         , Xos         , Xos         , Xu          , Uh          , Wwf         , Ww          , Ww          , Wo          , Ww          , Ww          , Wo          , Wo          , Xu          , Xu          , Xu          
Uu          , Uu          , Urb         , Urb         , Urb         , 1 Urb       , Uu          , Uu          , Uh          , Xos         , Xos         , Urb         , Urb         , Uu          , Uu          , Xos         , Xos         , Xos         , Xu          , Xu          , Xu          , Xu          , Xu          , Uh          , Uh          , Yhr^Xp      , Xos         , Xos         , Yhr^Xp      , Yhr^Xp      , Xos         , Xos         , Yhr^Xo      , Yhr^Xp      , Yhr^Xp      , Ql          , Ql          , Xos         , Xos         , Xu          , Wo          , Ww          , Ww          , Wwf         , Ww          , Ww          , Wwf         , Ww          , Xu          , Xu          , Xos         , Xu          , Xu          
Urb         , Urb         , Uu          , Uu          , Uu          , Uu          , Uu          , Uu          , Uu^Xp       , Xol         , Xol         , Uu          , Uu          , Urb         , Urb         , Uu          , Xos         , Xu          , Xu          , Xu          , Xu          , Xu          , Uu^Dr       , Uu^Uf       , Uu          , Uu          , Uh          , Yhr^Xp      , Xos         , Xos         , Yhr^Xp      , Yhr^Xp      , Xos         , Xos         , Xos         , Yhr^Xp      , Xos         , Xos         , Xos         , Wo          , Ww          , Ww          , Wwf         , Ww          , Wwf         , Uu          , Uu          , Xu          , Xu          , Xos         , Xos         , Xos         , Xos         
Uu          , Uu          , Xu          , Uu          , Uh          , Uu          , Uh          , Uu          , Uu          , Uh          , Xu          , Xos         , Xos         , Uu          , Urb         , Urb         , Xos         , Xu          , Xu          , Xu          , Xu          , Uu^Uf       , Uh          , Uu          , Ur          , Uu          , Uu          , Uh          , Uu          , Yhr^Xp      , Xos         , Xos         , Xos         , Xos         , Xos         , Xos         , Xos         , Xos         , Wo          , Ww          , Ww          , Wo          , Xu          , Ww          , Wwf         , Uu          , Uu          , Xu          , Uh          , Uh          , Uh          , Xu          , Xos         
Xu          , Xu          , Xu          , Uh          , Xu          , Uh          , Xu          , Uh          , Uh^Xp       , Uh          , Xu          , Xu          , Xos         , Xos         , Xos         , Urb^Z/      , Urb         , Xu          , Uu          , Uh          , Uu          , Uh          , Ur          , Ur          , Uh          , Uu          , Uu          , Urb         , Urb         , Uh          , Uh          , Xos         , Xos         , Xos         , Uh          , Ww          , Wo          , Ww          , Wo          , Wo          , Ww          , Xu          , Xos         , Xu          , Uu^Uf       , Uu          , Uu          , Uu          , Uu          , Uu^Uf       , Uu^Uf       , Uh          , Xu          
Xu          , Xu          , Xu          , Yhr^Xp      , Xu          , Yhr^Xp      , Xu          , Xu          , Ql          , Ql          , Xu          , Xos         , Ql          , Xu          , Xu          , Urb         , Ur          , Ur          , Ur          , Uu          , Ur          , Uu          , Uu          , Uu          , Xu          , Xu          , Xu          , Uu          , Uh          , Urb         , Urb         , Uu^Uf       , Uu          , Uh          , Urb         , Ww          , Ww          , Ww          , Ww          , Ww          , Xu          , Xu          , Xos         , Uh          , Uh          , Xu          , Uu          , Uu^Ii       , Uu          , Uu^Uf       , Xu          , Uh          , Xu          
Xu          , Xu          , Xu          , Xos         , Xu          , Xos         , Xos         , Xu          , Ql          , Ql          , Ql          , Xu          , Xu          , Ql^Xo       , Ql          , Uu          , Uu          , Ur          , Uu          , Uu          , Uh          , Uh          , Xu          , Ql          , Ql^Xo       , Xu          , Xu          , Xos         , Xos         , Xu          , Xu          , Uu          , Urb         , Urb         , Uh          , Wo          , Wo          , Ww          , Wo          , Xu          , Xu          , Xu          , Xu          , Xu          , Uh          , Uu^Uf       , Uu^Uf       , Uu          , Uu^Uf       , Uh          , Uh          , Uh          , Xu          
Xu          , Xu          , Xu          , Xos         , Xos         , Xos         , Ql^Xo       , Ql          , Ql          , Xu          , Xu          , Ql^Xo       , Ql          , Xu          , Xos         , Xu          , Xu          , Uh          , Xu          , Xu          , Ql          , Xu          , Xu          , Xu          , Xu          , Ql          , Xos         , Xos         , Xu          , Xos         , Xos         , Uu^Uf       , Urb         , Uu          , Xu          , Xu          , Wo          , Ww          , Ww          , Xu          , Xu          , Xu          , Xu          , Xu          , Xu          , Uh          , Uh          , Uh          , Uh          , Xu          , Xu          , Xu          , Xu          
Xu          , Xu          , Xos         , Xos         , Ql          , Ql          , Xu          , Xu          , Ql^Xo       , Xu          , Xu          , Xu          , Xu          , Xos         , Ql          , Xu          , Xu          , Ql          , Xu          , Xu          , Xu          , Ql^Xo       , Ql          , Xu          , Xos         , Xos         , Xu          , Xu          , Xu          , Xos         , Xos         , Uh          , Uu^Uf       , Uu^Uf       , Uh          , Xu          , Wo          , Ww          , Wo          , Wo          , Xu          , Xu          , Xu          , Xu          , Xu          , Uh          , Xu          , Xu          , Xu          , Uh          , Xos         , Xos         , Xu          
Xu          , Xu          , Xos         , Ql          , Xu          , Xu          , Xu          , Xu          , Ql          , Xu          , Xu          , Xu          , Xu          , Xu          , Ql          , Xu          , Xu          , Ql^Xo       , Xu          , Xu          , Xu          , Xu          , Xos         , Xos         , Xu          , Xu          , Xu          , Xu          , Xu          , Xu          , Xu          , Xu          , Uh          , Urb         , Uzw         , Xu          , Xu          , Wo          , Wo^Xo       , Wo^Xo       , Wo          , Xu          , Xu          , Xu          , Xu          , Xos         , Xu          , Xu          , Xu          , Xos         , Xu          , Xu          , Xu          
Xu          , Xu          , Ql          , Xu          , Xu          , Xu          , Xu          , Xu          , Xos         , Xu          , Xu          , Xu          , Xu          , Xu          , Ql          , Xu          , Xu          , Ql          , Xu          , Xu          , Xu          , Xu          , Xos         , Xos         , Xu          , Xu          , Uu^Cd       , Uu^Cd       , Uu^Cd       , Xu          , Xu          , Xu          , Urb^Z\      , Urb         , Uzw         , Xu          , Xu          , Wo^Xo       , Wo          , Wo          , Wo          , Wo          , Wo          , Xu          , Xu          , Xu          , Xu          , Xu          , Xu          , Xu          , Xu          , Xu          , Xu          
Xu          , Xu          , Ql          , Xu          , Xu          , Xu          , Xu          , Xu          , Ql          , Xu          , Xu          , Xu          , Xu          , Xu          , Xu          , Ql          , Xu          , Xos         , Xu          , Xu          , Xos         , Xos         , Xu          , Yhr         , Yhr^Xo      , Xu          , Xu          , Uu^Cd       , Uzw         , Uzw         , Uzw         , Uzw         , Urb         , Urb^Z\      , Xu          , Xu          , Xu          , Xu          , Wo          , Wo          , Wo          , Wo          , Wo          , Xu          , Xu          , Xu          , Xu          , Xu          , Xu          , Xu          , Xu          , Xu          , Xu          
Xu          , Xu          , Ql          , Ql          , Ql          , Xu          , Xu          , Xu          , Ql          , Xu          , Xu          , Xu          , Xu          , Xu          , Ql          , Ql          , Ql          , Ql          , Xu          , Xos         , Yhr         , Xu          , Xu          , Xu          , Xu          , Yhr^Xp      , Yhr^Xp      , Xu          , Uzw         , Uzw         , Urb         , Urb         , Uzw         , Xu          , Xu          , Xu          , Xu          , Xu          , Xu          , Wo          , Wo          , Wo          , Wo          , Xu          , Xu          , Xu          , Xu          , Xu          , Xu          , Xu          , Xu          , Xu          , Xu          
Ql          , Xu          , Ql          , Ql          , Ql          , Ql          , Ql          , Ql          , Xos         , Ql          , Ql          , Ql^Xo       , Ql          , Ql          , Ql          , Ql          , Ql          , Ql          , Xu          , Xu          , Xu          , Yhr^Xo      , Yhr^Xp      , Xu          , Yhr^Xp      , Yhr         , Uzw         , Uzw         , Urb         , Urb         , Xu          , Uzw         , Uu^Cd       , Uu^Cd       , Uu^Cd       , Xu          , Xu          , Xu          , Xu          , Wo          , Wo          , Wo          , Wo          , Wo          , Wo          , Xu          , Xu          , Xu          , Xu          , Xu          , Xu          , Xu          , Xu          
Ql          , Ql          , Ql          , Ql          , Ql          , Ql          , Xos         , Xos         , Xos         , Ql^Xo       , Ql^Xo       , Xu          , Xu          , Xu          , Ql          , Ql          , Ql          , Xu          , Xu          , Xu          , Xu          , Xu          , Xu          , Yhr         , Uzw         , Uzw         , Urb         , Urb         , Uzw         , Uzw         , Yhr^Xp      , Xu          , Xu          , Uu^Cd       , Xu          , Xu          , Xu          , Xu          , Xu          , Xu          , Wo          , Wo          , Wo          , Wo          , Wo          , Xu          , Xu          , Xu          , Xu          , Xu          , Xu          , Xu          , Xu          
Xu          , Xu          , Xu          , Ql          , Ql^Xo       , Xos         , Xos         , Xos         , Xos         , Ql          , Ql          , Xu          , Xu          , Xu          , Xu          , Ql          , Ql          , Ql          , Xu          , Xu          , Xu          , Xu          , Uzw         , Uzw         , Urb         , Urb         , Uzw         , Uzw         , Yhr         , Yhr^Xp      , Xu          , Yhr^Xp      , Yhr^Xo      , Xu          , Xu          , Xu          , Xu          , Xu          , Xu          , Xu          , Xu          , Wo          , Wo          , Wo          , Wo          , Wo          , Xu          , Xu          , Xu          , Xu          , Xu          , Xu          , Xu          
Xu          , Xu          , Xu          , Ql^Xo       , Ql          , Ql          , Xos         , Xos         , Ql          , Ql          , Xu          , Xu          , Xu          , Xu          , Uh          , Xu          , Uu          , Ql          , Uu          , Uu          , Cud         , Uzw         , Urb         , Urb         , Uzw         , Uzw         , Xu          , Yhr^Xp      , Yhr^Xp      , Xu          , Xu          , Xu          , Xu          , Yhr         , Xos         , Xos         , Xu          , Xu          , Xu          , Xu          , Xu          , Xu          , Wo          , Wo          , Wo          , Wo          , Wo          , Xu          , Xu          , Xu          , Xu          , Xu          , Xu          
Xu          , Xu          , Xu          , Xu          , Xu          , Ql          , Ql          , Xos         , Xos         , Ql          , Xu          , Xu          , Uh          , Xu          , Uh          , Uh          , Cud         , Uu          , Uu          , Uh          , Urb         , Urb         , Urb         , Uzw         , Xu          , Xu          , Xu          , Xu          , Xu          , Yhr^Xo      , Yhr         , Xu          , Xos         , Xos         , Xu          , Xu          , Xu          , Xu          , Xu          , Xu          , Xu          , Xu          , Xu          , Wo          , Wo          , Wo          , Wo          , Xu          , Xu          , Xu          , Xu          , Xu          , Xu          
Xu          , Xu          , Xu          , Xu          , Xu          , Xu          , Ql          , Ql          , Ql          , Ql          , Xu          , Uu          , Uh          , Uh          , Uh          , Uu^Uf       , Uu          , Uu          , Urb         , Urb         , Uu          , Uu          , Urb         , Cud         , Uu          , Xu          , Yhl^Xp      , Xu          , Xu          , Xu          , Xos         , Xos         , Xos         , Xos         , Xos         , Xu          , Xu          , Xu          , Xu          , Xu          , Xu          , Xu          , Xu          , Wo          , Wo          , Wo          , Wo          , Wo          , Wo          , Xu          , Xu          , Xu          , Xu          
Xu          , Xu          , Xu          , Xu          , Ql          , Ql          , Ql          , Ql          , Uu          , Uu          , Uu          , Uu          , Uu          , Uu^Uf       , Yhl^Xp      , Yhl^Xp      , Uh          , Uu          , Uu          , Uu          , Uh          , Uu          , Uu          , Uu          , Uh          , Yhl         , Yhl^Xp      , Uu^Uf       , Xu          , Xos         , Xu          , Xu          , Xu          , Xu          , Yhr         , Xos         , Xos         , Xu          , Xu          , Xu          , Xu          , Xu          , Xu          , Xu          , Wo          , Wo          , Wo          , Wo          , Wo          , Wo          , Wo          , Xu          , Xu          
Ql          , Xu          , Ql          , Xu          , Ql          , Ql          , Xu          , Ql          , Uu          , Uu          , Uh          , Uu          , Uu          , Ur          , Ur          , Yhl^Xp      , Yhl^Xp      , Uu^Uf       , Xu          , Uu^Uf       , Cud         , Uh          , Uu^Uf       , Uu          , Yhl^Xp      , Uh          , Cud         , Uu^Uf       , Xu          , Xos         , Xu          , Xu          , Yhr^Xp      , Yhr^Xo      , Xu          , Xu          , Xos         , Xos         , Xos         , Xu          , Xu          , Xu          , Xu          , Xu          , Xu          , Wo          , Xu          , Wo          , Wo          , Wo          , Wo          , Xu          , Xu          
Ql          , Ql          , Ql          , Ql          , Ql          , Xu          , Xu          , Xu          , Uu          , Uu          , Uu^Uf       , Uu^Uf       , Yhl^Xp      , Ur          , Uu          , Ur          , Ur          , Xu          , Xu          , Xu          , Uh          , Uu^Uf       , Uu^Uf       , Uu          , Ur          , Yhl         , Uh          , Uh          , Yhl^Xp      , Uh          , Uu^Uf       , Yhr         , Xu          , Xu          , Xos         , Xos         , Xos         , Xos         , Xos         , Xos         , Xu          , Xu          , Xu          , Xu          , Xu          , Xu          , Xu          , Wo          , Wo          , Wo          , Wo          , Xu          , Xu          
Xu          , Xu          , Xu          , Ql          , Ql          , Xu          , Xu          , Xu          , Xu          , Uh          , Uh          , Uu^Uf       , Yhl         , Uh          , Uh          , Uu          , Ur          , Uu^Uf       , Xu          , Uu^Uf       , Uu          , Uu^Uf       , Cud         , Cud         , Cud         , Ur          , Uu          , Uh          , Uu          , Yhl^Xp      , Uh          , Xu          , Xos         , Xos         , Xos         , Xos         , Xos         , Xos         , Xu          , Xu          , Xu          , Xu          , Xu          , Xu          , Xu          , Xu          , Xu          , Wo          , Wo          , Wo          , Wo          , Xu          , Xu          
Ql          , Xu          , Ql          , Ql          , Ql          , Xu          , Ql          , Xu          , Xu          , Uh          , Uu          , Uh          , Uu          , Uh          , Uh          , Uu^Uf       , Ur          , Yhl^Xp      , Yhl^Xp      , Xu          , Uu          , Uu          , Cud         , Kud         , Cud         , Urb         , Urb         , Urb         , Urb         , Uu          , Uu          , Xu          , Xol         , Xos         , Xos         , Xos         , Xu          , Xu          , Xu          , Xu          , Xu          , Xu          , Xu          , Xu          , Xu          , Xu          , Wo          , Wo          , Wo          , Wo          , Xu          , Xu          , Xu          
Ql          , Ql          , Ql          , Ql          , Ql          , Ql          , Ql          , Ql          , Ql          , Ql          , Ql          , Uu          , Uh          , Uu          , Uu          , Uu          , Uu          , Yhl^Xp      , Uu^Uf       , Uh          , Uu^Uf       , Uu^Uf       , Uu          , Cud         , Uu          , Uu          , Uh          , Uu          , Uu          , Urb         , Urb^Z/      , Uu^Z/       , Uu          , Xol         , Qxv         , Qxv         , Qxv         , Xu          , Xu          , Xu          , Xu          , Xu          , Xu          , Xu          , Xu          , Wo          , Wo          , Wo          , Wo          , Wo          , Xu          , Xu          , Xu          
Xu          , Xu          , Xu          , Xu          , Ql          , Xu          , Xu          , Ql          , Xu          , Ql          , Ur          , Uh          , Uh          , Uu          , Xu          , Xu          , Uh          , Uu          , Uu          , Cud         , Uh          , Uu^Uf       , Uu          , Uu          , Xu          , Xu          , Xu          , Xu          , Xol         , Uu^Z/       , Uu          , Urb         , Urb         , Uu          , Uu          , Qxv         , Qxv         , Qxv         , Qxv         , Xu          , Xu          , Xu          , Xu          , Xu          , Xu          , Wo          , Wo          , Wo          , Xu          , Xu          , Xu          , Xu          , Xu          
Xu          , Xu          , Ql          , Ql          , Ql          , Ql          , Ql          , Ql          , Ql          , Ql          , Ql          , Uh          , Uh          , Uh          , Uh          , Xu          , Xu          , Uh          , Uh          , Uh          , Uh          , Uh          , Uu          , Uu          , Xu          , Ql          , Ql          , Xos         , Xos         , Xol         , Qxv         , Uu          , Uu          , Urb         , Urb         , Uu          , Uu          , Qxv         , Qxv^Xo      , Qxv^Xo      , Qxv         , Xu          , Xu          , Xu          , Xu          , Wo          , Wo          , Wo          , Wo          , Xu          , Xu          , Xu          , Xu          
Xu          , Xu          , Ql          , Xu          , Ql          , Ql          , Ql          , Ql          , Ql          , Ql          , Xu          , Ql          , Ql          , Ql          , Xu          , Xu          , Ql          , Uh          , Ql          , Uh          , Ql          , Uh          , Ql          , Ql          , Uh          , Ql          , Ql          , Xos         , Xu          , Qxv         , Qxv         , Qxv         , Qxv         , Uu          , Uu          , Urb         , Urb^Xo      , Uu^Xo       , Uu          , Qxv         , Xu          , Xu          , Xu          , Xu          , Xu          , Wo          , Wo          , Wo          , Wo          , Xu          , Xu          , Xu          , Xu          
Xu          , Xu          , Ql          , Xu          , Ql          , Ql          , Xu          , Xu          , Xu          , Ql          , Ql          , Ql          , Ql          , Xu          , Ql          , Xu          , Ql          , Ql          , Ql          , Ql          , Ql          , Ql          , Ql          , Ql          , Ql          , Ql          , Ql          , Xos         , Xos         , Xu          , Xu          , Qxv         , Qxv         , Qxv         , Qxv^Xo      , Uu^Xo       , Uu          , Urb         , Xu          , Xu          , Xu          , Xu          , Xu          , Xu          , Xu          , Wo          , Wo          , Wo          , Wo          , Xu          , Xu          , Xu          , Xu          
Ql          , Xu          , Ql          , Ql          , Xu          , Ql          , Ql          , Xu          , Xu          , Ql          , Ql          , Ql          , Ql          , Ql          , Ql          , Ql          , Ql          , Xu          , Xu          , Ql          , Xu          , Xu          , Ql          , Xu          , Ql          , Ql          , Ql          , Ql          , Xos         , Xu          , Xu          , Xu          , Xu          , Qxv^Xo      , Qxv         , Qxv         , Xu          , Xu          , Xu          , Xu          , Xu          , Xu          , Xu          , Xu          , Xu          , Wo          , Wo          , Wo          , Wo          , Wo          , Wo          , Xu          , Xu          
