border_size=1
usage=map

Ryd         , Ryd         , Ryd         , Xos         , Xos         , Xos         , Xos         , Xos         , Xos         , Xos         , Xos         , Xos         , Xos         , Xos         , Ms          , Ms          , Ms          , Ms          , Ai          , Ai          , Ai          , Ai          , Ai          , Aa          , Aa          , Aa          , Aa          , Ai          , Ai          , Aa          , Aa          , Ha          , Ha          , Ha          , Ha          , Ha          , Ha          , Ha          , Ha          , Ha          , Aa          , Xos         , Xos         , Xos         , Xos         , Xos         , Xos         , Xos         
Xos         , Ryd         , Ryd         , Ryd         , Ryd         , Xos         , Xos         , Xos         , Xos         , Xos         , Xos         , Xos         , Ms          , Ms          , Ms          , Ms          , Ms          , Ms          , Ai          , Ai          , Ai          , Ai          , Ai          , Ai          , Ai          , Aa          , Aa          , Ai          , Ai          , Aa          , Aa^Fda      , Ha          , Ha          , Ha          , Ha          , Ha          , Ha          , Ha          , Ha          , Ha          , Aa          , Xos         , Xos         , Xos         , Xos         , Xos         , Xos         , Xos         
Xos         , Xos         , Xos         , Ryd         , Ryd         , Ryd         , Xos         , Xos         , Xos         , Xos         , Ms          , Ms          , Ms          , Ha          , Ms          , Ms          , Ai          , Ai          , Ai          , Ai          , Ai          , Ai          , Ai          , Ai          , Ai          , Ai          , Aa          , Aa          , Aa          , Aa          , Ai          , Ha          , Ha          , Ha          , Ha          , Ha          , Ha          , Ha          , Ha          , Aa          , Ai          , Xos         , Xos         , Xos         , Xos         , Xos         , Xos         , Xos         
Xos         , Xos         , Xos         , Xos         , Ryd         , Ryd         , Xos         , Xos         , Ha          , Ha          , Ha          , Ms          , Ha          , Ha          , Ai          , Ai          , Ai          , Ai          , Ai          , Ai          , Aa          , Aa          , Ai          , Aa          , Aa          , Ai          , Ai          , Aa          , Ai          , Ai          , Ai          , Aa          , Aa          , Ha          , Ha          , Ha          , Ha          , Aa          , Aa          , Aa          , Xos         , Xos         , Xos         , Xos         , Xos         , Xos         , Xos         , Xos         
Xos         , Xos         , Xos         , Xos         , Ryd         , Ryd         , Aa          , Ha          , Ha          , Ha          , Uu^Cd       , Aa          , Aa          , Ha          , Aa          , Ai          , Ai          , Aa          , Aa          , Aa          , Aa          , Aa          , Ai          , Aa          , Aa          , Ai          , Ai          , Ai          , Ai          , Aa          , Aa^Fda      , Aa          , Ai          , Aa          , Aa          , Ha          , Ha          , Aa          , Ai          , Ai          , Xos         , Xos         , Xos         , Xos         , Xos         , Xos         , Xos         , Xos         
Xos         , Xos         , Xos         , Xos         , Aa          , Ryd         , Aa          , Aa          , Ha          , Aa          , Aa          , Uu^Cd       , Uu^Cd       , Ha          , Ha          , Ai          , Ai          , Ai          , Aa          , Aa          , Ha          , Aa          , Aa          , Aa          , Ai          , Aa          , Ai          , Ai          , Ai          , Aa^Fda      , Aa^Fda      , Aa          , Ai          , Aa          , Aa          , Ha          , Ha          , Aa          , Ai          , Ai          , Xos         , Xos         , Xos         , Xos         , Xos         , Xos         , Xos         , Xos         
Xos         , Xos         , Ms          , Ha          , Aa          , Ryd         , Ryd         , Aa          , Aa          , Aa^Fda      , Aa^Fda      , Aa^Fda      , Aa^Fda      , Aa          , Ha          , Aa          , Ms          , Ai          , Aa          , Ha          , Aa          , Aa^Fda      , Aa          , Ai          , Ai          , Ai          , Ai          , Ai          , Aa          , Aa          , Aa          , Aa^Fda      , Ai          , Ai          , Aa          , Ha          , Ha          , Aa          , Ai          , Ai          , Xos         , Xos         , Xos         , Xos         , Xos         , Xos         , Xos         , Xos         
Ms          , Ms          , Ha          , Ms          , Aa          , Aa          , Ryd         , Aa          , Aa          , Aa          , Aa          , Aa^Fda      , Aa^Fda      , Aa          , Ha          , Ha          , Ms          , Ha          , Aa          , Ha          , Aa          , Aa^Fda      , Aa^Fda      , Ai          , Ai          , Aa          , Aa          , Aa          , Aa          , Ha          , Ha          , Aa          , Aa          , Ai          , Aa          , Ha          , Aa          , Aa          , Ai          , Ai          , Xos         , Xos         , Xos         , Xos         , Xos         , Xos         , Xos         , Xos         
Ms          , Ms          , Ha          , Uu^Cd       , Aa          , Aa          , Ryd         , 1 Aa        , Aa          , Aa          , Aa          , Aa          , Aa          , Aa          , Ms          , Ms          , Ha          , Ha          , Ha          , Aa          , Uu^Cd       , Aa          , Aa^Fda      , Aa          , Ai          , Aa          , Uu^Cd       , Aa          , Aa          , Aa          , Ha          , Ha          , Ha          , Aa          , Ha          , Aa          , Ha          , Aa          , Xos         , Xos         , Xos         , Xos         , Xos         , Xos         , Xos         , Xos         , Xos         , Xos         
Ms          , Ha          , Aa          , Aa          , Ha          , Aa          , Aa          , Ryd         , Aa          , Aa          , Aa          , Aa          , Aa          , Ha          , Ms          , Ms          , Ha          , Aa          , Ha          , Aa          , Aa          , Aa          , Aa          , Aa          , Ai          , Aa          , Uu^Cd       , Uu^Cd       , Aa          , Aa          , Aa          , Ha          , Ha          , Ha          , Ha          , Ha          , Aa          , Aa          , Xos         , Xos         , Xos         , Xos         , Xos         , Xos         , Xos         , Xos         , Xos         , Xos         
Ms          , Aa          , Aa          , Aa^Fda      , Aa          , Aa          , Uu^Cd       , Aa          , Aa          , Aa          , Ha          , Aa          , Aa          , Ha          , Aa          , Ha          , Aa          , Aa          , Ha          , Ha          , Aa          , Aa          , Ai          , Aa          , Ww          , Aa          , Aa          , Aa          , Aa          , Aa          , Aa          , Aa          , Ha          , Ha          , Ha          , Aa          , Xos         , Xos         , Xos         , Xos         , Xos         , Xos         , Xos         , Xos         , Xos         , Xos         , Xos         , Xos         
Ha          , Ha          , Ms          , Aa^Fda      , Aa^Fda      , Aa          , Aa          , Aa          , Aa          , Aa          , Ms          , Ha          , Aa          , Aa          , Aa          , Aa          , Aa^Fda      , Ha          , Ha          , Ha          , Ai          , Ai          , Ai          , Ai          , Ww          , Aa          , Aa          , Aa          , Aa          , Uu^Cd       , Aa          , Aa          , Ha          , Ha          , Aa          , Aa          , Xos         , Xos         , Xos         , Xos         , Xos         , Xos         , Xos         , Xos         , Xos         , Xos         , Xos         , Xos         
Ha          , Ms          , Ha          , Ms          , Ms          , Aa          , Ha          , Aa          , Ha          , Ha          , Ms          , Ha          , Aa          , Aa          , Aa          , Aa          , Aa          , Aa^Fda      , Aa          , Aa          , Ai          , Ai          , Chw         , Ww          , Ai          , Ai          , Aa          , Aa          , Aa          , Aa          , Ha          , Aa          , Aa          , Aa          , Aa          , Aa          , Xos         , Xos         , Xos         , Xos         , Xos         , Xos         , Xos         , Xos         , Xos         , Xos         , Xos         , Xos         
Ms          , Ms          , Ha          , Ha          , Ha          , Ha          , Aa          , Ha          , Aa          , Aa          , Ms          , Aa          , Aa          , Ryd         , Aa          , Aa          , Aa          , Aa^Fda      , Aa          , Ai          , Ai          , Ww          , Chw         , Ww          , Ww          , Ai          , Aa          , Aa^Fda      , Ha          , Ha          , Ha          , Aa          , Aa          , Aa          , Xos         , Xos         , Xos         , Xos         , Xos         , Xos         , Xos         , Xos         , Xos         , Xos         , Xos         , Xos         , Xos         , Xos         
Ms          , Ms          , Aa^Fda      , Aa          , Aa          , Aa          , Aa          , Uu^Cd       , Uu^Cd       , Aa          , Ha          , Ha          , Aa^Fda      , Aa          , Aa          , Aa          , Aa          , Aa          , Aa          , Aa          , Ai          , Ai          , Ww          , Chw         , Ai          , Ai          , Aa^Fda      , Aa^Fda      , Ha          , Ha          , Aa          , Aa          , Xos         , Xos         , Xos         , Xos         , Xos         , Xos         , Xos         , Xos         , Xos         , Xos         , Xos         , Xos         , Xos         , Xos         , Xos         , Xos         
Ha          , Ha          , Aa          , Aa          , Ha          , Ha          , Aa          , Aa          , Aa          , Aa          , Ha          , Ms          , Aa^Fda      , Aa^Fda      , Aa          , Aa          , Aa          , Ryd         , Ryd         , Aa          , Aa          , Ww          , Aa          , Ai          , Aa          , Aa          , Aa^Fda      , Aa^Fda      , Ha          , Aa          , Aa          , Xos         , Xos         , Xos         , Xos         , Xos         , Xos         , Xos         , Xos         , Xos         , Xos         , Xos         , Xos         , Xos         , Xos         , Xos         , Xos         , Xos         
Aa          , Ha          , Aa^Fda      , Aa          , Ha          , Aa          , Aa^Fda      , Aa^Fda      , Aa          , Aa          , Aa          , Ha          , Aa^Fda      , Aa          , Aa          , Aa          , Aa          , Aa          , Ryd         , Aa          , Aa          , Aa          , Aa          , Aa          , Aa          , Aa          , Aa          , Aa          , Ryd         , Aa          , Xos         , Xos         , Xos         , Xos         , Xos         , Xos         , Xos         , Xos         , Xos         , Xos         , Xos         , Xos         , Xos         , Xos         , Xos         , Xos         , Xos         , Xos         
Aa          , Aa^Fda      , Aa          , Ha          , Ms          , Aa^Fda      , Aa^Fda      , Aa          , Uu^Cd       , Aa          , Aa          , Aa          , Aa          , Aa          , Aa          , Aa          , Aa          , Aa          , Aa          , Ryd         , Ryd         , Aa          , Aa          , Aa          , Ryd         , Aa          , Ryd         , Ryd         , Qxs         , Qxs         , Qxs         , Xos         , Xos         , Xos         , Xos         , Xos         , Xu          , Xu          , Xu          , Xos         , Xos         , Xos         , Xos         , Xos         , Xos         , Xos         , Xos         , Xos         
Aa          , Aa^Fda      , Ha          , Ha          , Ms          , Ha          , Aa          , Aa          , Uu^Cd       , Aa          , Aa          , Aa          , Aa          , Aa          , Aa          , Aa          , Aa          , Aa          , Aa          , Aa          , Aa          , Aa          , Aa          , Ryd         , Ryd         , Ryd         , Ryd         , Ryd         , Ryd         , Qxs         , Qxs         , Qxs         , Qxs         , Xos         , Uu          , Yhl^Xp      , Xu          , Xu          , Xu          , Xu          , Xu          , Xos         , Xos         , Xos         , Xos         , Xos         , Xos         , Xos         
Aa          , Ha          , Aa          , Aa          , Ha          , Ha          , Aa          , Aa          , Aa          , Aa          , Aa          , Aa          , Ha          , Aa          , Ha          , Aa          , Aa          , Aa          , Aa          , Aa          , Aa          , Aa          , Aa          , Ryd         , Aa          , Ryd         , Ryd         , Ryd         , Ryd         , Ryd         , Ryd         , Cud         , Uu          , Uu          , Qxs         , Xu          , Uu          , Yhl^Xp      , Xu          , Xu          , Xu          , Xu          , Xu          , Xos         , Xos         , Xos         , Xos         , Xos         
Ms          , Ha          , Aa          , Aa          , Aa          , Aa          , Aa          , Aa          , Aa          , Aa          , Aa          , Aa          , Aa          , Ha          , Ha          , Ha          , Aa          , Aa^Fda      , Aa          , Ha          , Ha          , Aa          , Ha          , Ha          , Ha          , Aa          , Ryd         , Ryd         , Qxs         , Ryd         , Ryd         , Ryd         , Ryd         , Cud         , Uu          , Uu          , Qxs         , Xu          , Uu          , Yhl^Xp      , Xu          , Xu          , Xu          , Xu          , Xu          , Xos         , Xos         , Xos         
Ms          , Ha          , Ha          , Aa          , Ha          , Aa          , Aa          , Uu^Cd       , Aa          , Aa          , Ha          , Ha          , Aa          , Aa          , Ha          , Ha          , Aa          , Aa          , Aa          , Aa          , Ha          , Aa^Fda      , Aa          , Ha          , Ms          , Ha          , Aa          , Qxs         , Qxs         , Cud         , Uu          , Ryd         , Ryd         , Ryd         , Ryd         , Cud         , Uu          , Uu          , Qxs         , Xu          , Xu          , Xu          , Xu          , Xu          , Xu          , Xu          , Xos         , Xos         
Ms          , Ms          , Ms          , Aa          , Ha          , Aa          , Aa^Fda      , Uu^Cd       , Aa          , Ha          , Ha          , Ha          , Aa          , Aa^Fda      , Aa^Fda      , Aa          , Ha          , Ha          , Aa          , Aa          , Aa^Fda      , Aa^Fda      , Aa          , Aa          , Ha          , Ha          , Xos         , Xos         , Uu          , Uu          , Qxs         , Cud         , Uu          , Ryd         , Ryd         , Ryd         , Ryd         , Qxs         , Cud         , Qxs         , Xu          , Xu          , Xu          , Xu          , Xos         , Xos         , Ryd         , Ryd         
Ms          , Ms          , Ms          , Ha          , Aa          , Aa^Fda      , Aa          , Aa          , Aa          , Ha          , Ha          , Aa          , Aa          , Aa          , Aa^Fda      , Aa          , Aa^Fda      , Aa^Fda      , Aa^Fda      , Aa^Fda      , Aa^Fda      , Ha          , Ha          , Aa          , Aa          , Aa          , Xos         , Yhl^Xp      , Xu          , Xu          , Uu          , Uu          , Qxs         , Cud         , Qxs         , Ryd         , Ryd         , Ryd         , Ryd^Z/      , Xu          , Cud         , Xu          , Xos         , Xos         , Ryd         , Ryd         , Qxs         , Qxs         
Ms          , Ms          , Ms          , Ms          , Ha          , Aa          , Ha          , Aa          , Aa          , Ha          , Aa          , Aa          , Ha          , Ha          , Aa          , Aa          , Ha          , Ha          , Aa          , Aa          , Aa          , Ha          , Aa          , Aa          , Xos         , Xos         , Xu          , Xu          , Xu          , Yhl^Xp      , Xu          , Xu          , Xu          , Qxs         , Qxs         , Cud         , Ryd^Z/      , Ryd^Z/      , Zw          , Ryd         , Ryd         , Ryd         , Ryd         , Ryd         , Qxs         , Qxs         , Qxs         , Qxs         
Ms          , Ms          , Ms          , Ms          , Ha          , Ha          , Ha          , Ha          , Ha          , Ha          , Aa          , Aa          , Ha          , Aa          , Ha          , Ha          , Ha          , Aa          , Aa          , Aa          , Xos         , Aa          , Xos         , Xos         , Xos         , Xos         , Xos         , Xu          , Xu          , Xu          , Xu          , Xu          , Xu          , Xu          , Xu          , Xu          , Ryd         , Zw          , Zw          , Zw          , Zw          , Ryd         , Ryd         , Qxs         , Qxs         , Qxs         , Qxs         , Qxs         
Ms          , Ms          , Ha          , Ha          , Aa          , Aa          , Aa^Fda      , Aa^Fda      , Ha          , Aa          , Aa          , Ha          , Ms          , Ms          , Ms          , Ha          , Xos         , Aa          , Xos         , Xos         , Xos         , Xos         , Xos         , Xos         , Xos         , Xos         , Xos         , Xos         , Xos         , Xu          , Xu          , Xu          , Xu          , Xu          , Xu          , Cud         , Ryd         , Ryd         , Ryd         , Zw          , Zw          , Zw          , Zw          , Ryd         , Ryd         , Qxs         , Qxs         , Qxs         
Ms          , Ms          , Ha          , Aa          , Aa          , Aa          , Aa          , Aa^Fda      , Aa          , Aa          , Ha          , Ha          , Xos         , Ha          , Xos         , Xos         , Xos         , Xos         , Xos         , Xos         , Xos         , Xos         , Xos         , Xos         , Xos         , Xos         , Xos         , Xos         , Xos         , Xos         , Xos         , Xu          , Xu          , Xu          , Xos         , Xos         , Ryd         , Ryd         , Qxs         , Ryd         , Ryd         , Zw          , Zw          , Zw          , Zw          , Ryd         , Ryd         , Ryd         
Ha          , Ms          , Ms          , Ms          , Ha          , Ha          , Aa          , Aa          , Aa          , Ha          , Xos         , Xos         , Xos         , Xos         , Xos         , Xos         , Xos         , Xos         , Xos         , Xos         , Xos         , Xos         , Xos         , Xos         , Xos         , Xos         , Xos         , Xos         , Xos         , Xos         , Xos         , Xos         , Xos         , Xos         , Ryd         , Ryd         , Qxs         , Qxs         , Qxs         , Qxs         , Qxs         , Ryd         , Ryd         , Zw          , Zw          , Zw          , Zw          , Ryd         
