border_size=1
usage=map

Ryd^Zok     , Ryd^Zok     , Ryd^Zok     , Xos^Zok     , Xos^Zok     , Xos^Zok     , Xos         , Xos         , Xos         , Xos         , Xos         , Xos         , Xos         , Xos         , Ms          , Ms          , Ms          , Ha          , Ai          , Ai          , Ai          , Ai          , Ai          , Aa          , Aa          , Aa          , Aa          , Ai          , Ai          , Aa          , Aa          , Ha          , Ha          , Ms          , Ms          , Ms          , Ms          , Ms          , Ms          , Ms          , Xos         , Xos         , Xos         , Xos         , Xos         , Xos         , Xos         , Xos         
Xos^Zok     , Ryd^Zok     , Ryd^Zok     , Ryd^Zok     , Ryd         , Xos         , Xos         , Xos         , Xos         , Xos         , Xos         , Xos         , Ms          , Ms          , Ms          , Ms          , Ha          , Ha          , Ww          , Ai          , Ai          , Ai          , Ai          , Ai          , Ai          , Aa          , Aa          , Ai          , Ai          , Aa          , Aa^Fda      , Ha          , Ha          , Ms          , Ms          , Ms          , Ha          , Ms          , Ms          , Ha          , Xos         , Xos         , Xos         , Xos         , Xos         , Xos         , Xos         , Xos         
Xos^Zok     , Xos^Zok     , Xos         , Ryd         , Ryd         , Ryd         , Xos         , Xos         , Xos         , Xos         , Ms          , Ms          , Ms          , Ha          , Ms          , Ms          , Ww          , Ai          , Ai          , Ww          , Ai          , Ai          , Ai          , Ai          , Ai          , Ai          , Aa          , Aa          , Aa          , Aa          , Ai          , Ha^Fma      , Ha^Fda      , Ms          , Ms          , Ha          , Ha          , Ha          , Ha          , Aa          , Xos         , Xos         , Xos         , Xos         , Xos         , Xos         , Xos         , Xos         
Xos         , Xos         , Xos         , Xos         , Ryd         , Ryd         , Xos         , Xos         , Ha          , Ha          , Ha          , Ms          , Ha          , Ha          , Ai          , Ai          , Ww          , Ww          , Ai          , Ai          , Aa          , Aa          , Ai          , Aa          , Aa^Fda      , Ai          , Ai          , Aa          , Ww          , Ai          , Ai          , Aa^Fda      , Aa          , Ha          , Ha          , Ha          , Ms          , Aa          , Aa          , Aa          , Xos         , Xos         , Xos         , Xos         , Xos         , Xos         , Xos         , Xos         
Xos         , Xos         , Xos         , Xos         , Ryd         , Ryd         , Aa          , Ha          , Ha          , Ha          , Uu^Cd       , Aa          , Aa          , Ha          , Aa          , Ai          , Ai          , Aa          , Aa          , Aa          , Aa          , Aa          , Ww          , Aa          , Aa          , Ai          , Ai          , Ww          , Ww          , Aa          , Aa^Fda      , Ai          , Ai          , Aa          , Aa          , Ms          , Ms          , Aa          , Ai          , Ai          , Xos         , Xos         , Xos         , Xos         , Xos         , Xos         , Xos         , Xos         
Xos         , Xos         , Xos         , Xos         , Aa          , Ryd         , Aa          , Aa          , Ha          , Ha^Fda      , Ha^Fda      , Uu^Cd       , Uu^Cd       , Ha          , Ha          , Ai          , Ai          , Ww          , Aa          , Aa          , Ha          , Aa          , Aa          , Aa          , Ai          , Aa          , Ai          , Ww          , Ai          , Aa^Fda      , Ha^Fda      , Ha^Fda      , Ai          , Aa          , Aa          , Ms          , Ms          , Aa          , Ai          , Ai          , Xos         , Xos         , Xos         , Xos         , Xos         , Xos         , Xos         , Xos         
Xos         , Xos         , Ms          , Ha          , Aa          , Ryd         , Ryd         , Aa          , Aa          , Aa^Fda      , Aa^Fda      , Aa^Fda      , Aa^Fda      , Aa          , Ha          , Aa          , Ms          , Ai          , Aa          , Ha          , Aa          , Aa^Fda      , Aa          , Ai          , Ww          , Ai          , Ai          , Ai          , Aa          , Aa          , Ha^Fda      , Aa^Fda      , Ai          , Ai          , Aa          , Ha          , Ha          , Aa          , Ai          , Ai          , Xos         , Xos         , Xos         , Xos         , Xos         , Xos         , Xos         , Xos         
Ms          , Ms          , Ha          , Ms          , Aa          , Aa          , Ryd         , Aa          , Aa          , Aa          , Aa          , Aa^Fda      , Aa^Fda      , Aa          , Ha          , Ha          , Ms          , Ha          , Aa          , Ha          , Aa          , Aa^Fda      , Aa^Fda      , Ww          , Ai          , Aa          , Aa          , Aa          , Aa          , Ha          , Ha          , Aa          , Aa          , Ai          , Aa          , Ha          , Aa          , Aa          , Ai          , Ai          , Xos         , Xos         , Xos         , Xos         , Xos         , Xos         , Xos         , Xos         
Ms          , Ms          , Ha          , Uu^Cd       , Aa          , Aa          , Aa          , 1 Ryd       , Aa          , Aa          , Aa          , Aa          , Aa          , Aa          , Ms          , Ms          , Ha          , Ha          , Ha          , Aa          , Uu^Cd       , Aa          , Aa^Fda      , Aa          , Ww          , Aa          , Uu^Cd       , Aa          , Aa          , Aa          , Ha          , Ha          , Ha          , Aa          , Ha          , Aa          , Ha          , Aa          , Xos         , Xos         , Xos         , Xos         , Xos         , Xos         , Xos         , Xos         , Xos         , Xos         
Ms          , Ha          , Aa          , Aa          , Ha          , Aa          , Aa          , Ryd         , Aa          , Aa          , Aa          , Aa          , Aa          , Ha          , Ms          , Ms          , Ha          , Aa          , Ha          , Aa          , Aa          , Aa          , Aa          , Aa          , Ai          , Aa          , Uu^Cd       , Uu^Cd       , Aa          , Aa          , Aa          , Ha          , Ms          , Ha          , Ha          , Ha          , Aa          , Aa          , Xos         , Xos         , Xos         , Xos         , Xos         , Xos         , Xos         , Xos         , Xos         , Xos         
Ms          , Aa          , Aa          , Ha^Fda      , Aa          , Aa          , Uu^Cd       , Aa          , Aa          , Aa          , Ha          , Aa          , Aa          , Ha          , Aa          , Ha          , Aa          , Aa          , Ha          , Ha          , Aa          , Aa          , Ai          , Aa          , Ww          , Aa          , Aa          , Aa          , Aa          , Aa          , Aa          , Aa          , Ha          , Ms          , Ha          , Aa          , Xos         , Xos         , Xos         , Xos         , Xos         , Xos         , Xos         , Xos         , Xos         , Xos         , Xos         , Xos         
Ha          , Ha          , Ms          , Ha^Fda      , Ha^Fda      , Aa          , Aa          , Aa          , Aa          , Aa          , Ms          , Ha          , Aa          , Aa          , Ha          , Aa          , Aa^Fda      , Ha          , Ha          , Ha          , Ai          , Ai          , Ai          , Ai          , Ww          , Aa          , Aa          , Aa          , Aa          , Uu^Cd       , Aa          , Aa          , Ha          , Ha          , Aa          , Aa          , Xos         , Xos         , Xos         , Xos         , Xos         , Xos         , Xos         , Xos         , Xos         , Xos         , Xos         , Xos         
Ha          , Ms          , Ha          , Ms          , Ms          , Aa          , Ha          , Aa          , Ha          , Ha          , Ms          , Ha          , Aa          , Aa          , Ha          , Ha          , Aa          , Ha^Fda      , Aa          , Aa          , Ai          , Ai          , Chw         , Ww          , Ai          , Ai          , Aa          , Aa          , Aa          , Aa          , Ha          , Aa          , Aa          , Aa          , Aa          , Aa          , Xos         , Xos         , Xos         , Xos         , Xos         , Xos         , Xos         , Xos         , Xos         , Xos         , Xos         , Xos         
Ms          , Ms          , Ha          , Ha          , Ha          , Ha          , Aa          , Ha          , Aa          , Aa          , Ms          , Ha          , Ha          , Ha          , Aa          , Ha          , Aa          , Ha^Fda      , Aa          , Ai          , Ai          , Ww          , Chw         , Ww          , Ww          , Ai          , Aa          , Ha^Fda      , Ha          , Ha          , Ha          , Aa          , Aa          , Aa          , Xos         , Xos         , Xos         , Xos         , Xos         , Xos         , Xos         , Xos         , Xos         , Xos         , Xos         , Xos         , Xos         , Xos         
Ms          , Ms          , Aa^Fda      , Aa          , Aa          , Aa          , Aa          , Uu^Cd       , Uu^Cd       , Aa          , Ha          , Ha          , Aa^Fda      , Aa          , Aa          , Ha          , Aa          , Aa          , Aa          , Aa          , Ai          , Ai          , Ww          , Chw         , Ai          , Ai          , Aa^Fda      , Aa^Fda      , Ha          , Ha          , Aa          , Aa          , Xos         , Xos         , Xos         , Xos         , Xos         , Xos         , Xos         , Xos         , Xos         , Xos         , Xos         , Xos         , Xos         , Xos         , Xos         , Xos         
Ha          , Ha          , Aa          , Aa          , Ha          , Ha          , Aa          , Aa          , Aa          , Aa          , Ha          , Ms          , Aa^Fda      , Aa^Fda      , Aa          , Aa          , Aa          , Ryd         , Ryd         , Aa          , Aa          , Ww          , Aa          , Ai          , Aa          , Aa          , Aa^Fda      , Ha^Fda      , Ha          , Aa          , Xos         , Xos         , Xos         , Xos         , Xos         , Xos         , Xos         , Xos         , Xos         , Xos         , Xos         , Xos         , Xos         , Xos         , Xos         , Xos         , Xos         , Xos         
Aa          , Ha          , Aa^Fda      , Aa          , Ha          , Aa          , Aa^Fda      , Aa^Fda      , Aa          , Aa          , Aa          , Ha          , Aa^Fda      , Aa          , Aa          , Aa          , Aa          , Aa          , Ryd         , Aa          , Aa          , Aa          , Aa          , Aa          , Aa          , Aa          , Uu^Cd       , Aa          , Ryd         , Aa          , Xos         , Xos         , Xos         , Xos         , Xos         , Xos         , Xos         , Xos         , Xos         , Xos         , Xos         , Xos         , Xos         , Xos         , Xos         , Xos         , Xos         , Xos         
Aa          , Aa^Fda      , Aa          , Ha          , Ms          , Aa^Fda      , Ha^Fda      , Aa          , Uu^Cd       , Aa          , Aa          , Aa          , Aa          , Aa          , Aa          , Aa          , Aa          , Aa          , Aa          , Ryd         , Ryd         , Aa          , Aa          , Uu^Cd       , Ryd         , Aa          , Ryd         , Ryd         , Qxu         , Qxu         , Qxu         , Xos         , Xos         , Xos         , Xos         , Xos         , Xu          , Xu          , Xu          , Xos         , Xos         , Xos         , Xos         , Xos         , Xos         , Xos         , Xos         , Xos         
Aa          , Aa^Fda      , Ha          , Ha          , Ms          , Ha          , Aa          , Aa          , Uu^Cd       , Aa          , Aa          , Aa          , Aa          , Aa          , Aa          , Aa          , Aa          , Aa          , Aa          , Aa          , Aa          , Aa          , Aa          , Ryd         , Ryd         , Ryd         , Ryd         , Ryd         , Ryd         , Qxu         , Qxu         , Qxu         , Qxu         , Xos         , Uu          , Yhl^Xp      , Xu          , Xu          , Xu          , Xu          , Xu          , Xos         , Xos         , Xos         , Xos         , Xos         , Xos         , Xos         
Aa          , Ha          , Aa          , Aa          , Ha          , Ha          , Aa          , Aa          , Aa          , Aa          , Aa          , Aa          , Ha          , Aa          , Ha          , Aa          , Aa          , Aa          , Aa          , Aa          , Aa          , Uu^Cd       , Aa          , Ryd         , Uu^Cd       , Ryd         , Ryd         , Ryd         , Ryd         , Ryd         , Ryd         , Cud         , Uu          , Uu          , Qxu         , Xu          , Uu          , Yhl^Xp      , Xu          , Xu          , Xu          , Xu          , Xu          , Xos         , Xos         , Xos         , Xos         , Xos         
Ms          , Ha          , Aa          , Aa          , Aa          , Aa          , Aa          , Aa          , Aa          , Aa          , Aa          , Aa          , Aa          , Ha          , Ha          , Ha          , Aa          , Aa^Fda      , Aa          , Ha          , Ha          , Aa          , Ha          , Ha          , Ha          , Aa          , Ryd         , Ryd         , Qxu         , Ryd         , Ryd         , Ryd         , Ryd         , Cud         , Uu          , Uu          , Qxu         , Xu          , Uu          , Yhl^Xp      , Xu          , Xu          , Xu          , Xu          , Xu          , Xos         , Xos         , Xos         
Ms          , Ha          , Ha          , Aa          , Ha          , Aa          , Aa          , Uu^Cd       , Aa          , Aa          , Ha          , Ha          , Aa          , Aa          , Ha          , Ha          , Aa          , Aa          , Aa          , Aa          , Ha          , Aa^Fda      , Aa          , Ha          , Ms          , Ha          , Aa          , Qxu         , Qxu         , Cud         , Uu          , Ryd         , Ryd         , Ryd         , Ryd         , Cud         , Uu          , Uu          , Qxu         , Xu          , Xu          , Xu          , Xu          , Xu          , Xos         , Xos         , Xos         , Xos         
Ms          , Ms          , Ms          , Aa          , Ha          , Ha^Fda      , Ha^Fda      , Uu^Cd       , Aa          , Ha          , Ha          , Ha          , Aa          , Aa^Fda      , Aa^Fda      , Aa          , Ha          , Ha          , Ha^Fda      , Aa          , Aa^Fda      , Aa^Fda      , Aa          , Aa          , Ha          , Ha          , Xos         , Xos         , Uu          , Uu          , Qxu         , Cud         , Uu          , Ryd         , Ryd         , Ryd         , Ryd         , Qxu         , Cud         , Xu          , Xos         , Xu          , Xos         , Xos         , Xos         , Xos         , Xos         , Xos         
Ms          , Ms          , Ms          , Ha          , Aa          , Aa^Fda      , Aa          , Aa          , Aa          , Ha          , Ha          , Aa          , Aa          , Ha^Fda      , Aa^Fda      , Aa          , Aa^Fda      , Ha^Fda      , Aa^Fda      , Aa^Fda      , Aa^Fda      , Ha          , Ha          , Aa          , Xos         , Xos         , Xos         , Yhl^Xp      , Xu          , Xu          , Uu          , Uu          , Qxu         , Cud         , Qxu         , Ryd         , Ryd         , Ryd         , Ryd^Z/      , Xu          , Cud         , Xos         , Xos         , Xos         , Xos         , Xos         , Xos         , Xos         
Ms          , Ms          , Ms          , Ms          , Ha          , Aa          , Ha          , Aa          , Aa          , Ha          , Aa          , Aa          , Ha          , Ha          , Aa          , Aa          , Ha          , Ha          , Aa          , Aa          , Aa          , Ha          , Xos         , Xos         , Xos         , Xos         , Xu          , Xu          , Xu          , Yhl^Xp      , Xu          , Xu          , Xu          , Qxu         , Xu          , Cud         , Ryd^Z/      , Ryd^Z/      , Zw          , Ryd         , Ryd         , Cud         , Cud         , Xos         , Xos         , Xos         , Xos         , Xos         
Ms          , Ms          , Ms          , Ms          , Ha          , Ha          , Ha          , Ha          , Ha          , Ha          , Aa          , Aa          , Ha          , Aa          , Ha          , Ha          , Ha          , Aa          , Aa          , Aa          , Xos         , Xos         , Xos         , Xos         , Xos         , Xos         , Xos         , Xu          , Xu          , Xu          , Xu          , Xu          , Xu          , Xu          , Xu          , Xu          , Ryd         , Zw          , Zw          , Zw          , Zw          , Ryd         , Ryd^Z/      , Xos         , Xos         , Xos         , Xos         , Xos         
Ms          , Ms          , Ha          , Ha          , Aa          , Aa          , Aa^Fda      , Aa^Fda      , Ha          , Aa          , Aa          , Ha          , Ms          , Ms          , Ms          , Ha          , Xos         , Aa          , Xos         , Xos         , Xos         , Xos         , Xos         , Xos         , Xos         , Xos         , Xos         , Xos         , Xos         , Xu          , Xu          , Xu          , Xu          , Xu          , Xos         , Cud         , Cud         , Ryd         , Ryd         , Zw          , Ryd^Z/      , Ryd^Z/      , Zw          , Ryd         , Ryd         , Xos         , Xos         , Xos         
Ms          , Ms          , Ha          , Aa          , Aa          , Aa          , Aa          , Aa^Fda      , Aa          , Aa          , Ha          , Ha          , Xos         , Ha          , Xos         , Xos         , Xos         , Xos         , Xos         , Xos         , Xos         , Xos         , Xos         , Xos         , Xos         , Xos         , Xos         , Xos         , Xos         , Xos         , Xos         , Xu          , Xos         , Xos         , Xos         , Xos         , Xos         , Cud         , Xos         , Ryd^Z/      , Ryd         , Zw          , Zw          , Zw          , Zw          , Ryd         , Ryd         , Xos         
Ha          , Ms          , Ms          , Ms          , Ha          , Ha          , Aa          , Aa          , Aa          , Ha          , Xos         , Xos         , Xos         , Xos         , Xos         , Xos         , Xos         , Xos         , Xos         , Xos         , Xos         , Xos         , Xos         , Xos         , Xos         , Xos         , Xos         , Xos         , Xos         , Xos         , Xos         , Xos         , Xos         , Xos         , Xos         , Xos         , Xos         , Xos         , Xos         , Xos         , Xos         , Ryd         , Ryd         , Zw          , Zw          , Zw          , Zw          , Ryd         
