border_size=1
usage=map

Ryd         , Ryd         , Ryd         , Cud         , Cud         , Xu          , Xu          , Xu          , Xu          , Xos         , Xos         , Xos         , Xos         , Xos         , Xu          , Xu          , Xu          , Xu          , Xu          , Xu          , Xu          , Xu          , Yl          , Ryd         , Ryd         , Uu^Uf       , Yl          , Yl          , Xu          , Xu          , Xu          , Xu          , Xu          , Xu          , Xu          , Xu          , Xu          , Xu          , Xu          , Xu          , Xu          , Xu          , Xu          , Xu          , Xu          , Xu          , Xu          , Xu          , Xu          , Xu          , Xu          , Xu          , Xu          , Xu          
Ryd         , Ryd         , Ryd         , Ryd         , Ryd         , Cud         , Xu          , Xu          , Cud         , Ryd         , Ryd         , Uh^Ii       , Uh          , Uh          , Yl          , Xu          , Zw          , Yr^Xp         , Xu          , Xu          , Xu          , Uu^Uf       , Uu^Uf       , Ryd         , Yl          , Yl          , Xu          , Xu          , Uh          , Xu          , Yr          , Xu          , Uh          , Xu          , Uh          , Xu          , Xu          , Xu          , Xu          , Xu          , Xu          , Xu          , Xu          , Xu          , Xu          , Xu          , Xu          , Xu          , Xu          , Xu          , Xu          , Xu          , Xu          , Xu
Ryd         , Ryd         , Ryd         , Ryd         , Ryd         , Xg^Zse      , Ryd         , Cud         , Cud         , Kud         , Uh          , Uh^Ii       , Yl          , Yl          , Qxv         , Yl          , Yl          , Xu          , Zw          , Yr^Xp         , Xu          , Xu          , Uu^Uf       , Yl          , Ryd         , Yl          , Uu^Uf       , Xu          , Xu          , Yr          , Yl          , Yr          , Xu          , Xu          , Yr          , Xu          , Uh          , Xu          , Xu          , Xu          , Xu          , Xu          , Xu          , Xu          , Xu          , Xu          , Xu          , Xu          , Xu          , Xu          , Xu          , Xu          , Xu          , Xu
Cud         , Ryd         , Xg^Zse      , Ryd         , Ryd         , Ryd         , Ryd         , Ryd         , Ryd         , Ryd         , Yl          , Yl          , Qxv         , Qxv         , Qxv         , Qxv         , Qxv         , Yl          , Yl          , Xu          , Xu          , Xu          , Yl          , Ryd         , Ryd         , Uu^Uf       , Xu          , Xu          , Uu          , Yr          , Yr          , Yr          , Xu          , Yr          , Yl          , Yr          , Xu          , Xu          , Xu          , Xu          , Xu          , Xu          , Xu          , Xu          , Xu          , Xu          , Xu          , Xu          , Xu          , Xu          , Xu          , Xu          , Xu          , Xu          
Xu          , Xu          , Cud         , Ryd         , Ryd         , Ryd         , Ryd         , Ryd         , Ryd         , Ryd         , Yl          , Qxv         , Qxv         , Uu^Ii       , Qxv         , Qxv         , Qxv         , Qxv         , Yl          , Yl          , Yl          , Xu          , Xg^Zsw      , Ryd         , Yl          , Yl          , Xu          , Xu          , Yr^Xp         , Xu          , Xu          , Xu          , Uu          , Yr          , Yr          , Yr          , Xu          , Xu          , Xu          , Xu          , Xu          , Xu          , Xu          , Xu          , Xu          , Xu          , Xu          , Xu          , Xu          , Xu          , Xu          , Xu          , Xu          , Xu
Uu^Uf       , Cud         , Kud         , Cud         , Ryd         , Ryd         , Ryd         , 1 Ryd       , Ryd         , Ryd         , Ryd         , Yl          , Yl          , Qxv         , Qxv         , Qxv         , Yl          , Yl          , Ryd         , Ryd         , Yl          , Yl          , Uu          , Xg^Zsw      , Xu          , Xu          , Yr^Xp         , Re^Uf       , Ww          , Re^Uf       , Yr^Xp         , Uu          , Xu          , Xu          , Xu          , Xu          , Yr          , Xu          , Uh          , Xu          , Xu          , Xu          , Xu          , Xu          , Xu          , Xu          , Xu          , Xu          , Xu          , Xu          , Xu          , Xu          , Xu          , Xu
Uh^Ii       , Uh^Ii       , Ryd         , Ryd         , Yl          , Yl          , Yl          , Ryd         , Ryd         , Ryd         , Ryd         , Ryd         , Ryd         , Yl          , Yl          , Yl          , Ryd         , Ryd         , Yl          , Yl          , Uu^Uf       , Uu^Uf       , Uu          , Uu^Uf       , Cud         , Xu          , Uu          , Wo          , Wo          , Ww          , Re^Uf       , Xu          , Xu          , Xu          , Xu          , Yr          , Yl          , Yr          , Xu          , Xu          , Xu          , Xu          , Xu          , Xu          , Xu          , Xu          , Xu          , Xu          , Xu          , Xu          , Xu          , Xu          , Xu          , Xu          
Ryd         , Ryd         , Yl          , Yl          , Qxv         , Qxv         , Qxv         , Yl          , Yl          , Ryd         , Uu^Uf       , Ryd         , Ryd         , Ryd         , Ryd         , Ryd         , Ryd         , Yl          , Yl          , Yl          , Yl          , Re^Uf       , Re^Uf       , Cud         , 5 Kud       , Cud         , Uu          , Uu^Uf       , Re^Uf       , Wo          , Wo          , Yr^Xp         , Re^Uf       , Xu          , Uu          , Yr          , Yr          , Yr          , Uh          , Xu          , Xu          , Xu          , Xu          , Xu          , Xu          , Xu          , Xu          , Xu          , Xu          , Xu          , Xu          , Xu          , Xu          , Xu
Ryd         , Yl          , Qxv         , Qxv         , Qxv         , Uu^Ii       , Qxv         , Qxv         , Qxv         , Yl          , Uu^Uf       , Uu^Ufi      , Yr          , Ryd         , Ryd         , Ryd         , Ryd         , Ryd         , Yl          , Yl          , Uh          , Uu          , Uh          , Cud         , Cud         , Uu          , Uu          , Uu^Uf       , Re^Uf       , Wo          , Wo          , Wo          , Yr^Xp         , Uu          , Xu          , Xu          , Uh          , Xu          , Xu          , Xu          , Xu          , Xu          , Xu          , Xu          , Xu          , Xu          , Xu          , Xu          , Xu          , Xu          , Xu          , Xu          , Xu          , Xu
Ryd         , Yl          , Yl          , Qxv         , Qxv         , Qxv         , Qxv         , Qxv         , Yl          , Uu^Uf       , Yr          , Yr^Xp         , Cud         , Yr^Xp         , Yr          , Ryd         , Yl          , Yl          , Uu^Uf       , Uh          , Uu          , Uu          , Uh          , Uh          , Uh          , Re^Uf       , Uu          , Re^Uf       , Ww          , Wo          , Wo          , Ww          , Re^Uf       , Xu          , Xu          , Xu          , Xu          , Xu          , Xu          , Xu          , Xu          , Xu          , Xu          , Xu          , Xu          , Xu          , Xu          , Xu          , Xu          , Xu          , Xu          , Xu          , Xu          , Xu
Ryd         , Ryd         , Ryd         , Yl          , Yl          , Qxv         , Yl          , Yl          , Uu^Uf       , Uu^Uf       , Yr^Xp         , Cud         , 4 Kud       , Cud         , Yr^Xp         , Yr          , Yr          , Ryd         , Ryd         , Uh          , Uu^Uf       , Uu^Uf       , Uu          , Uu          , Uh          , Uu^Uf       , Re^Uf       , Uu^Uf       , Re^Uf       , Yr^Xp         , Re^Uf       , Yr^Xp         , Uu          , Xu          , Xu          , Uh          , Xu          , Xu          , Xu          , Xu          , Xos         , Xos         , Xos         , Xu          , Xu          , Xu          , Xu          , Xu          , Xu          , Xu          , Xu          , Xu          , Xu          , Xu
Uu          , Uu          , Xu          , Zw          , Zw          , Yl          , Xu          , Xu          , Xu          , Uu^Uf       , Yr          , Cud         , Cud         , Cud         , Uu^Ufi      , Yr          , Uu^Uf       , Ryd         , Ryd         , Uu^Uf       , Cud         , Uu^Uf       , Xos         , Uu^Uf       , Xos         , Uh          , Xos         , Xos         , Xos         , Uu          , Xos         , Uu          , Xos         , Uu          , Yr          , Yr          , Yr          , Uh          , Xos         , Xos         , Xos         , Xos         , Xos         , Xos         , Xos         , Xu          , Xu          , Xu          , Xu          , Xu          , Xu          , Xu          , Xu          , Xu          
Uu^Uf       , Uu^Uf       , Xu          , Yr^Xp         , Xu          , Zw          , Zw          , Yr^Xp         , Xu          , Yr          , Yr          , Yr^Xp         , Yr          , Yr^Xp         , Uh          , Uu^Ufi      , Uu^Ufi      , Uu^Uf       , Ryd         , Ryd         , Xg^Zse      , Xos         , Cud         , Xos         , Cud         , Xos         , Xos         , Xos         , Xos         , Uh          , Xos         , Uh          , Xos         , Xos         , Yr          , Yl          , Yr          , Xos         , Xos         , Xos         , Xos         , Xos         , Xos         , Xos         , Xos         , Xos         , Xos         , Xu          , Xu          , Xu          , Xu          , Xu          , Xu          , Xu
Uu^Uf       , Xu          , Yr^Xp         , Xu          , Yr^Xp         , Xu          , Yr^Xp         , Zw          , Zw          , Uu^Uf       , Yr          , Uu^Uf       , Xu          , Uu^Ufi      , Uu^Uf       , Uu          , Uu^Ufi      , Cud         , Xos         , Xg^Zse      , Ryd         , Ryd         , Ryd         , Cud         , Uu          , Cud         , Cud         , Xos         , Xos         , Xos         , Xos         , Xos         , Xos         , Uh          , Xos         , Yr          , Xos         , Uh          , Xos         , Xos         , Ryd         , Ryd         , Ryd         , Xos         , Xos         , Xos         , Xos         , Xos         , Xos         , Xu          , Xu          , Xu          , Xu          , Xu
Xu          , Xu          , Zw          , Xu          , Zw          , Xu          , Xu          , Xu          , Uu^Uf       , Zw          , Yr          , Uu^Uf       , Xu          , Xu          , Xu          , Uu^Ufi      , Uu^Ufi      , Xos         , Xos         , Xos         , Cud         , Ryd         , Ryd         , Ryd         , Uu          , Uu          , Uu^Uf       , Cud         , Cud         , Cud         , Cud         , Xos         , Xos         , Xos         , Xos         , Uh          , Xos         , Xos         , Xos         , Xos         , Ryd         , Uu^Ii       , Ryd         , Xu          , Xu          , Xos         , Xos         , Xos         , Xos         , Xos         , Xos         , Xu          , Xu          , Xu          
Xos         , Xos         , Yr          , Ryd         , Yr          , Yr          , Zw          , Zw          , Zw          , Zw          , Yr          , Zw          , Yr          , Uu^Uf       , Xu          , Uh          , Xu          , Xu          , Uu^Ii       , Xos         , Cud         , Ryd         , Ryd         , Ryd         , Ryd         , Uh          , Uh          , Uu^Uf       , Uu          , Uu^Uf       , Uu^Uf       , Cud         , Cud         , Cud         , Cud         , Xos         , Xos         , Xos         , Ryd         , Ryd         , Ryd         , Ryd         , Xu          , Xu          , Ryd         , Ryd         , Ryd         , Xos         , Xos         , Xos         , Xos         , Xos         , Xos         , Xu          
Xos         , Uu^Uf       , Zw          , Zw          , Ryd         , Ryd         , Zw          , Zw          , Uu^Uf       , Uu^Uf       , Yr          , Uu^Uf       , Xu          , Zw          , Yr^Xp         , Xu          , Uh          , Uh          , Uh          , Xos         , Xos         , Cud         , Cud         , Ryd         , Ryd         , Ryd         , Uh          , Uh          , Uh          , Uu          , Uu          , Uu          , Uh          , Uu^Uf       , Uh          , Cud         , Ryd         , Xg^Zsw      , Xg^Zsw      , Ryd         , Xu          , Xu          , Xu          , Xu          , Yr          , Uu^Ii       , Ryd         , Xos         , Xos         , Xos         , Xos         , Xos         , Xos         , Xos
Re^Uf       , Uu^Ii       , Zw          , Zw          , Xu          , Xu          , Xu          , Ryd         , Zw          , Uu^Uf       , Xu          , Zw          , Yr^Xp         , Xu          , Xu          , Xu          , Yr          , Uh          , Yr          , Uh          , Xos         , Xos         , Xos         , Cud         , Ryd         , Ryd         , Ryd         , Uu          , Uu          , Uu^Uf       , Uu          , Uu          , Ryd         , Uh          , Ryd         , Ryd         , Ryd         , Ryd         , Cud         , Xu          , Xu          , Xu          , Xu          , Xu          , Yr          , Yr          , Xos         , Xos         , Xu          , Xos         , Xos         , Xos         , Xos         , Xos
Zw          , Zw          , Zw          , Ryd         , Xu          , Yr^Xp         , Ryd         , Ryd         , Xu          , Zw          , Yr^Xp         , Xu          , Xu          , Xu          , Xu          , Yr^Xp         , Xu          , Zw          , Zw          , Yr          , Cud         , Xos         , Xos         , Cud         , Cud         , Ryd         , Ryd         , Ryd         , Ryd         , Ryd         , Ryd         , Ryd         , Cud         , Ryd         , Ryd         , Ryd         , Ryd         , Ryd         , Ryd         , Cud         , Cud         , Xu          , Xg^Zsw      , Ryd         , Yr          , Yr          , Xu          , Xu          , Xu          , Xos         , Xos         , Xos         , Xos         , Xos
Zw          , Uu^Ii       , Ryd         , Ryd         , Re^Uf       , Xu          , Zw          , Zw          , Xu          , Xu          , Xu          , Xu          , Xu          , Yr^Xp         , Xu          , Xu          , Xu          , Uh          , Yr          , Ryd         , Ryd         , Cud         , Cud         , Xos         , Xos         , Cud         , Ryd         , Ryd         , Ryd         , Ryd         , Cud         , Cud         , Uu^Cd       , Cud         , Cud         , Ryd         , Ryd         , Ryd         , Ryd         , Ryd         , Ryd         , Ryd         , Ryd         , Xg^Zsw      , Xu          , Xu          , Xu          , Uu^Ii       , Xu          , Xos         , Xos         , Xos         , Yr          , Yr
Zw          , Yr          , Re^Uf       , Ryd         , Ryd         , Re^Uf       , Re^Uf       , Xu          , Yr^Xp         , Zw          , Ryd         , Yr^Xp         , Xu          , Zw          , Xu          , Yr^Xp         , Yr          , Yr          , Xu          , Xu          , Cud         , Ryd         , Ryd         , Cud         , Xos         , Cud         , Ryd         , Ryd         , Ryd         , Ryd         , Cud         , Uu^Cd       , 3 Uu^Kd     , Uu^Cd       , Cud         , Ryd         , Ryd         , Ryd         , Ryd         , Ryd         , Ryd         , Ryd         , Xu          , Xu          , Xu          , Xu          , Xu          , Zw          , Xu          , Xos         , Ryd         , Yr          , Xos         , Xos
Uu^Uf       , Zw          , Re^Uf       , Yr          , Yr          , Re^Uf       , Re^Uf       , Xu          , Xu          , Xu          , Xu          , Yr          , Re^Uf       , Re^Uf       , Zw          , Yr          , Yr          , Uu^Ii       , Xu          , Xu          , Xu          , Cud         , Ryd         , Cud         , Xos         , Cud         , Cud         , Ryd         , Ryd         , Ryd         , Cud         , Uu^Cd       , Uu^Cd       , Uu^Cd       , Cud         , Ryd         , Ryd         , Ryd         , Cud         , Ryd         , Xg^Zse      , Xg^Zse      , Ryd         , Xu          , Ryd         , Uu^Ii       , Ryd         , Ryd         , Xu          , Yr          , Ryd         , Yr          , Yr          , Xos         
Uu^Ufi      , Uu^Ufi      , Re^Uf       , Zw          , Ryd         , Yr          , Ryd         , Yr          , Ryd         , Xu          , Zw          , Zw          , Re^Uf       , Re^Uf       , Zw          , Ryd         , Xu          , Yr          , Xu          , Xu          , Xu          , Cud         , Ryd         , Cud         , Cud         , Xos         , Cud         , Ryd         , Ryd         , Ryd         , Ryd         , Cud         , Cud         , Cud         , Ryd         , Ryd         , Ryd         , Ryd         , Cud         , Xos         , Xos         , Ryd         , Ryd         , Uu^Ii       , Ryd         , Ryd         , Ryd         , Uu^Ii       , Xu          , Yr          , Yr          , Uu^Ii       , Zw          , Yl          
Xu          , Xu          , Zw          , Zw          , Re^Uf       , Ryd         , Yr          , Ryd         , Ryd         , Yr          , Zw          , Zw          , Ryd         , Zw          , Xu          , Zw          , Yr^Xp         , Xu          , Xu          , Xu          , Xu          , Cud         , Cud         , Ryd         , Ryd         , Cud         , Ryd         , Ryd         , Ryd         , Ryd         , Ryd         , Ryd         , Ryd         , Ryd         , Ryd         , Ryd         , Ryd         , Cud         , Xos         , Xos         , Xos         , Xos         , Xos         , Ryd         , Uu^Ii       , Ryd         , Uu^Ii       , Ryd         , Xu          , Yr          , Yr          , Zw          , Zw          , Zw
Xu          , Xu          , Yr^Xp         , Zw          , Xu          , Re^Uf       , Re^Uf       , Zw          , Zw          , Zw          , Ryd         , Yr          , Xu          , Zw          , Yr^Xp         , Xu          , Xu          , Xu          , Xu          , Xu          , Xu          , Xu          , Xu          , Cud         , Cud         , Ryd         , Ryd         , Ryd         , Ryd         , Ryd         , Ryd         , Ryd         , Ryd         , Ryd         , Ryd         , Ryd         , Xg^Zse      , Xos         , Xos         , Xos         , Xu          , Xu          , Xu          , Xos         , Xu          , Xu          , Xu          , Xu          , Xu          , Yr          , Yr          , Zw          , Uu^Ii       , Zw
Xu          , Xu          , Xu          , Xu          , Yr^Xp         , Zw          , Xu          , Yr          , Xu          , Uu^Ii       , Xu          , Zw          , Yr^Xp         , Xu          , Xu          , Xu          , Xu          , Xu          , Xu          , Xu          , Xos         , Xu          , Xu          , Xu          , Xu          , Cud         , Cud         , Cud         , Cud         , Cud         , Cud         , Cud         , Cud         , Cud         , Xos         , Xg^Zse      , Ryd         , Ryd         , Ryd         , Uu^Uf       , Uu^Uf       , Uu^Uf       , Yr          , Xu          , Yr          , Xu          , Uu^Ii       , Xu          , Ryd         , Uu^Uf       , Uh          , Zw          , Yr          , Ryd
Xu          , Xu          , Xu          , Xu          , Xu          , Xu          , Xu          , Xu          , Xu          , Xu          , Xu          , Xu          , Xu          , Xu          , Xu          , Xu          , Xu          , Xu          , Xu          , Xu          , Xu          , Xos         , Xos         , Xos         , Xos         , Xos         , Xos         , Xos         , Xos         , Xos         , Xos         , Xos         , Xos         , Xos         , Xos         , Xos         , Ryd         , Ryd         , Ryd         , Ryd         , Yl          , Uu^Uf       , Zw          , Yr          , Uh          , Yl          , Yl          , Zw          , Zw          , Uu^Uf       , Uu^Uf       , Zw          , Yl          , Yr          
Xu          , Xu          , Xu          , Xu          , Xu          , Xu          , Aa          , Xu          , Xu          , Xu          , Aa          , Xu          , Xu          , Xu          , Xu          , Xu          , Xu          , Xu          , Xu          , Xu          , Xu          , Xu          , Xu          , Xos         , Xos         , Xos         , Xos         , Xos         , Xos         , Xos         , Xos         , Xos         , Xos         , Xos         , Zw          , Xos         , Ryd         , Ryd         , Yr          , Yl          , Uu^Ii       , Uu^Uf       , Zw          , Yr          , Uh          , Yr          , Ryd         , Zw          , Zw          , Zw          , Uu^Ii       , Yr          , Yl          , Yr          
Xu          , Xu          , Xu          , Xu          , Aa          , Aa          , Xu          , Xu          , Aa          , Xu          , Xu          , Aa          , Aa          , Xu          , Xu          , Xu          , Xu          , Xu          , Xu          , Xu          , Xu          , Xu          , Xu          , Xu          , Yr          , Xos         , Xos         , Ryd         , Ryd         , Xos         , Yr          , Xos         , Zw          , Zw          , Ryd         , Zw          , Uu^Uf       , Yr          , Yr          , Yl          , Zw          , Zw          , Ryd         , Ryd         , Uh          , Ryd         , Zw          , Yl          , Zw          , Yr          , Zw          , Zw          , Uu^Uf       , Yr          
Xu          , Xu          , Aa          , Aa          , Xu          , Xu          , Aa          , Aa          , Xu          , Aa          , Aa          , Xu          , Xu          , Aa          , Aa          , Xu          , Xu          , Xu          , Xu          , Xu          , Uu^Ii       , Zw          , Zw          , Uu^Uf       , Uu          , Yr          , Yr          , Ryd         , Yr          , Yr          , Yr          , Zw          , Yr          , Ryd         , Yl          , Uu^Uf       , Uu^Uf       , Yr          , Yr          , Uh          , Uh          , Zw          , Uh          , Uh          , Xu          , Uh          , Uh          , Uu^Ii       , Uh          , Uh          , Yr          , Zw          , Uu^Uf       , Uu^Uf       
Xu          , Xu          , Xu          , Xu          , Aa          , Xu          , Xu          , Aa          , Aa          , Xu          , Xu          , Xu          , Aa          , Xu          , Xu          , Aa          , Aa          , Xu          , Xu          , Xu          , Xu          , Uu^Uf       , Uu^Uf       , Uu          , Ryd         , Ryd         , Ryd         , Ryd         , Zw          , Uu^Ii       , Yl          , Yl          , Zw          , Zw          , Yr          , Uu^Uf       , Yl          , Uu^Uf       , Uh          , Zw          , Yr          , Uh          , Xu          , Xu          , Xu          , Xu          , Xu          , Uh          , Yr          , Zw          , Yr          , Uu^Uf       , Yr          , Yl          
Xu          , Xu          , Aa          , Xu          , Xu          , Aa          , Aa          , Aa          , Xu          , Xu          , Aa          , Aa          , Aa          , Xu          , Xu          , Xu          , Xu          , Aa          , Aa          , Xu          , Xu          , Zw          , Uu          , Ryd         , Yr          , Ryd         , Yr          , Zw          , Yl          , Yl          , Yl          , Yr          , Yr          , Zw          , Yr          , Uu^Ii       , Yr          , Zw          , Zw          , Zw          , Uu^Uf       , Uh          , Xu          , Xu          , 2 Xu        , Xu          , Xu          , Uh          , Ryd         , Yr          , Zw          , Zw          , Ryd         , Ryd         
Xu          , Xu          , Xu          , Aa          , Aa          , Xu          , Xu          , Xu          , Aa          , Aa          , Xu          , Xu          , Aa          , Aa          , Aa          , Xu          , Aa          , Xu          , Xu          , Xu          , Xu          , Xu          , Zw          , Uh          , Yr          , Uu^Uf       , Uu^Ii       , Yl          , Yl          , Yl          , Ryd         , Yr          , Zw          , Ryd         , Ryd         , Yr          , Zw          , Zw          , Yl          , Uu^Uf       , Uu^Uf       , Uh          , Xu          , Xu          , Xu          , Xu          , Xu          , Uh          , Zw          , Zw          , Yr          , Uu^Ii       , Uu^Uf       , Yr          
Xu          , Xu          , Xu          , Xu          , Xu          , Aa          , Aa          , Xu          , Xu          , Xu          , Xu          , Xu          , Xu          , Xu          , Aa          , Aa          , Xu          , Xu          , Aa          , Xu          , Xu          , Xu          , Xu          , Uu          , Uu^Uf       , Uu          , Uu          , Uu          , Uu          , Ryd         , Uu^Uf       , Zw          , Zw          , Ryd         , Yr          , Yr          , Zw          , Zw          , Zw          , Uu^Uf       , Uh          , Uh          , Uh          , Xu          , Xu          , Xu          , Uh          , Uh          , Uh          , Zw          , Uu^Ii       , Yr          , Yr          , Uu^Uf       
Xu          , Xu          , Xu          , Xu          , Xu          , Xu          , Xu          , Aa          , Aa          , Xu          , Xu          , Xu          , Aa          , Aa          , Xu          , Xu          , Aa          , Aa          , Xu          , Xu          , Xu          , Xu          , Xu          , Yl          , Uu^Ii       , Uu          , Uu          , Uu          , Uu          , Uh          , Uu          , Uu^Uf       , Uu^Ii       , Yr          , Yr          , Ryd         , Zw          , Zw          , Uu^Ii       , Uh          , Yr          , Uu^Uf       , Yr          , Uh          , Uh          , Uh          , Yl          , Yl          , Yl          , Uh          , Ryd         , Ryd         , Ryd         , Yl          
Xu          , Xu          , Xu          , Xu          , Xu          , Xu          , Xu          , Xu          , Xu          , Aa          , Aa          , Xu          , Xu          , Xu          , Aa          , Aa          , Xu          , Xu          , Xu          , Xu          , Xu          , Xu          , Xu          , Xu          , Ryd         , Uu          , Uu          , Uu          , Uu          , Uu          , Uu          , Uu^Uf       , Ryd         , Yr          , Ryd         , Ryd         , Yr          , Yr          , Uu^Uf       , Uu^Uf       , Yl          , Yr          , Ryd         , Yr          , Uh          , Yr          , Zw          , Zw          , Ryd         , Yl          , Yr          , Uh          , Yl          , Yr          
Xu          , Xu          , Xu          , Xu          , Xu          , Xu          , Xu          , Xu          , Xu          , Xu          , Xu          , Xu          , Xu          , Xu          , Xu          , Xu          , Xu          , Xu          , Xu          , Xu          , Xu          , Xu          , Xu          , Ryd         , Zw          , Zw          , Ryd         , Zw          , Yr          , Uu          , Uu^Uf       , Uu^Uf       , Uu^Uf       , Ryd         , Yr          , Yr          , Ryd         , Zw          , Zw          , Ryd         , Zw          , Zw          , Uu^Uf       , Uu^Uf       , Uh          , Yr          , Yr          , Uu^Uf       , Uu^Uf       , Uu^Uf       , Yr          , Yr          , Yr          , Yr          
