border_size=1
usage=map

Zw          , Ryd         , Ryd         , Cud         , Cud         , Xu          , Xu          , Xu          , Xu          , Xos         , Xos         , Xos         , Xos         , Xos         , Xu          , Xu          , Xu          , Xu          , Xu          , Xu          , Xu          , Xu          , Yl          , Ryd         , Ryd         , Uu^Uf       , Yl          , Yl          , Xu          , Xu          , Xu          , Xu          , Xu          , Xu          , Xu          , Xu          , Xu          , Xu          , Xu          , Xu          , Xu          , Xu          , Xu          , Xu          , Xu          , Xu          , Xu          , Xu          , Xu          , Xu          , Xu          , Xu          , Xu          , Xu          
Zw          , Zw          , Zw          , Ryd         , Ryd         , Cud         , Xu          , Xu          , Cud         , Ryd         , Ryd         , Uh^Ii       , Uh          , Uh          , Yl          , Xu          , Zw          , Yl^Xp       , Xu          , Xu          , Xu          , Uu^Uf       , Uu^Uf       , Ryd         , Yl          , Yl          , Xu          , Xu          , Uh          , Xu          , Yl          , Xu          , Uh          , Xu          , Uh          , Xu          , Xu          , Xu          , Xu          , Xu          , Xu          , Xu          , Xu          , Xu          , Xu          , Xu          , Xu          , Xu          , Xu          , Xu          , Xu          , Xu          , Xu          , Xu          
Ryd         , Zw          , Zw          , Zw          , Zw          , Xg^Zse      , Ryd         , Cud         , Cud         , Kud         , Uh          , Uh^Ii       , Yl          , Yl          , Qxv         , Yl          , Yl          , Xu          , Zw          , Yl^Xp       , Xu          , Xu          , Uu^Uf       , Yl          , Ryd         , Yl          , Uu^Uf       , Xu          , Xu          , Yl          , Yr          , Yl          , Xu          , Xu          , Yl          , Xu          , Uh          , Xu          , Xu          , Xu          , Xu          , Xu          , Xu          , Xu          , Xu          , Xu          , Xu          , Xu          , Xu          , Xu          , Xu          , Xu          , Xu          , Xu          
Cud         , Ryd         , Xg^Zse      , Zw          , Zw          , Zw          , Zw          , Ryd         , Ryd         , Ryd         , Yl          , Yl          , Qxv         , Qxv         , Qxv         , Qxv         , Qxv         , Yl          , Yl          , Xu          , Xu          , Xu          , Yl          , Ryd         , Ryd         , Uu^Uf       , Xu          , Xu          , Uu          , Yl          , Yl          , Yl          , Xu          , Yl          , Yr          , Yl          , Xu          , Xu          , Xu          , Xu          , Xu          , Xu          , Xu          , Xu          , Xu          , Xu          , Xu          , Xu          , Xu          , Xu          , Xu          , Xu          , Xu          , Xu          
Xu          , Xu          , Cud         , Ryd         , Ryd         , Zw          , Zw          , Zw          , Zw          , Ryd         , Yl          , Qxv         , Qxv         , Uu^Ii       , Qxv         , Qxv         , Qxv         , Qxv         , Yl          , Yl          , Yl          , Xu          , Xg^Zsw      , Ryd         , Yl          , Yl          , Xu          , Xu          , Yl^Xp       , Xu          , Xu          , Xu          , Uu          , Yl          , Yl          , Yl          , Xu          , Xu          , Xu          , Xu          , Xu          , Xu          , Xu          , Xu          , Xu          , Xu          , Xu          , Xu          , Xu          , Xu          , Xu          , Xu          , Xu          , Xu          
Uu^Uf       , Cud         , Kud         , Cud         , Ryd         , Ryd         , Ryd         , 1 Zw        , Zw          , Ryd         , Ryd         , Yl          , Yl          , Qxv         , Qxv         , Qxv         , Yl          , Yl          , Ryd         , Ryd         , Yl          , Yl          , Uu          , Xg^Zsw      , Xu          , Xu          , Yl^Xp       , Re^Uf       , Ww          , Re^Uf       , Yl^Xp       , Uu          , Xu          , Xu          , Xu          , Xu          , Yl          , Xu          , Uh          , Xu          , Xu          , Xu          , Xu          , Xu          , Xu          , Xu          , Xu          , Xu          , Xu          , Xu          , Xu          , Xu          , Xu          , Xu          
Uh^Ii       , Uh^Ii       , Ryd         , Ryd         , Yl          , Yl          , Yl          , Ryd         , Ryd         , Ryd         , Ryd         , Ryd         , Ryd         , Yl          , Yl          , Yl          , Ryd         , Ryd         , Yl          , Yl          , Uu^Uf       , Uu^Uf       , Uu          , Uu^Uf       , Cud         , Xu          , Uu          , Wo          , Wo          , Ww          , Re^Uf       , Xu          , Xu          , Xu          , Xu          , Yl          , Yr          , Yl          , Xu          , Xu          , Xu          , Xu          , Xu          , Xu          , Xu          , Xu          , Xu          , Xu          , Xu          , Xu          , Xu          , Xu          , Xu          , Xu          
Ryd         , Ryd         , Yl          , Yl          , Qxv         , Qxv         , Qxv         , Yl          , Yl          , Ryd         , Uu^Uf       , Ryd         , Ryd         , Ryd         , Ryd         , Ryd         , Ryd         , Yl          , Yl          , Yl          , Yl          , Re^Uf       , Re^Uf       , Cud         , 5 Kud       , Cud         , Uu          , Uu^Uf       , Re^Uf       , Wo          , Wo          , Yl^Xp       , Re^Uf       , Xu          , Uu          , Yl          , Yl          , Yl          , Uh          , Xu          , Xu          , Xu          , Xu          , Xu          , Xu          , Xu          , Xu          , Xu          , Xu          , Xu          , Xu          , Xu          , Xu          , Xu          
Ryd         , Yl          , Qxv         , Qxv         , Qxv         , Uu^Ii       , Qxv         , Qxv         , Qxv         , Yl          , Uu^Uf       , Uu^Ufi      , Yr^Ii       , Ryd         , Ryd         , Ryd         , Ryd         , Ryd         , Yl          , Yl          , Uh          , Uu          , Uh          , Cud         , Cud         , Uu          , Uu          , Uu^Uf       , Re^Uf       , Wo          , Wo          , Wo          , Yl^Xp       , Uu          , Xu          , Xu          , Uh          , Xu          , Xu          , Xu          , Xu          , Xu          , Xu          , Xu          , Xu          , Xu          , Xu          , Xu          , Xu          , Xu          , Xu          , Xu          , Xu          , Xu          
Ryd         , Yl          , Yl          , Qxv         , Qxv         , Qxv         , Qxv         , Qxv         , Yl          , Uu^Uf       , Yl          , Yr^Xp       , Cud         , Yr^Xp       , Yr          , Ryd         , Yl          , Yl          , Uu^Uf       , Uh          , Uu          , Uu          , Uh          , Uh          , Uh          , Re^Uf       , Uu          , Re^Uf       , Ww          , Wo          , Wo          , Ww          , Re^Uf       , Xu          , Xu          , Xu          , Xu          , Xu          , Xu          , Xu          , Xu          , Xu          , Xu          , Xu          , Xu          , Xu          , Xu          , Xu          , Xu          , Xu          , Xu          , Xu          , Xu          , Xu          
Ryd         , Ryd         , Ryd         , Yl          , Yl          , Qxv         , Yl          , Yl          , Uu^Uf       , Uu^Uf       , Yl^Xp       , Cud         , 4 Kud       , Cud         , Yl^Xp       , Yr          , Yr^Ii       , Ryd         , Ryd         , Uh          , Uu^Uf       , Uu^Uf       , Uu          , Uu          , Uh          , Uu^Uf       , Re^Uf       , Uu^Uf       , Re^Uf       , Yl^Xp       , Re^Uf       , Yl^Xp       , Uu          , Xu          , Xu          , Uh          , Xu          , Xu          , Xu          , Xu          , Xos         , Xos         , Xos         , Xu          , Xu          , Xu          , Xu          , Xu          , Xu          , Xu          , Xu          , Xu          , Xu          , Xu          
Uu          , Uu          , Xu          , Zw          , Zw          , Yl          , Xu          , Xu          , Xu          , Uu^Uf       , Yl          , Cud         , Cud         , Cud         , Uu^Ufi      , Yr^Ii       , Uu^Uf       , Ryd         , Ryd         , Uu^Uf       , Cud         , Uu^Uf       , Xos         , Uu^Uf       , Xos         , Uh          , Xos         , Xos         , Xos         , Uu          , Xos         , Uu          , Xos         , Uu          , Yl          , Yl          , Yl          , Uh          , Xos         , Xos         , Xos         , Xos         , Xos         , Xos         , Xos         , Xu          , Xu          , Xu          , Xu          , Xu          , Xu          , Xu          , Xu          , Xu          
Uu^Uf       , Uu^Uf       , Xu          , Yl^Xp       , Xu          , Zw          , Zw          , Yl^Xp       , Xu          , Yl          , Yl          , Yl          , Yl          , Yl^Xp       , Uh          , Uu^Ufi      , Uu^Ufi      , Uu^Uf       , Ryd         , Ryd         , Xg^Zse      , Xos         , Cud         , Xos         , Cud         , Xos         , Xos         , Xos         , Xos         , Uh          , Xos         , Uh          , Xos         , Xos         , Yl          , Yr          , Yl          , Xos         , Xos         , Xos         , Xos         , Xos         , Xos         , Xos         , Xos         , Xos         , Xos         , Xu          , Xu          , Xu          , Xu          , Xu          , Xu          , Xu          
Uu^Uf       , Xu          , Yl^Xp       , Xu          , Yl^Xp       , Xu          , Yl^Xp       , Zw          , Zw          , Uu^Uf       , Yl          , Uu^Uf       , Xu          , Uu^Ufi      , Uu^Uf       , Uu          , Uu^Ufi      , Cud         , Xos         , Xg^Zse      , Ryd         , Ryd         , Ryd         , Cud         , Uu          , Cud         , Cud         , Xos         , Xos         , Xos         , Xos         , Xos         , Xos         , Uh          , Xos         , Yl          , Xos         , Uh          , Xos         , Xos         , Ryd         , Ryd         , Ryd         , Xos         , Xos         , Xos         , Xos         , Xos         , Xos         , Xu          , Xu          , Xu          , Xu          , Xu          
Xu          , Xu          , Zw          , Xu          , Zw          , Xu          , Xu          , Xu          , Uu^Uf       , Zw          , Yl          , Uu^Uf       , Xu          , Xu          , Xu          , Uu^Ufi      , Uu^Ufi      , Xos         , Xos         , Xos         , Cud         , Ryd         , Ryd         , Ryd         , Uu          , Uu          , Uu^Uf       , Cud         , Cud         , Cud         , Cud         , Xos         , Xos         , Xos         , Xos         , Uh          , Xos         , Xos         , Xos         , Xos         , Ryd         , Uu^Ii       , Ryd         , Xu          , Xu          , Xos         , Xos         , Xos         , Xos         , Xos         , Xos         , Xu          , Xu          , Xu          
Xos         , Xos         , Yl          , Ryd         , Yl          , Yl          , Zw          , Zw          , Zw          , Zw          , Yl          , Zw          , Yl          , Uu^Uf       , Xu          , Uh          , Xu          , Xu          , Uu^Ii       , Xos         , Cud         , Ryd         , Ryd         , Ryd         , Ryd         , Uh          , Uh          , Uu^Uf       , Uu          , Uu^Uf       , Uu^Uf       , Cud         , Cud         , Cud         , Cud         , Xos         , Xos         , Xos         , Ryd         , Ryd         , Ryd         , Ryd         , Xu          , Xu          , Ryd         , Ryd         , Ryd         , Xos         , Xos         , Xos         , Xos         , Xos         , Xos         , Xu          
Xos         , Uu^Uf       , Zw          , Zw          , Ryd         , Ryd         , Zw          , Zw          , Uu^Uf       , Uu^Uf       , Yl          , Uu^Uf       , Xu          , Zw          , Yl^Xp       , Xu          , Uh          , Uh          , Uh          , Xos         , Xos         , Cud         , Cud         , Ryd         , Ryd         , Ryd         , Uh          , Uh          , Uh          , Uu          , Uu          , Uu          , Uh          , Uu^Uf       , Uh          , Cud         , Ryd         , Xg^Zsw      , Xg^Zsw      , Ryd         , Xu          , Xu          , Xu          , Xu          , Yl          , Uu^Ii       , Ryd         , Xos         , Xos         , Xos         , Xos         , Xos         , Xos         , Xos         
Re^Uf       , Uu^Ii       , Zw          , Zw          , Xu          , Xu          , Xu          , Ryd         , Zw          , Uu^Uf       , Xu          , Zw          , Yl^Xp       , Xu          , Xu          , Xu          , Yl          , Uh          , Yl          , Uh          , Xos         , Xos         , Xos         , Cud         , Ryd         , Ryd         , Ryd         , Uu          , Uu          , Uu^Uf       , Uu          , Uu          , Ryd         , Uh          , Ryd         , Ryd         , Ryd         , Ryd         , Cud         , Xu          , Xu          , Xu          , Xu          , Xu          , Yl          , Yl          , Xos         , Xos         , Xu          , Xos         , Xos         , Xos         , Xos         , Xos         
Zw          , Zw          , Zw          , Ryd         , Xu          , Yl^Xp       , Ryd         , Ryd         , Xu          , Zw          , Yl^Xp       , Xu          , Xu          , Xu          , Xu          , Yl^Xp       , Xu          , Zw          , Zw          , Yl          , Cud         , Xos         , Xos         , Cud         , Cud         , Ryd         , Ryd         , Ryd         , Ryd         , Ryd         , Ryd         , Ryd         , Cud         , Ryd         , Ryd         , Ryd         , Ryd         , Ryd         , Ryd         , Cud         , Cud         , Xu          , Xg^Zsw      , Ryd         , Yl          , Yl          , Xu          , Xu          , Xu          , Xos         , Xos         , Xos         , Xos         , Xos         
Zw          , Uu^Ii       , Ryd         , Ryd         , Re^Uf       , Xu          , Zw          , Zw          , Xu          , Xu          , Xu          , Xu          , Xu          , Yl^Xp       , Xu          , Xu          , Xu          , Uh          , Yl          , Ryd         , Ryd         , Cud         , Cud         , Xos         , Xos         , Cud         , Ryd         , Ryd         , Ryd         , Ryd         , Cud         , Cud         , Uu^Cd       , Cud         , Cud         , Ryd         , Ryd         , Ryd         , Ryd         , Ryd         , Ryd         , Ryd         , Ryd         , Xg^Zsw      , Xu          , Xu          , Xu          , Uu^Ii       , Xu          , Xos         , Xos         , Xos         , Yl^Xp       , Yl          
Zw          , Yl          , Re^Uf       , Ryd         , Ryd         , Re^Uf       , Re^Uf       , Xu          , Yl^Xp       , Zw          , Ryd         , Yl^Xp       , Xu          , Zw          , Xu          , Yl^Xp       , Yl          , Yl          , Xu          , Xu          , Cud         , Ryd         , Ryd         , Cud         , Xos         , Cud         , Ryd         , Ryd         , Ryd         , Ryd         , Cud         , Uu^Cd       , 3 Uu^Kd     , Uu^Cd       , Cud         , Ryd         , Ryd         , Ryd         , Ryd         , Ryd         , Ryd         , Ryd         , Xu          , Xu          , Xu          , Xu          , Xu          , Zw          , Xu          , Xos         , Ryd         , Yl^Xp       , Xos         , Xos         
Uu^Uf       , Zw          , Re^Uf       , Yl          , Yl          , Re^Uf       , Re^Uf       , Xu          , Xu          , Xu          , Xu          , Yl          , Re^Uf       , Re^Uf       , Zw          , Yl          , Yl          , Uu^Ii       , Xu          , Xu          , Xu          , Cud         , Ryd         , Cud         , Xos         , Cud         , Cud         , Ryd         , Ryd         , Ryd         , Cud         , Uu^Cd       , Uu^Cd       , Uu^Cd       , Cud         , Ryd         , Ryd         , Ryd         , Cud         , Ryd         , Xg^Zse      , Xg^Zse      , Ryd         , Xu          , Ryd         , Uu^Ii       , Ryd         , Ryd         , Xu          , Yl^Xp       , Ryd         , Yl          , Yl^Xp       , Xos         
Uu^Ufi      , Uu^Ufi      , Re^Uf       , Zw          , Ryd         , Yl          , Ryd         , Yl          , Ryd         , Xu          , Zw          , Zw          , Re^Uf       , Re^Uf       , Zw          , Ryd         , Xu          , Yl          , Xu          , Xu          , Xu          , Cud         , Ryd         , Cud         , Cud         , Xos         , Cud         , Ryd         , Ryd         , Ryd         , Ryd         , Cud         , Cud         , Cud         , Ryd         , Ryd         , Ryd         , Ryd         , Cud         , Xos         , Xos         , Ryd         , Ryd         , Uu^Ii       , Ryd         , Ryd         , Ryd         , Uu^Ii       , Xu          , Yl          , Yl          , Uu^Ii       , Zw          , Yl          
Xu          , Xu          , Zw          , Zw          , Re^Uf       , Ryd         , Yl          , Ryd         , Ryd         , Yl          , Zw          , Zw          , Ryd         , Zw          , Xu          , Zw          , Yl^Xp       , Xu          , Xu          , Xu          , Xu          , Cud         , Cud         , Ryd         , Ryd         , Cud         , Ryd         , Ryd         , Ryd         , Ryd         , Ryd         , Ryd         , Ryd         , Ryd         , Ryd         , Ryd         , Ryd         , Cud         , Xos         , Xos         , Xos         , Xos         , Xos         , Ryd         , Uu^Ii       , Ryd         , Uu^Ii       , Ryd         , Xu          , Yl^Xp       , Yl^Xp       , Zw          , Zw          , Zw          
Xu          , Xu          , Yl^Xp       , Zw          , Xu          , Re^Uf       , Re^Uf       , Zw          , Zw          , Zw          , Ryd         , Yl          , Xu          , Zw          , Yl^Xp       , Xu          , Xu          , Xu          , Xu          , Xu          , Xu          , Xu          , Xu          , Cud         , Cud         , Ryd         , Ryd         , Ryd         , Ryd         , Ryd         , Ryd         , Ryd         , Ryd         , Ryd         , Ryd         , Ryd         , Xg^Zse      , Xos         , Xos         , Xos         , Xu          , Xu          , Xu          , Xos         , Xu          , Xu          , Xu          , Xu          , Xu          , Yl^Xp       , Yl          , Zw          , Uu^Ii       , Zw          
Xu          , Xu          , Xu          , Xu          , Yl^Xp       , Zw          , Xu          , Yl          , Xu          , Uu^Ii       , Xu          , Zw          , Yl^Xp       , Xu          , Xu          , Xu          , Xu          , Xu          , Xu          , Xu          , Xos         , Xu          , Xu          , Xu          , Xu          , Cud         , Cud         , Cud         , Cud         , Cud         , Cud         , Cud         , Cud         , Cud         , Xos         , Xg^Zse      , Ryd         , Ryd         , Ryd         , Uu^Uf       , Uu^Uf       , Uu^Uf       , Yl^Xp       , Xu          , Yl^Xp       , Xu          , Uu^Ii       , Xu          , Ryd         , Uu^Uf       , Uh          , Zw          , Yl          , Ryd         
Xu          , Xu          , Xu          , Xu          , Xu          , Xu          , Xu          , Xu          , Xu          , Xu          , Xu          , Xu          , Xu          , Xu          , Xu          , Xu          , Xu          , Xu          , Xu          , Xu          , Xu          , Xos         , Xos         , Xos         , Xos         , Xos         , Xos         , Xos         , Xos         , Xos         , Xos         , Xos         , Xos         , Xos         , Xos         , Xos         , Ryd         , Ryd         , Ryd         , Ryd         , Yl          , Uu^Uf       , Zw          , Yl          , Uh          , Yl          , Yl^Xp       , Zw          , Zw          , Uu^Uf       , Uu^Uf       , Zw          , Yl^Xp       , Yl          
Xu          , Xu          , Xu          , Xu          , Xu          , Xu          , Aa          , Xu          , Xu          , Xu          , Aa          , Xu          , Xu          , Xu          , Xu          , Xu          , Xu          , Xu          , Xu          , Xu          , Xu          , Xu          , Xu          , Xos         , Xos         , Xos         , Xos         , Xos         , Xos         , Xos         , Xos         , Xos         , Xos         , Xos         , Zw          , Xos         , Ryd         , Ryd         , Yl          , Yl^Xp       , Uu^Ii       , Uu^Uf       , Zw          , Yl^Xp       , Uh          , Yl^Xp       , Ryd         , Zw          , Zw          , Zw          , Uu^Ii       , Yl^Xp       , Yl          , Yl          
Xu          , Xu          , Xu          , Xu          , Aa          , Aa          , Xu          , Xu          , Aa          , Xu          , Xu          , Aa          , Aa          , Xu          , Xu          , Xu          , Xu          , Xu          , Xu          , Xu          , Xu          , Xu          , Xu          , Xu          , Yl          , Xos         , Xos         , Ryd         , Ryd         , Xos         , Yl          , Xos         , Zw          , Zw          , Ryd         , Zw          , Uu^Uf       , Yl^Xp       , Yl^Xp       , Yl          , Zw          , Zw          , Ryd         , Ryd         , Uh          , Ryd         , Zw          , Yl^Xp       , Zw          , Yl          , Zw          , Zw          , Uu^Uf       , Yl^Xp       
Xu          , Xu          , Aa          , Aa          , Xu          , Xu          , Aa          , Aa          , Xu          , Aa          , Aa          , Xu          , Xu          , Aa          , Aa          , Xu          , Xu          , Xu          , Xu          , Xu          , Uu^Ii       , Zw          , Zw          , Uu^Uf       , Uu          , Yl^Xp       , Yl          , Ryd         , Yl          , Yl          , Yl          , Zw          , Yl          , Ryd         , Yl          , Uu^Uf       , Uu^Uf       , Yl          , Yl^Xp       , Uh          , Uh          , Zw          , Uh          , Uh          , Xu          , Uh          , Uh          , Uu^Ii       , Uh          , Uh          , Yl          , Zw          , Uu^Uf       , Uu^Uf       
Xu          , Xu          , Xu          , Xu          , Aa          , Xu          , Xu          , Aa          , Aa          , Xu          , Xu          , Xu          , Aa          , Xu          , Xu          , Aa          , Aa          , Xu          , Xu          , Xu          , Xu          , Uu^Uf       , Uu^Uf       , Uu          , Ryd         , Ryd         , Ryd         , Ryd         , Zw          , Uu^Ii       , Yl^Xp       , Yl^Xp       , Zw          , Zw          , Yl^Xp       , Uu^Uf       , Yl          , Uu^Uf       , Uh          , Zw          , Yl^Xp       , Uh          , Xu          , Xu          , Xu          , Xu          , Xu          , Uh          , Yl          , Zw          , Yl^Xp       , Uu^Uf       , Yl          , Yl^Xp       
Xu          , Xu          , Aa          , Xu          , Xu          , Aa          , Aa          , Aa          , Xu          , Xu          , Aa          , Aa          , Aa          , Xu          , Xu          , Xu          , Xu          , Aa          , Aa          , Xu          , Xu          , Zw          , Uu          , Ryd         , Yl          , Ryd         , Yl          , Zw          , Yl          , Yl          , Yl^Xp       , Yl^Xp       , Yl          , Zw          , Yl          , Uu^Ii       , Yl          , Zw          , Zw          , Zw          , Uu^Uf       , Uh          , Xu          , Xu          , 2 Xu        , Xu          , Xu          , Uh          , Ryd         , Yl          , Zw          , Zw          , Ryd         , Ryd         
Xu          , Xu          , Xu          , Aa          , Aa          , Xu          , Xu          , Xu          , Aa          , Aa          , Xu          , Xu          , Aa          , Aa          , Aa          , Xu          , Aa          , Xu          , Xu          , Xu          , Xu          , Xu          , Zw          , Uh          , Yl^Xp       , Uu^Uf       , Uu^Ii       , Yl^Xp       , Yl          , Yl^Xp       , Ryd         , Yl          , Zw          , Ryd         , Ryd         , Yl^Xp       , Zw          , Zw          , Yl^Xp       , Uu^Uf       , Uu^Uf       , Uh          , Xu          , Xu          , Xu          , Xu          , Xu          , Uh          , Zw          , Zw          , Yl^Xp       , Uu^Ii       , Uu^Uf       , Yl^Xp       
Xu          , Xu          , Xu          , Xu          , Xu          , Aa          , Aa          , Xu          , Xu          , Xu          , Xu          , Xu          , Xu          , Xu          , Aa          , Aa          , Xu          , Xu          , Aa          , Xu          , Xu          , Xu          , Xu          , Yl^Xp       , Uu^Uf       , Uu          , Uu          , Uu          , Uu          , Ryd         , Uu^Uf       , Zw          , Zw          , Ryd         , Yl          , Yl          , Zw          , Zw          , Zw          , Uu^Uf       , Uh          , Uh          , Uh          , Xu          , Xu          , Xu          , Uh          , Uh          , Uh          , Zw          , Uu^Ii       , Yl^Xp       , Yl          , Uu^Uf       
Xu          , Xu          , Xu          , Xu          , Xu          , Xu          , Xu          , Aa          , Aa          , Xu          , Xu          , Xu          , Aa          , Aa          , Xu          , Xu          , Aa          , Aa          , Xu          , Xu          , Xu          , Xu          , Xu          , Yl          , Uu^Ii       , Uu          , Uu          , Uu          , Uu          , Uh          , Uu          , Uu^Uf       , Uu^Ii       , Yl^Xp       , Yl          , Ryd         , Zw          , Zw          , Uu^Ii       , Uh          , Yl          , Uu^Uf       , Yl          , Uh          , Uh          , Uh          , Yl          , Yl^Xp       , Yl          , Uh          , Ryd         , Ryd         , Ryd         , Yl          
Xu          , Xu          , Xu          , Xu          , Xu          , Xu          , Xu          , Xu          , Xu          , Aa          , Aa          , Xu          , Xu          , Xu          , Aa          , Aa          , Xu          , Xu          , Xu          , Xu          , Xu          , Xu          , Xu          , Xu          , Ryd         , Uu          , Uu          , Uu          , Uu          , Uu          , Uu          , Uu^Uf       , Ryd         , Yl          , Ryd         , Ryd         , Yl^Xp       , Yl          , Uu^Uf       , Uu^Uf       , Yl          , Yl          , Ryd         , Yl^Xp       , Uh          , Yl^Xp       , Zw          , Zw          , Ryd         , Yl          , Yl          , Uh          , Yl          , Yl          
Xu          , Xu          , Xu          , Xu          , Xu          , Xu          , Xu          , Xu          , Xu          , Xu          , Xu          , Xu          , Xu          , Xu          , Xu          , Xu          , Xu          , Xu          , Xu          , Xu          , Xu          , Xu          , Xu          , Ryd         , Zw          , Zw          , Ryd         , Zw          , Yl          , Uu          , Uu^Uf       , Uu^Uf       , Uu^Uf       , Ryd         , Yl          , Yl          , Ryd         , Zw          , Zw          , Ryd         , Zw          , Zw          , Uu^Uf       , Uu^Uf       , Uh          , Yl          , Yl          , Uu^Uf       , Uu^Uf       , Uu^Uf       , Yl          , Yl          , Yl          , Yl          
