border_size=1
usage=map

Zw          , Urb         , Urb         , Cud         , Cud         , Xu          , Xu          , Xu          , Xu          , Xos         , Xos         , Xos         , Xos         , Xos         , Xu          , Xu          , Xu          , Xu          , Xu          , Xu          , Xu          , Xu          , Yhl         , Urb         , Urb         , Uu^Uf       , Yhl         , Yhl         , Xu          , Xu          , Xu          , Xu          , Xu          , Xu          , Xu          , Xu          , Xu          , Xu          , Xu          , Xu          , Xu          , Xv          , Xv          , Xv          , Xv          , Xv          , Xv          , Xv          , Xv          , Xv          , Xv          , Xv          , Xv          , Xv          
Zw          , Zw          , Zw          , Urb         , Urb         , Cud         , Xu          , Xu          , Cud         , Urb         , Urb         , Uh^Ii       , Uh          , Uh          , Yhl         , Xu          , Zw          , Yhl^Xp      , Xu          , Xu          , Xu          , Uu^Uf       , Uu^Uf       , Urb         , Yhl         , Yhl         , Xu          , Xu          , Uh          , Xu          , Yhl         , Xu          , Uh          , Xu          , Uh          , Xu          , Xu          , Xu          , Xu          , Xu          , Xu          , Xv          , Xv          , Xv          , Xv          , Xv          , Xv          , Xv          , Xv          , Xv          , Xv          , Xv          , Xv          , Xv          
Urb         , Zw          , Zw          , Zw          , Zw          , Urb^Z/      , Urb         , Cud         , Cud         , Cud         , Uh          , Uh^Ii       , Yhl         , Yhl         , Qxv         , Yhl         , Yhl         , Xu          , Zw          , Yhl^Xp      , Xu          , Xu          , Uu^Uf       , Yhl         , Urb         , Yhl         , Uu^Uf       , Xu          , Xu          , Yhl         , Yhr         , Yhl         , Xu          , Xu          , Yhl         , Xu          , Uh          , Xu          , Xu          , Xu          , Xu          , Xv          , Xv          , Xv          , Xv          , Xv          , Xv          , Xv          , Xv          , Xv          , Xv          , Xv          , Xv          , Xv          
Cud         , Urb         , Urb^Z/      , Zw          , Zw          , Zw          , Zw          , Urb         , Urb         , Urb         , Yhl         , Yhl         , Qxv         , Qxv         , Qxv         , Qxv         , Qxv         , Yhl         , Yhl         , Xu          , Xu          , Xu          , Yhl         , Urb         , Urb         , Uu^Uf       , Xu          , Xu          , Uu          , Yhl         , Yhl         , Yhl         , Xu          , Yhl         , Yhr         , Yhl         , Xu          , Xu          , Xu          , Xu          , Xu          , Xv          , Xv          , Xv          , Xv          , Xv          , Xv          , Xv          , Xv          , Xv          , Xv          , Xv          , Xv          , Xv          
Xu          , Xu          , Cud         , Urb         , Urb         , Zw          , Ce          , Ce          , Ce          , Urb         , Yhl         , Qxv         , Qxv         , Uu^Ii       , Qxv         , Qxv         , Qxv         , Qxv         , Yhl         , Yhl         , Yhl         , Xu          , Urb^Z\      , Urb         , Yhl         , Yhl         , Xu          , Xu          , Yhl^Xp      , Xu          , Xu          , Xu          , Uu          , Yhl         , Yhl         , Yhl         , Xu          , Xu          , Xu          , Xu          , Xu          , Xv          , Xv          , Xv          , Xv          , Xv          , Xv          , Xv          , Xv          , Xv          , Xv          , Xv          , Xv          , Xv          
Uu^Uf       , Cud         , Cud         , Cud         , Urb         , Urb         , Ce          , 1 Ke        , Ce          , Urb         , Urb         , Yhl         , Yhl         , Qxv         , Qxv         , Qxv         , Yhl         , Yhl         , Urb         , Urb         , Yhl         , Yhl         , Uu          , Urb^Z\      , Xu          , Xu          , Yhl^Xp      , Re^Uf       , Ww          , Re^Uf       , Yhl^Xp      , Uu          , Xu          , Xu          , Xu          , Xu          , Yhl         , Xu          , Uh          , Xu          , Xu          , Xv          , Xv          , Xv          , Xv          , Xv          , Xv          , Xv          , Xv          , Xv          , Xv          , Xv          , Xv          , Xv          
Uh^Ii       , Uh^Ii       , Urb         , Urb         , Yhl         , Yhl         , Yhl         , Ce          , Urb         , Zw          , Zw          , Urb         , Urb         , Yhl         , Yhl         , Yhl         , Urb         , Urb         , Yhl         , Yhl         , Uu^Uf       , Uu^Uf       , Uu          , Uu^Uf       , Cud         , Xu          , Uu          , Wo          , Wo          , Ww          , Re^Uf       , Xu          , Xu          , Xu          , Xu          , Yhl         , Yhr         , Yhl         , Xu          , Xu          , Xu          , Xv          , Xv          , Xv          , Xv          , Xv          , Xv          , Xv          , Xv          , Xv          , Xv          , Xv          , Xv          , Xv          
Urb         , Urb         , Yhl         , Yhl         , Qxv         , Qxv         , Qxv         , Yhl         , Yhl         , Urb         , Uu^Uf       , Zw          , Zw          , Urb         , Urb         , Urb         , Urb         , Yhl         , Yhl         , Yhl         , Yhl         , Re^Uf       , Re^Uf       , Cud         , 5 Kud       , Cud         , Uu          , Uu^Uf       , Re^Uf       , Wo          , Wo          , Yhl^Xp      , Re^Uf       , Xu          , Uu          , Yhl         , Yhl         , Yhl         , Uh          , Xu          , Xu          , Xv          , Xv          , Xv          , Xv          , Xv          , Xv          , Xv          , Xv          , Xv          , Xv          , Xv          , Xv          , Xv          
Urb         , Yhl         , Qxv         , Qxv         , Qxv         , Uu^Ii       , Qxv         , Qxv         , Qxv         , Yhl         , Uu^Uf       , Uu^Ufi      , Yhr^Ii      , Zw          , Zw          , Urb         , Urb         , Urb         , Yhl         , Yhl         , Uh          , Uu          , Uh          , Cud         , Cud         , Uu          , Uu          , Uu^Uf       , Re^Uf       , Wo          , Wo          , Wo          , Yhl^Xp      , Uu          , Xu          , Xu          , Uh          , Xu          , Xu          , Xu          , Xu          , Xv          , Xv          , Xv          , Xv          , Xv          , Xv          , Xv          , Xv          , Xv          , Xv          , Xv          , Xv          , Xv          
Urb         , Yhl         , Yhl         , Qxv         , Qxv         , Qxv         , Qxv         , Qxv         , Yhl         , Uu^Uf       , Yhl         , Yhr^Xp      , Cud         , Yhr^Xp      , Yhr         , Zw          , Yhl         , Yhl         , Uu^Uf       , Uh          , Uu          , Uu          , Uh          , Uh          , Uh          , Re^Uf       , Uu          , Re^Uf       , Ww          , Wo          , Wo          , Ww          , Re^Uf       , Xu          , Xu          , Xu          , Xu          , Xu          , Xu          , Xu          , Xu          , Xv          , Xv          , Xv          , Xv          , Xv          , Xv          , Xv          , Xv          , Xv          , Xv          , Xv          , Xv          , Xv          
Urb         , Urb         , Urb         , Yhl         , Yhl         , Qxv         , Yhl         , Yhl         , Uu^Uf       , Uu^Uf       , Yhl^Xp      , Cud         , 4 Kud       , Cud         , Yhl^Xp      , Yhr         , Yhr^Ii      , Urb         , Urb         , Uh          , Uu^Uf       , Uu^Uf       , Uu          , Uu          , Uh          , Uu^Uf       , Re^Uf       , Uu^Uf       , Re^Uf       , Yhl^Xp      , Re^Uf       , Yhl^Xp      , Uu          , Xu          , Xu          , Uh          , Xu          , Xu          , Xu          , Xu          , Xos         , Xv          , Xv          , Xv          , Xv          , Xv          , Xv          , Xv          , Xv          , Xv          , Xv          , Xv          , Xv          , Xv          
Uu          , Uu          , Xu          , Zw          , Zw          , Yhl         , Xu          , Xu          , Xu          , Uu^Uf       , Yhl         , Cud         , Cud         , Cud         , Uu^Ufi      , Yhr^Ii      , Uu^Uf       , Urb         , Urb         , Uu^Uf       , Cud         , Uu^Uf       , Xos         , Uu^Uf       , Xos         , Uh          , Xos         , Xos         , Xos         , Uu          , Xos         , Uu          , Xos         , Uu          , Yhl         , Yhl         , Yhl         , Uh          , Xos         , Xos         , Xos         , Xos         , Xos         , Xv          , Xv          , Xv          , Xv          , Xv          , Xv          , Xv          , Xv          , Xv          , Xv          , Xv          
Uu^Uf       , Uu^Uf       , Xu          , Yhl^Xp      , Xu          , Zw          , Zw          , Yhl^Xp      , Xu          , Yhl         , Yhl         , Yhl         , Yhl         , Yhl^Xp      , Uh          , Uu^Ufi      , Uu^Ufi      , Uu^Uf       , Urb         , Urb         , Urb^Z/      , Xos         , Cud         , Xos         , Cud         , Xos         , Xos         , Xos         , Xos         , Uh          , Xos         , Uh          , Xos         , Xos         , Yhl         , Yhr         , Yhl         , Xos         , Xos         , Xos         , Xos         , Xos         , Xos         , Xos         , Xos         , Xv          , Xv          , Xv          , Xv          , Xv          , Xv          , Xv          , Xv          , Xv          
Uu^Uf       , Xu          , Yhl^Xp      , Xu          , Yhl^Xp      , Xu          , Yhl^Xp      , Zw          , Zw          , Uu^Uf       , Yhl         , Uu^Uf       , Xu          , Uu^Ufi      , Uu^Uf       , Uu          , Uu^Ufi      , Cud         , Xos         , Urb^Z/      , Urb         , Urb         , Urb         , Cud         , Uu          , Cud         , Cud         , Xos         , Xos         , Xos         , Xos         , Xos         , Xos         , Uh          , Xos         , Yhl         , Xos         , Uh          , Xos         , Xos         , Urb         , Urb         , Urb         , Xos         , Xos         , Xos         , Xos         , Xv          , Xv          , Xv          , Xv          , Xv          , Xv          , Xv          
Xu          , Xu          , Zw          , Xu          , Zw          , Xu          , Xu          , Xu          , Uu^Uf       , Zw          , Yhl         , Uu^Uf       , Xu          , Xu          , Xu          , Uu^Ufi      , Uu^Ufi      , Xos         , Xos         , Xos         , Cud         , Urb         , Urb         , Urb         , Uu          , Uu          , Uu^Uf       , Cud         , Cud         , Cud         , Cud         , Xos         , Xos         , Xos         , Xos         , Uh          , Xos         , Xos         , Xos         , Xos         , Urb         , Uu^Ii       , Urb         , Xu          , Xu          , Xos         , Xos         , Xos         , Xos         , Xv          , Xv          , Xv          , Xv          , Xv          
Xos         , Xos         , Yhl         , Ur          , Yhl         , Yhl         , Zw          , Zw          , Zw          , Zw          , Yhl         , Zw          , Yhl         , Uu^Uf       , Xu          , Uh          , Xu          , Xu          , Uu^Ii       , Xos         , Cud         , Urb         , Urb         , Urb         , Urb         , Uh          , Uh          , Uu^Uf       , Zw          , Uu^Uf       , Uu^Uf       , Cud         , Cud         , Cud         , Cud         , Xos         , Xos         , Xos         , Urb         , Urb         , Urb         , Urb         , Xu          , Xu          , Urb         , Urb         , Urb         , Xos         , Xos         , Xos         , Xos         , Xv          , Xv          , Xv          
Xos         , Uu^Uf       , Zw          , Ur          , Ur          , Ur          , Zw          , Zw          , Uu^Uf       , Uu^Uf       , Yhl         , Uu^Uf       , Xu          , Zw          , Yhl^Xp      , Xu          , Uh          , Uh          , Uh          , Xos         , Xos         , Cud         , Cud         , Urb         , Urb         , Urb         , Uh          , Zw          , Uh          , Zw          , Uu          , Zw          , Uh          , Uu^Uf       , Uh          , Cud         , Urb         , Urb^Z\      , Urb^Z\      , Urb         , Xu          , Xu          , Xu          , Xu          , Yhl         , Uu^Ii       , Urb         , Xos         , Xos         , Xos         , Xos         , Xos         , Xos         , Xv          
Re^Uf       , Uu^Ii       , Zw          , Zw          , Xu          , Xu          , Xu          , Ur          , Zw          , Uu^Uf       , Xu          , Zw          , Yhl^Xp      , Xu          , Xu          , Xu          , Yhl         , Uh          , Yhl         , Uh          , Xos         , Xos         , Xos         , Cud         , Urb         , Urb         , Urb         , Uu          , Uu          , Uu^Uf       , Uu          , Zw          , Urb         , Uh          , Urb         , Urb         , Urb         , Urb         , Cud         , Xu          , Xu          , Xu          , Xu          , Xu          , Yhl         , Yhl         , Xos         , Xos         , Xu          , Xos         , Xos         , Xos         , Xos         , Xos         
Zw          , Zw          , Zw          , Ur          , Xu          , Yhl^Xp      , Ur          , Ur          , Xu          , Zw          , Yhl^Xp      , Xu          , Xu          , Xu          , Xu          , Yhl^Xp      , Xu          , Zw          , Zw          , Yhl         , Cud         , Xos         , Xos         , Cud         , Cud         , Urb         , Urb         , Urb         , Urb         , Urb         , Urb         , Urb         , Cud         , Urb         , Urb         , Urb         , Urb         , Urb         , Urb         , Cud         , Cud         , Xu          , Urb^Z\      , Urb         , Yhl         , Yhl         , Xu          , Xu          , Xu          , Xos         , Xos         , Xos         , Xos         , Xos         
Zw          , Uu^Ii       , Ur          , Ur          , Re^Uf       , Xu          , Zw          , Zw          , Xu          , Xu          , Xu          , Xu          , Xu          , Yhl^Xp      , Xu          , Xu          , Xu          , Uh          , Yhl         , Urb         , Urb         , Cud         , Cud         , Xos         , Xos         , Cud         , Urb         , Urb         , Urb         , Urb         , Cud         , Cud         , Uu^Cd       , Cud         , Cud         , Urb         , Urb         , Urb         , Urb         , Urb         , Urb         , Urb         , Urb         , Urb^Z\      , Xu          , Xu          , Xu          , Uu^Ii       , Xu          , Xos         , Xos         , Xos         , Yhl^Xp      , Yhl         
Zw          , Yhl         , Re^Uf       , Ur          , Ur          , Re^Uf       , Re^Uf       , Xu          , Yhl^Xp      , Zw          , Urb         , Yhl^Xp      , Xu          , Zw          , Xu          , Yhl^Xp      , Ur          , Ur          , Xu          , Xu          , Cud         , Urb         , Urb         , Cud         , Xos         , Cud         , Urb         , Urb         , Urb         , Urb         , Cud         , Uu^Cd       , 3 Uu^Kd     , Uu^Cd       , Cud         , Urb         , Urb         , Urb         , Urb         , Urb         , Urb         , Urb         , Xu          , Xu          , Xu          , Xu          , Xu          , Zw          , Xu          , Xos         , Urb         , Yhl^Xp      , Xos         , Xos         
Uu^Uf       , Zw          , Re^Uf       , Yhl         , Yhl         , Re^Uf       , Re^Uf       , Xu          , Xu          , Xu          , Xu          , Yhl         , Re^Uf       , Re^Uf       , Ur          , Ur          , Yhl         , Uu^Ii       , Xu          , Xu          , Xu          , Cud         , Urb         , Cud         , Xos         , Cud         , Cud         , Urb         , Urb         , Urb         , Cud         , Uu^Cd       , Uu^Cd       , Uu^Cd       , Cud         , Urb         , Urb         , Urb         , Cud         , Urb         , Urb^Z/      , Urb^Z/      , Urb         , Xu          , Urb         , Uu^Ii       , Urb         , Urb         , Xu          , Yhl^Xp      , Urb         , Yhl         , Yhl^Xp      , Xos         
Uu^Ufi      , Uu^Ufi      , Re^Uf       , Zw          , Ur          , Ur          , Ur          , Yhl         , Ur          , Xu          , Ur          , Ur          , Re^Uf       , Re^Uf       , Ur          , Ur          , Xu          , Yhl         , Xu          , Xu          , Xu          , Cud         , Urb         , Cud         , Cud         , Xos         , Cud         , Urb         , Urb         , Urb         , Urb         , Cud         , Cud         , Cud         , Urb         , Urb         , Urb         , Urb         , Cud         , Xos         , Xos         , Urb         , Urb         , Uu^Ii       , Urb         , Urb         , Urb         , Uu^Ii       , Xu          , Yhl         , Yhl         , Uu^Ii       , Zw          , Yhl         
Xu          , Xu          , Zw          , Zw          , Re^Uf       , Ur          , Yhl         , Ur          , Ur          , Yhl         , Ur          , Zw          , Urb         , Zw          , Xu          , Ur          , Yhl^Xp      , Xu          , Xu          , Xu          , Xu          , Cud         , Cud         , Urb         , Urb         , Cud         , Urb         , Urb         , Urb         , Urb         , Urb         , Urb         , Urb         , Urb         , Urb         , Urb         , Urb         , Cud         , Xos         , Xos         , Xos         , Xos         , Xos         , Urb         , Uu^Ii       , Urb         , Uu^Ii       , Urb         , Xu          , Yhl^Xp      , Yhl^Xp      , Zw          , Zw          , Zw          
Xu          , Xu          , Yhl^Xp      , Zw          , Xu          , Re^Uf       , Re^Uf       , Zw          , Zw          , Ur          , Urb         , Yhl         , Xu          , Zw          , Yhl^Xp      , Xu          , Xu          , Xu          , Xu          , Xu          , Xu          , Xu          , Xu          , Cud         , Cud         , Urb         , Urb         , Urb         , Urb         , Urb         , Urb         , Urb         , Urb         , Urb         , Urb         , Urb         , Urb^Z/      , Xos         , Xos         , Xos         , Xu          , Xu          , Xu          , Xos         , Xu          , Xu          , Xu          , Xu          , Xu          , Yhl^Xp      , Yhl         , Zw          , Uu^Ii       , Zw          
Xv          , Xu          , Xu          , Xu          , Yhl^Xp      , Zw          , Xu          , Yhl         , Xu          , Uu^Ii       , Xu          , Zw          , Yhl^Xp      , Xu          , Xu          , Xu          , Xu          , Xu          , Xv          , Xv          , Xv          , Xu          , Xu          , Xu          , Xu          , Cud         , Cud         , Cud         , Cud         , Cud         , Cud         , Cud         , Cud         , Cud         , Xos         , Urb^Z/      , Urb         , Urb         , Urb         , Uu^Uf       , Uu^Uf       , Uu^Uf       , Yhl^Xp      , Xu          , Yhl^Xp      , Xu          , Uu^Ii       , Xu          , Urb         , Uu^Uf       , Uh          , Zw          , Yhl         , Urb         
Xv          , Xv          , Xv          , Xu          , Xu          , Xu          , Xu          , Xu          , Xu          , Xu          , Xu          , Xu          , Xu          , Xu          , Xu          , Xu          , Xv          , Xv          , Xv          , Xv          , Xv          , Xv          , Xos         , Xos         , Xos         , Xos         , Xos         , Xos         , Xos         , Xos         , Xos         , Xos         , Xos         , Xos         , Xos         , Xos         , Urb         , Urb         , Urb         , Urb         , Yhl         , Uu^Uf       , Zw          , Yhl         , Uh          , Yhl         , Yhl^Xp      , Zw          , Zw          , Uu^Uf       , Uu^Uf       , Zw          , Yhl^Xp      , Yhl         
Xv          , Xv          , Xv          , Xv          , Xv          , Xu          , Xv          , Xu          , Xv          , Xu          , Xv          , Xu          , Xu          , Xu          , Xv          , Xv          , Xv          , Xv          , Xv          , Xv          , Xu          , Xu          , Xu          , Xos         , Xos         , Xos         , Xos         , Xos         , Xos         , Xos         , Xos         , Xos         , Xos         , Xos         , Zw          , Xos         , Urb         , Urb         , Yhl         , Yhl^Xp      , Uu^Ii       , Uu^Uf       , Zw          , Yhl^Xp      , Zw          , Yhl^Xp      , Urb         , Zw          , Zw          , Zw          , Uu^Ii       , Yhl^Xp      , Yhl         , Yhl         
Xv          , Xv          , Xv          , Xv          , Xv          , Xv          , Xv          , Xv          , Xv          , Xv          , Xv          , Xv          , Xv          , Xv          , Xv          , Xv          , Xv          , Xv          , Xu          , Xu          , Xu          , Xu          , Xu          , Xu          , Yhl         , Xos         , Xos         , Urb         , Urb         , Xos         , Yhl         , Xos         , Zw          , Zw          , Urb         , Zw          , Uu^Uf       , Yhl^Xp      , Yhl^Xp      , Yhl         , Zw          , Zw          , Urb         , Urb         , Zw          , Urb         , Zw          , Yhl^Xp      , Zw          , Yhl         , Zw          , Zw          , Uu^Uf       , Yhl^Xp      
Xv          , Xv          , Xv          , Xv          , Xv          , Xv          , Xv          , Xv          , Xv          , Xv          , Xv          , Xv          , Xv          , Xv          , Xv          , Xv          , Xv          , Xv          , Xu          , Xu          , Uu^Ii       , Zw          , Zw          , Uu^Uf       , Uu          , Yhl^Xp      , Yhl         , Urb         , Yhl         , Yhl         , Yhl         , Zw          , Yhl         , Urb         , Yhl         , Uu^Uf       , Uu^Uf       , Yhl         , Yhl^Xp      , Zw          , Uh          , Zw          , Yhr         , Zw          , Zw          , Zw          , Zw          , Uu^Ii       , Zw          , Zw          , Yhl         , Zw          , Uu^Uf       , Uu^Uf       
Xv          , Xv          , Xv          , Xv          , Xv          , Xv          , Xv          , Xv          , Xv          , Xv          , Xv          , Xv          , Xv          , Xv          , Xv          , Xv          , Xv          , Xv          , Xu          , Xu          , Xu          , Uu^Uf       , Uu^Uf       , Uu          , Urb         , Urb         , Urb         , Urb         , Zw          , Uu^Ii       , Yhl^Xp      , Yhl^Xp      , Zw          , Zw          , Yhl^Xp      , Uu^Uf       , Yhl         , Uu^Uf       , Uh          , Zw          , Yhl^Xp      , Yhr         , Urb         , Urb         , Yhr         , Ww          , Ww          , Zw          , Yhl         , Zw          , Yhl^Xp      , Uu^Uf       , Yhl         , Yhl^Xp      
Xv          , Xv          , Xv          , Xv          , Xv          , Xv          , Xv          , Xv          , Xv          , Xv          , Xv          , Xv          , Xv          , Xv          , Xv          , Xv          , Xv          , Xv          , Xv          , Xu          , Xu          , Zw          , Uu          , Urb         , Yhl         , Urb         , Yhl         , Zw          , Yhl         , Yhl         , Yhl^Xp      , Yhl^Xp      , Yhl         , Zw          , Yhl         , Uu^Ii       , Yhl         , Zw          , Zw          , Zw          , Zw          , Urb         , Urb         , Ww          , Ww          , Ww          , Zw          , Zw          , Urb         , Yhl         , Zw          , Zw          , Urb         , Urb         
Xv          , Xv          , Xv          , Xv          , Xv          , Xv          , Xv          , Xv          , Xv          , Xv          , Xv          , Xv          , Xv          , Xv          , Xv          , Xv          , Xv          , Xv          , Xv          , Xu          , Xu          , Xu          , Zw          , Uh          , Yhl^Xp      , Uu^Uf       , Uu^Ii       , Yhl^Xp      , Yhl         , Yhl^Xp      , Urb         , Yhl         , Zw          , Urb         , Urb         , Yhl^Xp      , Zw          , Zw          , Yhl^Xp      , Zw          , Urb         , Urb         , Ww          , Ww          , Wo          , Ww          , Zw          , Zw          , Zw          , Zw          , Yhl^Xp      , Uu^Ii       , Uu^Uf       , Yhl^Xp      
Xv          , Xv          , Xv          , Xv          , Xv          , Xv          , Xv          , Xv          , Xv          , Xv          , Xv          , Xv          , Xv          , Xv          , Xv          , Xv          , Xv          , Xv          , Xv          , Xv          , Xu          , Xu          , Xu          , Yhl^Xp      , Uu^Uf       , Uu          , Uu          , Uu          , Uu          , Urb         , Uu^Uf       , Zw          , Zw          , Urb         , Yhl         , Yhl         , Zw          , Zw          , Zw          , Zw          , Urb         , Zw          , Zw          , Ww          , Ww          , Ww          , Urb         , Urb         , Zw          , Zw          , Uu^Ii       , Yhl^Xp      , Yhl         , Uu^Uf       
Xv          , Xv          , Xv          , Xv          , Xv          , Xv          , Xv          , Xv          , Xv          , Xv          , Xv          , Xv          , Xv          , Xv          , Xv          , Xv          , Xv          , Xv          , Xv          , Xv          , Xv          , Xu          , Xu          , Yhl         , Uu^Ii       , Uu          , Uu          , Uu          , Uu          , Uh          , Uu          , Uu^Uf       , Uu^Ii       , Yhl^Xp      , Yhl         , Urb         , Zw          , Zw          , Uu^Ii       , Urb         , Zw          , Zw          , Yhl         , Zw          , Zw          , Zw          , Yhl         , Yhl^Xp      , Yhl         , Zw          , Urb         , Urb         , Uh          , Yhl         
Xv          , Xv          , Xv          , Xv          , Xv          , Xv          , Xv          , Xv          , Xv          , Xv          , Xv          , Xv          , Xv          , Xv          , Xv          , Xv          , Xv          , Xv          , Xv          , Xv          , Xv          , Xu          , Xu          , Xu          , Urb         , Uu          , Uu          , Uu          , Uu          , Uu          , Uu          , Uu^Uf       , Urb         , Yhl         , Urb         , Urb         , Yhl^Xp      , Yhl         , Uu^Uf       , Uu^Uf       , Yhl         , Yhl         , Urb         , Yhl^Xp      , Zw          , Yhl^Xp      , Zw          , Zw          , Urb         , Yhl         , Yhl         , Urb         , Uh          , Yhl         
Xv          , Xv          , Xv          , Xv          , Xv          , Xv          , Xv          , Xv          , Xv          , Xv          , Xv          , Xv          , Xv          , Xv          , Xv          , Xv          , Xv          , Xv          , Xv          , Xv          , Xv          , Xu          , Xu          , Urb         , Zw          , Zw          , Urb         , Zw          , Yhl         , Uu          , Uu^Uf       , Uu^Uf       , Uu^Uf       , Urb         , Yhl         , Yhl         , Urb         , Zw          , Zw          , Urb         , Zw          , Zw          , Uu^Uf       , Uu^Uf       , Uh          , Yhl         , Yhl         , Uu^Uf       , Uu^Uf       , Zw          , Yhl         , Yhl         , Uh          , Yhl         
