border_size=1
usage=map

Zw          , Ryd         , Ryd         , Cud         , Cud         , Xu          , Xu          , Xu          , Xu          , Xos         , Xos         , Xos         , Xos         , Xos         , Xu          , Xu          , Xu          , Xu          , Xu          , Xu          , Xu          , Xu          , Yhl         , Ryd         , Ryd         , Uu^Uf       , Yhl         , Yhl         , Xu          , Xu          , Xu          , Xu          , Xu          , Xu          , Xu          , Xu          , Xu          , Xu          , Xu          , Xu          , Xu          , Xv          , Xv          , Xv          , Xv          , Xv          , Xv          , Xv          , Xv          , Xv          , Xv          , Xv          , Xv          , Xv          
Zw          , Zw          , Zw          , Ryd         , Ryd         , Cud         , Xu          , Xu          , Cud         , Ryd         , Ryd         , Uh^Ii       , Uh          , Uh          , Yhl         , Xu          , Zw          , Yhl^Xp      , Xu          , Xu          , Xu          , Uu^Uf       , Uu^Uf       , Ryd         , Yhl         , Yhl         , Xu          , Xu          , Uh          , Xu          , Yhl         , Xu          , Uh          , Xu          , Uh          , Xu          , Xu          , Xu          , Xu          , Xu          , Xu          , Xv          , Xv          , Xv          , Xv          , Xv          , Xv          , Xv          , Xv          , Xv          , Xv          , Xv          , Xv          , Xv          
Ryd         , Zw          , Zw          , Zw          , Zw          , Ryd^Z/      , Ryd         , Cud         , Cud         , Cud         , Uh          , Uh^Ii       , Yhl         , Yhl         , Qxv         , Yhl         , Yhl         , Xu          , Zw          , Yhl^Xp      , Xu          , Xu          , Uu^Uf       , Yhl         , Ryd         , Yhl         , Uu^Uf       , Xu          , Xu          , Yhl         , Yhr         , Yhl         , Xu          , Xu          , Yhl         , Xu          , Uh          , Xu          , Xu          , Xu          , Xu          , Xv          , Xv          , Xv          , Xv          , Xv          , Xv          , Xv          , Xv          , Xv          , Xv          , Xv          , Xv          , Xv          
Cud         , Ryd         , Ryd^Z/      , Zw          , Zw          , Zw          , Zw          , Ryd         , Ryd         , Ryd         , Yhl         , Yhl         , Qxv         , Qxv         , Qxv         , Qxv         , Qxv         , Yhl         , Yhl         , Xu          , Xu          , Xu          , Yhl         , Ryd         , Ryd         , Uu^Uf       , Xu          , Xu          , Uu          , Yhl         , Yhl         , Yhl         , Xu          , Yhl         , Yhr         , Yhl         , Xu          , Xu          , Xu          , Xu          , Xu          , Xv          , Xv          , Xv          , Xv          , Xv          , Xv          , Xv          , Xv          , Xv          , Xv          , Xv          , Xv          , Xv          
Xu          , Xu          , Cud         , Ryd         , Ryd         , Zw          , Ce          , Ce          , Ce          , Ryd         , Yhl         , Qxv         , Qxv         , Uu^Ii       , Qxv         , Qxv         , Qxv         , Qxv         , Yhl         , Yhl         , Yhl         , Xu          , Ryd^Z\      , Ryd         , Yhl         , Yhl         , Xu          , Xu          , Yhl^Xp      , Xu          , Xu          , Xu          , Uu          , Yhl         , Yhl         , Yhl         , Xu          , Xu          , Xu          , Xu          , Xu          , Xv          , Xv          , Xv          , Xv          , Xv          , Xv          , Xv          , Xv          , Xv          , Xv          , Xv          , Xv          , Xv          
Uu^Uf       , Cud         , Cud         , Cud         , Ryd         , Ryd         , Ce          , 1 Ke        , Ce          , Ryd         , Ryd         , Yhl         , Yhl         , Qxv         , Qxv         , Qxv         , Yhl         , Yhl         , Ryd         , Ryd         , Yhl         , Yhl         , Uu          , Ryd^Z\      , Xu          , Xu          , Yhl^Xp      , Re^Uf       , Ww          , Re^Uf       , Yhl^Xp      , Uu          , Xu          , Xu          , Xu          , Xu          , Yhl         , Xu          , Uh          , Xu          , Xu          , Xv          , Xv          , Xv          , Xv          , Xv          , Xv          , Xv          , Xv          , Xv          , Xv          , Xv          , Xv          , Xv          
Uh^Ii       , Uh^Ii       , Ryd         , Ryd         , Yhl         , Yhl         , Yhl         , Ce          , Ryd         , Zw          , Zw          , Ryd         , Ryd         , Yhl         , Yhl         , Yhl         , Ryd         , Ryd         , Yhl         , Yhl         , Uu^Uf       , Uu^Uf       , Uu          , Uu^Uf       , Cud         , Xu          , Uu          , Wo          , Wo          , Ww          , Re^Uf       , Xu          , Xu          , Xu          , Xu          , Yhl         , Yhr         , Yhl         , Xu          , Xu          , Xu          , Xv          , Xv          , Xv          , Xv          , Xv          , Xv          , Xv          , Xv          , Xv          , Xv          , Xv          , Xv          , Xv          
Ryd         , Ryd         , Yhl         , Yhl         , Qxv         , Qxv         , Qxv         , Yhl         , Yhl         , Ryd         , Uu^Uf       , Zw          , Zw          , Ryd         , Ryd         , Ryd         , Ryd         , Yhl         , Yhl         , Yhl         , Yhl         , Re^Uf       , Re^Uf       , Cud         , 5 Kud       , Cud         , Uu          , Uu^Uf       , Re^Uf       , Wo          , Wo          , Yhl^Xp      , Re^Uf       , Xu          , Uu          , Yhl         , Yhl         , Yhl         , Uh          , Xu          , Xu          , Xv          , Xv          , Xv          , Xv          , Xv          , Xv          , Xv          , Xv          , Xv          , Xv          , Xv          , Xv          , Xv          
Ryd         , Yhl         , Qxv         , Qxv         , Qxv         , Uu^Ii       , Qxv         , Qxv         , Qxv         , Yhl         , Uu^Uf       , Uu^Ufi      , Yhr^Ii      , Zw          , Zw          , Ryd         , Ryd         , Ryd         , Yhl         , Yhl         , Uh          , Uu          , Uh          , Cud         , Cud         , Uu          , Uu          , Uu^Uf       , Re^Uf       , Wo          , Wo          , Wo          , Yhl^Xp      , Uu          , Xu          , Xu          , Uh          , Xu          , Xu          , Xu          , Xu          , Xv          , Xv          , Xv          , Xv          , Xv          , Xv          , Xv          , Xv          , Xv          , Xv          , Xv          , Xv          , Xv          
Ryd         , Yhl         , Yhl         , Qxv         , Qxv         , Qxv         , Qxv         , Qxv         , Yhl         , Uu^Uf       , Yhl         , Yhr^Xp      , Cud         , Yhr^Xp      , Yhr         , Zw          , Yhl         , Yhl         , Uu^Uf       , Uh          , Uu          , Uu          , Uh          , Uh          , Uh          , Re^Uf       , Uu          , Re^Uf       , Ww          , Wo          , Wo          , Ww          , Re^Uf       , Xu          , Xu          , Xu          , Xu          , Xu          , Xu          , Xu          , Xu          , Xv          , Xv          , Xv          , Xv          , Xv          , Xv          , Xv          , Xv          , Xv          , Xv          , Xv          , Xv          , Xv          
Ryd         , Ryd         , Ryd         , Yhl         , Yhl         , Qxv         , Yhl         , Yhl         , Uu^Uf       , Uu^Uf       , Yhl^Xp      , Cud         , 4 Kud       , Cud         , Yhl^Xp      , Yhr         , Yhr^Ii      , Ryd         , Ryd         , Uh          , Uu^Uf       , Uu^Uf       , Uu          , Uu          , Uh          , Uu^Uf       , Re^Uf       , Uu^Uf       , Re^Uf       , Yhl^Xp      , Re^Uf       , Yhl^Xp      , Uu          , Xu          , Xu          , Uh          , Xu          , Xu          , Xu          , Xu          , Xos         , Xv          , Xv          , Xv          , Xv          , Xv          , Xv          , Xv          , Xv          , Xv          , Xv          , Xv          , Xv          , Xv          
Uu          , Uu          , Xu          , Zw          , Zw          , Yhl         , Xu          , Xu          , Xu          , Uu^Uf       , Yhl         , Cud         , Cud         , Cud         , Uu^Ufi      , Yhr^Ii      , Uu^Uf       , Ryd         , Ryd         , Uu^Uf       , Cud         , Uu^Uf       , Xos         , Uu^Uf       , Xos         , Uh          , Xos         , Xos         , Xos         , Uu          , Xos         , Uu          , Xos         , Uu          , Yhl         , Yhl         , Yhl         , Uh          , Xos         , Xos         , Xos         , Xos         , Xos         , Xv          , Xv          , Xv          , Xv          , Xv          , Xv          , Xv          , Xv          , Xv          , Xv          , Xv          
Uu^Uf       , Uu^Uf       , Xu          , Yhl^Xp      , Xu          , Zw          , Zw          , Yhl^Xp      , Xu          , Yhl         , Yhl         , Yhl         , Yhl         , Yhl^Xp      , Uh          , Uu^Ufi      , Uu^Ufi      , Uu^Uf       , Ryd         , Ryd         , Ryd^Z/      , Xos         , Cud         , Xos         , Cud         , Xos         , Xos         , Xos         , Xos         , Uh          , Xos         , Uh          , Xos         , Xos         , Yhl         , Yhr         , Yhl         , Xos         , Xos         , Xos         , Xos         , Xos         , Xos         , Xos         , Xos         , Xv          , Xv          , Xv          , Xv          , Xv          , Xv          , Xv          , Xv          , Xv          
Uu^Uf       , Xu          , Yhl^Xp      , Xu          , Yhl^Xp      , Xu          , Yhl^Xp      , Zw          , Zw          , Uu^Uf       , Yhl         , Uu^Uf       , Xu          , Uu^Ufi      , Uu^Uf       , Uu          , Uu^Ufi      , Cud         , Xos         , Ryd^Z/      , Ryd         , Ryd         , Ryd         , Cud         , Uu          , Cud         , Cud         , Xos         , Xos         , Xos         , Xos         , Xos         , Xos         , Uh          , Xos         , Yhl         , Xos         , Uh          , Xos         , Xos         , Ryd         , Ryd         , Ryd         , Xos         , Xos         , Xos         , Xos         , Xv          , Xv          , Xv          , Xv          , Xv          , Xv          , Xv          
Xu          , Xu          , Zw          , Xu          , Zw          , Xu          , Xu          , Xu          , Uu^Uf       , Zw          , Yhl         , Uu^Uf       , Xu          , Xu          , Xu          , Uu^Ufi      , Uu^Ufi      , Xos         , Xos         , Xos         , Cud         , Ryd         , Ryd         , Ryd         , Uu          , Uu          , Uu^Uf       , Cud         , Cud         , Cud         , Cud         , Xos         , Xos         , Xos         , Xos         , Uh          , Xos         , Xos         , Xos         , Xos         , Ryd         , Uu^Ii       , Ryd         , Xu          , Xu          , Xos         , Xos         , Xos         , Xos         , Xv          , Xv          , Xv          , Xv          , Xv          
Xos         , Xos         , Yhl         , Ur          , Yhl         , Yhl         , Zw          , Zw          , Zw          , Zw          , Yhl         , Zw          , Yhl         , Uu^Uf       , Xu          , Uh          , Xu          , Xu          , Uu^Ii       , Xos         , Cud         , Ryd         , Ryd         , Ryd         , Ryd         , Uh          , Uh          , Uu^Uf       , Zw          , Uu^Uf       , Uu^Uf       , Cud         , Cud         , Cud         , Cud         , Xos         , Xos         , Xos         , Ryd         , Ryd         , Ryd         , Ryd         , Xu          , Xu          , Ryd         , Ryd         , Ryd         , Xos         , Xos         , Xos         , Xos         , Xv          , Xv          , Xv          
Xos         , Uu^Uf       , Zw          , Ur          , Ur          , Ur          , Zw          , Zw          , Uu^Uf       , Uu^Uf       , Yhl         , Uu^Uf       , Xu          , Zw          , Yhl^Xp      , Xu          , Uh          , Uh          , Uh          , Xos         , Xos         , Cud         , Cud         , Ryd         , Ryd         , Ryd         , Uh          , Zw          , Uh          , Zw          , Uu          , Zw          , Uh          , Uu^Uf       , Uh          , Cud         , Ryd         , Ryd^Z\      , Ryd^Z\      , Ryd         , Xu          , Xu          , Xu          , Xu          , Yhl         , Uu^Ii       , Ryd         , Xos         , Xos         , Xos         , Xos         , Xos         , Xos         , Xv          
Re^Uf       , Uu^Ii       , Zw          , Zw          , Xu          , Xu          , Xu          , Ur          , Zw          , Uu^Uf       , Xu          , Zw          , Yhl^Xp      , Xu          , Xu          , Xu          , Yhl         , Uh          , Yhl         , Uh          , Xos         , Xos         , Xos         , Cud         , Ryd         , Ryd         , Ryd         , Uu          , Uu          , Uu^Uf       , Uu          , Zw          , Ryd         , Uh          , Ryd         , Ryd         , Ryd         , Ryd         , Cud         , Xu          , Xu          , Xu          , Xu          , Xu          , Yhl         , Yhl         , Xos         , Xos         , Xu          , Xos         , Xos         , Xos         , Xos         , Xos         
Zw          , Zw          , Zw          , Ur          , Xu          , Yhl^Xp      , Ur          , Ur          , Xu          , Zw          , Yhl^Xp      , Xu          , Xu          , Xu          , Xu          , Yhl^Xp      , Xu          , Zw          , Zw          , Yhl         , Cud         , Xos         , Xos         , Cud         , Cud         , Ryd         , Ryd         , Ryd         , Ryd         , Ryd         , Ryd         , Ryd         , Cud         , Ryd         , Ryd         , Ryd         , Ryd         , Ryd         , Ryd         , Cud         , Cud         , Xu          , Ryd^Z\      , Ryd         , Yhl         , Yhl         , Xu          , Xu          , Xu          , Xos         , Xos         , Xos         , Xos         , Xos         
Zw          , Uu^Ii       , Ur          , Ur          , Re^Uf       , Xu          , Zw          , Zw          , Xu          , Xu          , Xu          , Xu          , Xu          , Yhl^Xp      , Xu          , Xu          , Xu          , Uh          , Yhl         , Ryd         , Ryd         , Cud         , Cud         , Xos         , Xos         , Cud         , Ryd         , Ryd         , Ryd         , Ryd         , Cud         , Cud         , Uu^Cd       , Cud         , Cud         , Ryd         , Ryd         , Ryd         , Ryd         , Ryd         , Ryd         , Ryd         , Ryd         , Ryd^Z\      , Xu          , Xu          , Xu          , Uu^Ii       , Xu          , Xos         , Xos         , Xos         , Yhl^Xp      , Yhl         
Zw          , Yhl         , Re^Uf       , Ur          , Ur          , Re^Uf       , Re^Uf       , Xu          , Yhl^Xp      , Zw          , Ryd         , Yhl^Xp      , Xu          , Zw          , Xu          , Yhl^Xp      , Ur          , Ur          , Xu          , Xu          , Cud         , Ryd         , Ryd         , Cud         , Xos         , Cud         , Ryd         , Ryd         , Ryd         , Ryd         , Cud         , Uu^Cd       , 3 Uu^Kd     , Uu^Cd       , Cud         , Ryd         , Ryd         , Ryd         , Ryd         , Ryd         , Ryd         , Ryd         , Xu          , Xu          , Xu          , Xu          , Xu          , Zw          , Xu          , Xos         , Ryd         , Yhl^Xp      , Xos         , Xos         
Uu^Uf       , Zw          , Re^Uf       , Yhl         , Yhl         , Re^Uf       , Re^Uf       , Xu          , Xu          , Xu          , Xu          , Yhl         , Re^Uf       , Re^Uf       , Ur          , Ur          , Yhl         , Uu^Ii       , Xu          , Xu          , Xu          , Cud         , Ryd         , Cud         , Xos         , Cud         , Cud         , Ryd         , Ryd         , Ryd         , Cud         , Uu^Cd       , Uu^Cd       , Uu^Cd       , Cud         , Ryd         , Ryd         , Ryd         , Cud         , Ryd         , Ryd^Z/      , Ryd^Z/      , Ryd         , Xu          , Ryd         , Uu^Ii       , Ryd         , Ryd         , Xu          , Yhl^Xp      , Ryd         , Yhl         , Yhl^Xp      , Xos         
Uu^Ufi      , Uu^Ufi      , Re^Uf       , Zw          , Ur          , Ur          , Ur          , Yhl         , Ur          , Xu          , Ur          , Ur          , Re^Uf       , Re^Uf       , Ur          , Ur          , Xu          , Yhl         , Xu          , Xu          , Xu          , Cud         , Ryd         , Cud         , Cud         , Xos         , Cud         , Ryd         , Ryd         , Ryd         , Ryd         , Cud         , Cud         , Cud         , Ryd         , Ryd         , Ryd         , Ryd         , Cud         , Xos         , Xos         , Ryd         , Ryd         , Uu^Ii       , Ryd         , Ryd         , Ryd         , Uu^Ii       , Xu          , Yhl         , Yhl         , Uu^Ii       , Zw          , Yhl         
Xu          , Xu          , Zw          , Zw          , Re^Uf       , Ur          , Yhl         , Ur          , Ur          , Yhl         , Ur          , Zw          , Ryd         , Zw          , Xu          , Ur          , Yhl^Xp      , Xu          , Xu          , Xu          , Xu          , Cud         , Cud         , Ryd         , Ryd         , Cud         , Ryd         , Ryd         , Ryd         , Ryd         , Ryd         , Ryd         , Ryd         , Ryd         , Ryd         , Ryd         , Ryd         , Cud         , Xos         , Xos         , Xos         , Xos         , Xos         , Ryd         , Uu^Ii       , Ryd         , Uu^Ii       , Ryd         , Xu          , Yhl^Xp      , Yhl^Xp      , Zw          , Zw          , Zw          
Xu          , Xu          , Yhl^Xp      , Zw          , Xu          , Re^Uf       , Re^Uf       , Zw          , Zw          , Ur          , Ryd         , Yhl         , Xu          , Zw          , Yhl^Xp      , Xu          , Xu          , Xu          , Xu          , Xu          , Xu          , Xu          , Xu          , Cud         , Cud         , Ryd         , Ryd         , Ryd         , Ryd         , Ryd         , Ryd         , Ryd         , Ryd         , Ryd         , Ryd         , Ryd         , Ryd^Z/      , Xos         , Xos         , Xos         , Xu          , Xu          , Xu          , Xos         , Xu          , Xu          , Xu          , Xu          , Xu          , Yhl^Xp      , Yhl         , Zw          , Uu^Ii       , Zw          
Xv          , Xu          , Xu          , Xu          , Yhl^Xp      , Zw          , Xu          , Yhl         , Xu          , Uu^Ii       , Xu          , Zw          , Yhl^Xp      , Xu          , Xu          , Xu          , Xu          , Xu          , Xv          , Xv          , Xv          , Xu          , Xu          , Xu          , Xu          , Cud         , Cud         , Cud         , Cud         , Cud         , Cud         , Cud         , Cud         , Cud         , Xos         , Ryd^Z/      , Ryd         , Ryd         , Ryd         , Uu^Uf       , Uu^Uf       , Uu^Uf       , Yhl^Xp      , Xu          , Yhl^Xp      , Xu          , Uu^Ii       , Xu          , Ryd         , Uu^Uf       , Uh          , Zw          , Yhl         , Ryd         
Xv          , Xv          , Xv          , Xu          , Xu          , Xu          , Xu          , Xu          , Xu          , Xu          , Xu          , Xu          , Xu          , Xu          , Xu          , Xu          , Xv          , Xv          , Xv          , Xv          , Xv          , Xv          , Xos         , Xos         , Xos         , Xos         , Xos         , Xos         , Xos         , Xos         , Xos         , Xos         , Xos         , Xos         , Xos         , Xos         , Ryd         , Ryd         , Ryd         , Ryd         , Yhl         , Uu^Uf       , Zw          , Yhl         , Uh          , Yhl         , Yhl^Xp      , Zw          , Zw          , Uu^Uf       , Uu^Uf       , Zw          , Yhl^Xp      , Yhl         
Xv          , Xv          , Xv          , Xv          , Xv          , Xu          , Xv          , Xu          , Xv          , Xu          , Xv          , Xu          , Xu          , Xu          , Xv          , Xv          , Xv          , Xv          , Xv          , Xv          , Xu          , Xu          , Xu          , Xos         , Xos         , Xos         , Xos         , Xos         , Xos         , Xos         , Xos         , Xos         , Xos         , Xos         , Zw          , Xos         , Ryd         , Ryd         , Yhl         , Yhl^Xp      , Uu^Ii       , Uu^Uf       , Zw          , Yhl^Xp      , Zw          , Yhl^Xp      , Ryd         , Zw          , Zw          , Zw          , Uu^Ii       , Yhl^Xp      , Yhl         , Yhl         
Xv          , Xv          , Xv          , Xv          , Xv          , Xv          , Xv          , Xv          , Xv          , Xv          , Xv          , Xv          , Xv          , Xv          , Xv          , Xv          , Xv          , Xv          , Xu          , Xu          , Xu          , Xu          , Xu          , Xu          , Yhl         , Xos         , Xos         , Ryd         , Ryd         , Xos         , Yhl         , Xos         , Zw          , Zw          , Ryd         , Zw          , Uu^Uf       , Yhl^Xp      , Yhl^Xp      , Yhl         , Zw          , Zw          , Ryd         , Ryd         , Zw          , Ryd         , Zw          , Yhl^Xp      , Zw          , Yhl         , Zw          , Zw          , Uu^Uf       , Yhl^Xp      
Xv          , Xv          , Xv          , Xv          , Xv          , Xv          , Xv          , Xv          , Xv          , Xv          , Xv          , Xv          , Xv          , Xv          , Xv          , Xv          , Xv          , Xv          , Xu          , Xu          , Uu^Ii       , Zw          , Zw          , Uu^Uf       , Uu          , Yhl^Xp      , Yhl         , Ryd         , Yhl         , Yhl         , Yhl         , Zw          , Yhl         , Ryd         , Yhl         , Uu^Uf       , Uu^Uf       , Yhl         , Yhl^Xp      , Zw          , Uh          , Zw          , Yhr         , Zw          , Zw          , Zw          , Zw          , Uu^Ii       , Zw          , Zw          , Yhl         , Zw          , Uu^Uf       , Uu^Uf       
Xv          , Xv          , Xv          , Xv          , Xv          , Xv          , Xv          , Xv          , Xv          , Xv          , Xv          , Xv          , Xv          , Xv          , Xv          , Xv          , Xv          , Xv          , Xu          , Xu          , Xu          , Uu^Uf       , Uu^Uf       , Uu          , Ryd         , Ryd         , Ryd         , Ryd         , Zw          , Uu^Ii       , Yhl^Xp      , Yhl^Xp      , Zw          , Zw          , Yhl^Xp      , Uu^Uf       , Yhl         , Uu^Uf       , Uh          , Zw          , Yhl^Xp      , Yhr         , Ryd         , Ryd         , Yhr         , Ww          , Ww          , Zw          , Yhl         , Zw          , Yhl^Xp      , Uu^Uf       , Yhl         , Yhl^Xp      
Xv          , Xv          , Xv          , Xv          , Xv          , Xv          , Xv          , Xv          , Xv          , Xv          , Xv          , Xv          , Xv          , Xv          , Xv          , Xv          , Xv          , Xv          , Xv          , Xu          , Xu          , Zw          , Uu          , Ryd         , Yhl         , Ryd         , Yhl         , Zw          , Yhl         , Yhl         , Yhl^Xp      , Yhl^Xp      , Yhl         , Zw          , Yhl         , Uu^Ii       , Yhl         , Zw          , Zw          , Zw          , Zw          , Ryd         , Ryd         , Ww          , Ww          , Ww          , Zw          , Zw          , Ryd         , Yhl         , Zw          , Zw          , Ryd         , Ryd         
Xv          , Xv          , Xv          , Xv          , Xv          , Xv          , Xv          , Xv          , Xv          , Xv          , Xv          , Xv          , Xv          , Xv          , Xv          , Xv          , Xv          , Xv          , Xv          , Xu          , Xu          , Xu          , Zw          , Uh          , Yhl^Xp      , Uu^Uf       , Uu^Ii       , Yhl^Xp      , Yhl         , Yhl^Xp      , Ryd         , Yhl         , Zw          , Ryd         , Ryd         , Yhl^Xp      , Zw          , Zw          , Yhl^Xp      , Zw          , Ryd         , Ryd         , Ww          , Ww          , Wo          , Ww          , Zw          , Zw          , Zw          , Zw          , Yhl^Xp      , Uu^Ii       , Uu^Uf       , Yhl^Xp      
Xv          , Xv          , Xv          , Xv          , Xv          , Xv          , Xv          , Xv          , Xv          , Xv          , Xv          , Xv          , Xv          , Xv          , Xv          , Xv          , Xv          , Xv          , Xv          , Xv          , Xu          , Xu          , Xu          , Yhl^Xp      , Uu^Uf       , Uu          , Uu          , Uu          , Uu          , Ryd         , Uu^Uf       , Zw          , Zw          , Ryd         , Yhl         , Yhl         , Zw          , Zw          , Zw          , Zw          , Ryd         , Zw          , Zw          , Ww          , Ww          , Ww          , Ryd         , Ryd         , Zw          , Zw          , Uu^Ii       , Yhl^Xp      , Yhl         , Uu^Uf       
Xv          , Xv          , Xv          , Xv          , Xv          , Xv          , Xv          , Xv          , Xv          , Xv          , Xv          , Xv          , Xv          , Xv          , Xv          , Xv          , Xv          , Xv          , Xv          , Xv          , Xv          , Xu          , Xu          , Yhl         , Uu^Ii       , Uu          , Uu          , Uu          , Uu          , Uh          , Uu          , Uu^Uf       , Uu^Ii       , Yhl^Xp      , Yhl         , Ryd         , Zw          , Zw          , Uu^Ii       , Ryd         , Zw          , Zw          , Yhl         , Zw          , Zw          , Zw          , Yhl         , Yhl^Xp      , Yhl         , Zw          , Ryd         , Ryd         , Uh          , Yhl         
Xv          , Xv          , Xv          , Xv          , Xv          , Xv          , Xv          , Xv          , Xv          , Xv          , Xv          , Xv          , Xv          , Xv          , Xv          , Xv          , Xv          , Xv          , Xv          , Xv          , Xv          , Xu          , Xu          , Xu          , Ryd         , Uu          , Uu          , Uu          , Uu          , Uu          , Uu          , Uu^Uf       , Ryd         , Yhl         , Ryd         , Ryd         , Yhl^Xp      , Yhl         , Uu^Uf       , Uu^Uf       , Yhl         , Yhl         , Ryd         , Yhl^Xp      , Zw          , Yhl^Xp      , Zw          , Zw          , Ryd         , Yhl         , Yhl         , Ryd         , Uh          , Yhl         
Xv          , Xv          , Xv          , Xv          , Xv          , Xv          , Xv          , Xv          , Xv          , Xv          , Xv          , Xv          , Xv          , Xv          , Xv          , Xv          , Xv          , Xv          , Xv          , Xv          , Xv          , Xu          , Xu          , Ryd         , Zw          , Zw          , Ryd         , Zw          , Yhl         , Uu          , Uu^Uf       , Uu^Uf       , Uu^Uf       , Ryd         , Yhl         , Yhl         , Ryd         , Zw          , Zw          , Ryd         , Zw          , Zw          , Uu^Uf       , Uu^Uf       , Uh          , Yhl         , Yhl         , Uu^Uf       , Uu^Uf       , Zw          , Yhl         , Yhl         , Uh          , Yhl         
