border_size=1
usage=map

Ryd         , Ryd         , Ryd         , Cud         , Cud         , Xu          , Xu          , Xu          , Xu          , Xu          , Uh          , Xu          , Uh          , Xu          , Xu          , Xu          , Xu          , Xu          , Xu          , Xu          , Xu          , Xu          , Yl          , Ryd         , Ryd         , Uu^Uf       , Yl          , Yl          , Xu          , Xu          , Xu          , Xu          , Xu          , Xu          , Xu          , Xv          , Xv          , Xv          , Xv          , Xv          , Xv          , Xv          , Xv          , Xv          , Xv          , Xv          , Xv          , Xv          , Xv          , Xv          , Xv          , Xv          , Xv          , Xv          
Ryd         , Ryd         , Ryd         , Ryd         , Ryd         , Cud         , Xu          , Xu          , Cud         , Ryd         , Ryd         , Uh^Ii       , Uh          , Uh          , Yl          , Xu          , Zw          , Yrh         , Xu          , Xu          , Xu          , Uu^Uf       , Uu^Uf       , Ryd         , Yl          , Yl          , Xu          , Xu          , Uh          , Xu          , Yr          , Xu          , Uh          , Xu          , Uh          , Xu          , Xu          , Xv          , Xv          , Xv          , Xv          , Xv          , Xv          , Xv          , Xv          , Xv          , Xv          , Xv          , Xv          , Xv          , Xv          , Xv          , Xv          , Xv          
Ryd         , Ryd         , Ryd         , Ryd         , Ryd         , Xg^Zse      , Ryd         , Cud         , Cud         , Kud         , Uh          , Uh^Ii       , Yl          , Yl          , Qxv         , Yl          , Yl          , Xu          , Zw          , Yrh         , Xu          , Xu          , Uu^Uf       , Yl          , Ryd         , Yl          , Uu^Uf       , Xu          , Xu          , Yr          , Yl          , Yr          , Xu          , Xu          , Yr          , Xu          , Uh          , Xu          , Xv          , Xv          , Xv          , Xv          , Xv          , Xv          , Xv          , Xv          , Xv          , Xv          , Xv          , Xv          , Xv          , Xv          , Xv          , Xv          
Cud         , Ryd         , Xg^Zse      , Ryd         , Ryd         , Ryd         , Ryd         , Ryd         , Ryd         , Ryd         , Yl          , Yl          , Qxv         , Qxv         , Qxv         , Qxv         , Qxv         , Yl          , Yl          , Xu          , Xu          , Xu          , Yl          , Ryd         , Ryd         , Uu^Uf       , Xu          , Xu          , Uu          , Yr          , Yr          , Yr          , Xu          , Yr          , Yl          , Yr          , Xu          , Xu          , Xv          , Xv          , Xv          , Xv          , Xv          , Xv          , Xv          , Xv          , Xv          , Xv          , Xv          , Xv          , Xv          , Xv          , Xv          , Xv          
Xu          , Xu          , Cud         , Ryd         , Ryd         , Ryd         , Ryd         , Ryd         , Ryd         , Ryd         , Yl          , Qxv         , Qxv         , Qxv         , Qxv         , Qxv         , Qxv         , Qxv         , Yl          , Yl          , Yl          , Xu          , Xg^Zsw      , Ryd         , Yl          , Yl          , Xu          , Xu          , Yrh         , Xu          , Xu          , Xu          , Uu          , Yr          , Yr          , Yr          , Xu          , Xv          , Xu          , Xv          , Xv          , Xv          , Xv          , Xv          , Xv          , Xv          , Xv          , Xv          , Xv          , Xv          , Xv          , Xv          , Xv          , Xv          
Uu^Uf       , Cud         , Kud         , Cud         , Ryd         , Ryd         , Ryd         , 1 Ryd       , Ryd         , Ryd         , Ryd         , Yl          , Yl          , Qxv         , Qxv         , Qxv         , Yl          , Yl          , Ryd         , Ryd         , Yl          , Yl          , Uu          , Xg^Zsw      , Xu          , Xu          , Yrh         , Re^Uf       , Ww          , Re^Uf       , Yrh         , Uu          , Xu          , Xu          , Xu          , Xu          , Yr          , Xu          , Uh          , Xu          , Xv          , Xv          , Xv          , Xv          , Xv          , Xv          , Xv          , Xv          , Xv          , Xv          , Xv          , Xv          , Xv          , Xv          
Uh^Ii       , Uh^Ii       , Ryd         , Ryd         , Yl          , Yl          , Yl          , Ryd         , Ryd         , Ryd         , Ryd         , Ryd         , Ryd         , Yl          , Yl          , Yl          , Ryd         , Ryd         , Yl          , Yl          , Uu^Uf       , Uu^Uf       , Uu          , Uu^Uf       , Cud         , Xu          , Uu          , Wo          , Wo          , Ww          , Re^Uf       , Xu          , Xu          , Xu          , Xu          , Yr          , Yl          , Yr          , Xu          , Xu          , Xv          , Xv          , Xv          , Xv          , Xv          , Xv          , Xv          , Xv          , Xv          , Xv          , Xv          , Xv          , Xv          , Xv          
Uu^Ufi      , Uh          , Yl          , Yl          , Qxv         , Qxv         , Qxv         , Yl          , Yl          , Ryd         , Uu^Uf       , Ryd         , Ryd         , Ryd         , Ryd         , Ryd         , Ryd         , Yl          , Yl          , Yl          , Yl          , Re^Uf       , Re^Uf       , Cud         , 5 Kud       , Cud         , Uu          , Uu^Uf       , Re^Uf       , Wo          , Wo          , Yrh         , Re^Uf       , Xu          , Uu          , Yr          , Yr          , Yr          , Uh          , Xu          , Xv          , Xv          , Xv          , Xv          , Xv          , Xv          , Xv          , Xv          , Xv          , Xv          , Xv          , Xv          , Xv          , Xv          
Uu^Uf       , Yl          , Qxv         , Qxv         , Qxv         , Qxv         , Qxv         , Qxv         , Qxv         , Yl          , Uu^Uf       , Uu^Ufi      , Yr          , Ryd         , Ryd         , Ryd         , Ryd         , Ryd         , Yl          , Yl          , Uh          , Uu          , Uh          , Cud         , Cud         , Uu          , Uu          , Uu^Uf       , Re^Uf       , Wo          , Wo          , Wo          , Yrh         , Uu          , Xu          , Xu          , Uh          , Xu          , Xu          , Xu          , Xv          , Xv          , Xv          , Xv          , Xv          , Xv          , Xv          , Xv          , Xv          , Xv          , Xv          , Xv          , Xv          , Xv          
Uu^Uf       , Yl          , Yl          , Qxv         , Qxv         , Qxv         , Qxv         , Qxv         , Yl          , Uu^Uf       , Yr          , Yrh         , Cud         , Yrh         , Yr          , Ryd         , Yl          , Yl          , Uu^Uf       , Uh          , Uu          , Uu          , Uh          , Uh          , Uh          , Re^Uf       , Uu          , Re^Uf       , Ww          , Wo          , Wo          , Ww          , Re^Uf       , Xu          , Xu          , Xu          , Xu          , Xu          , Xv          , Xv          , Xv          , Xv          , Xv          , Xv          , Xv          , Xv          , Xv          , Xv          , Xv          , Xv          , Xv          , Xv          , Xv          , Xv          
Ryd         , Ryd         , Ryd         , Yl          , Yl          , Qxv         , Yl          , Yl          , Uu^Uf       , Uu^Uf       , Yrh         , Cud         , 4 Kud       , Cud         , Yrh         , Yr          , Yr          , Ryd         , Ryd         , Uh          , Uu^Uf       , Uu^Uf       , Uu          , Uu          , Uh          , Uu^Uf       , Re^Uf       , Uu^Uf       , Re^Uf       , Yrh         , Re^Uf       , Yrh         , Uu          , Xu          , Xu          , Uh          , Xu          , Xu          , Xu          , Xv          , Xv          , Xv          , Xv          , Xv          , Xv          , Xv          , Xv          , Xv          , Xv          , Xv          , Xv          , Xv          , Xv          , Xv          
Uu          , Uu          , Xu          , Zw          , Zw          , Yl          , Xu          , Xu          , Xu          , Uu^Uf       , Yr          , Cud         , Cud         , Cud         , Uu^Ufi      , Yr          , Uu^Uf       , Ryd         , Ryd         , Uu^Uf       , Cud         , Uu^Uf       , Xu          , Uu^Uf       , Xu          , Uh          , Xu          , Xu          , Xu          , Uu          , Xu          , Uu          , Xu          , Uu          , Yr          , Yr          , Yr          , Uh          , Xu          , Xv          , Xv          , Xv          , Xv          , Xv          , Xv          , Xv          , Xv          , Xv          , Xv          , Xv          , Xv          , Xv          , Xv          , Xv          
Uu^Uf       , Uu^Uf       , Xu          , Yrh         , Xu          , Zw          , Zw          , Yrh         , Xu          , Yr          , Yr          , Yrh         , Yr          , Yrh         , Uh          , Uu^Ufi      , Uu^Ufi      , Uu^Uf       , Ryd         , Ryd         , Xg^Zse      , Xu          , Cud         , Xu          , Cud         , Xu          , Xu          , Xu          , Xu          , Uh          , Xu          , Uh          , Xu          , Xu          , Yr          , Yl          , Yr          , Xu          , Xu          , Xv          , Xu          , Xu          , Xu          , Xv          , Xv          , Xv          , Xv          , Xv          , Xv          , Xv          , Xv          , Xv          , Xv          , Xv          
Uu^Uf       , Xu          , Yrh         , Xu          , Yrh         , Xu          , Yrh         , Zw          , Zw          , Uu^Uf       , Yr          , Uu^Uf       , Xu          , Uu^Ufi      , Uu^Uf       , Uu          , Uu^Ufi      , Cud         , Xu          , Xg^Zse      , Ryd         , Ryd         , Ryd         , Cud         , Uu          , Cud         , Cud         , Xu          , Xu          , Xu          , Xu          , Xu          , Xu          , Uh          , Xu          , Yr          , Xu          , Uh          , Xu          , Xu          , Ryd         , Ryd         , Ryd         , Xu          , Xv          , Xv          , Xv          , Xv          , Xv          , Xv          , Xv          , Xv          , Xv          , Xv          
Xu          , Xu          , Zw          , Xu          , Zw          , Xu          , Xu          , Xu          , Uu^Uf       , Zw          , Yr          , Uu^Uf       , Xu          , Xu          , Xu          , Uu^Ufi      , Uu^Ufi      , Xu          , Xu          , Xu          , Cud         , Ryd         , Ryd         , Ryd         , Uu          , Uu          , Uu^Uf       , Cud         , Cud         , Cud         , Cud         , Xu          , Xu          , Xu          , Xu          , Uh          , Xu          , Xu          , Xu          , Xu          , Ryd         , Uu^Ii       , Ryd         , Xu          , Xu          , Xu          , Xu          , Xv          , Xv          , Xv          , Xv          , Xv          , Xv          , Xv          
Uu^Uf       , Uu^Uf       , Yr          , Ryd         , Yr          , Yr          , Zw          , Zw          , Zw          , Zw          , Yr          , Zw          , Yr          , Uu^Uf       , Xu          , Uh          , Xu          , Xu          , Uu^Ii       , Xu          , Cud         , Ryd         , Ryd         , Ryd         , Ryd         , Uh          , Uh          , Uu^Uf       , Uu          , Uu^Uf       , Uu^Uf       , Cud         , Cud         , Cud         , Cud         , Xu          , Xu          , Xu          , Ryd         , Ryd         , Ryd         , Ryd         , Xu          , Xu          , Ryd         , Ryd         , Ryd         , Xu          , Xv          , Xv          , Xv          , Xv          , Xv          , Xv          
Uu^Uf       , Uu^Uf       , Zw          , Zw          , Ryd         , Ryd         , Zw          , Zw          , Uu^Uf       , Uu^Uf       , Yr          , Uu^Uf       , Xu          , Zw          , Yrh         , Xu          , Uh          , Uh          , Uh          , Xu          , Xu          , Cud         , Cud         , Ryd         , Ryd         , Ryd         , Uh          , Uh          , Uh          , Uu          , Uu          , Uu          , Uh          , Uu^Uf       , Uh          , Cud         , Ryd         , Xg^Zsw      , Xg^Zsw      , Ryd         , Xu          , Xu          , Xu          , Xu          , Yr          , Uu^Ii       , Ryd         , Xu          , Xv          , Xv          , Xv          , Xv          , Xv          , Xv          
Re^Uf       , Uu^Ii       , Zw          , Zw          , Xu          , Xu          , Xu          , Ryd         , Zw          , Uu^Uf       , Xu          , Zw          , Yrh         , Xu          , Xu          , Xu          , Yr          , Uh          , Yr          , Uh          , Xu          , Xu          , Xu          , Cud         , Ryd         , Ryd         , Ryd         , Uu          , Uu          , Uu^Uf       , Uu          , Uu          , Ryd         , Uh          , Ryd         , Ryd         , Ryd         , Ryd         , Cud         , Xu          , Xu          , Xu          , Xu          , Xu          , Yr          , Yr          , Xu          , Xu          , Xv          , Xv          , Xv          , Xv          , Xv          , Xv          
Zw          , Zw          , Zw          , Ryd         , Xu          , Yrh         , Ryd         , Ryd         , Xu          , Zw          , Yrh         , Xu          , Xu          , Xu          , Xu          , Yrh         , Xu          , Zw          , Zw          , Yr          , Cud         , Xu          , Xu          , Cud         , Cud         , Ryd         , Ryd         , Ryd         , Ryd         , Ryd         , Ryd         , Ryd         , Cud         , Ryd         , Ryd         , Ryd         , Ryd         , Ryd         , Ryd         , Cud         , Cud         , Xu          , Xg^Zsw      , Ryd         , Yr          , Yr          , Xu          , Xu          , Xu          , Xv          , Xv          , Xv          , Xu          , Xu          
Zw          , Uu^Ii       , Ryd         , Ryd         , Re^Uf       , Xu          , Zw          , Zw          , Xu          , Xu          , Xu          , Xu          , Xu          , Yrh         , Xu          , Xu          , Xu          , Uh          , Yr          , Ryd         , Ryd         , Cud         , Cud         , Xu          , Xu          , Cud         , Ryd         , Ryd         , Ryd         , Ryd         , Cud         , Cud         , Uu^Cd       , Cud         , Cud         , Ryd         , Ryd         , Ryd         , Ryd         , Ryd         , Ryd         , Ryd         , Ryd         , Xg^Zsw      , Xu          , Xu          , Xu          , Uu^Ii       , Xu          , Xv          , Xu          , Xu          , Yr          , Yr          
Zw          , Yr          , Re^Uf       , Ryd         , Ryd         , Re^Uf       , Re^Uf       , Xu          , Yrh         , Zw          , Ryd         , Yrh         , Xu          , Zw          , Xu          , Yrh         , Yr          , Yr          , Xu          , Xu          , Cud         , Ryd         , Ryd         , Cud         , Xu          , Cud         , Ryd         , Ryd         , Ryd         , Ryd         , Cud         , Uu^Cd       , 3 Uu^Kd     , Uu^Cd       , Cud         , Ryd         , Ryd         , Ryd         , Ryd         , Ryd         , Ryd         , Ryd         , Xu          , Xu          , Xu          , Xu          , Xu          , Zw          , Xu          , Xu          , Ryd         , Yr          , Xu          , Xu          
Uu^Uf       , Zw          , Re^Uf       , Yr          , Yr          , Re^Uf       , Re^Uf       , Xu          , Xu          , Xu          , Xu          , Yr          , Re^Uf       , Re^Uf       , Zw          , Yr          , Yr          , Uu^Ii       , Xu          , Xu          , Xu          , Cud         , Ryd         , Cud         , Xu          , Cud         , Cud         , Ryd         , Ryd         , Ryd         , Cud         , Uu^Cd       , Uu^Cd       , Uu^Cd       , Cud         , Ryd         , Ryd         , Ryd         , Cud         , Ryd         , Xg^Zse      , Xg^Zse      , Ryd         , Xu          , Ryd         , Uu^Ii       , Ryd         , Ryd         , Xu          , Yr          , Ryd         , Yr          , Yr          , Xu          
Uu^Ufi      , Uu^Ufi      , Re^Uf       , Zw          , Ryd         , Yr          , Ryd         , Yr          , Ryd         , Xu          , Zw          , Zw          , Re^Uf       , Re^Uf       , Zw          , Ryd         , Xu          , Yr          , Xu          , Xv          , Xu          , Cud         , Ryd         , Cud         , Cud         , Xu          , Cud         , Ryd         , Ryd         , Ryd         , Ryd         , Cud         , Cud         , Cud         , Ryd         , Ryd         , Ryd         , Ryd         , Cud         , Xu          , Xu          , Ryd         , Ryd         , Uu^Ii       , Ryd         , Ryd         , Ryd         , Uu^Ii       , Xu          , Yr          , Yr          , Uu^Ii       , Zw          , Yl          
Xu          , Xu          , Zw          , Zw          , Re^Uf       , Ryd         , Yr          , Ryd         , Ryd         , Yr          , Zw          , Zw          , Ryd         , Zw          , Xu          , Zw          , Yrh         , Xu          , Xv          , Xv          , Xu          , Cud         , Cud         , Ryd         , Ryd         , Cud         , Ryd         , Ryd         , Ryd         , Ryd         , Ryd         , Ryd         , Ryd         , Ryd         , Ryd         , Ryd         , Ryd         , Cud         , Xu          , Xu          , Xu          , Xu          , Xu          , Ryd         , Uu^Ii       , Ryd         , Uu^Ii       , Ryd         , Xu          , Yr          , Yr          , Zw          , Zw          , Zw          
Xv          , Xu          , Yrh         , Zw          , Xu          , Re^Uf       , Re^Uf       , Zw          , Zw          , Zw          , Ryd         , Yr          , Xu          , Zw          , Yrh         , Xu          , Xu          , Xu          , Xv          , Xv          , Xv          , Xu          , Xu          , Cud         , Cud         , Ryd         , Ryd         , Ryd         , Ryd         , Ryd         , Ryd         , Ryd         , Ryd         , Ryd         , Ryd         , Ryd         , Xg^Zse      , Xu          , Xu          , Xu          , Xu          , Xu          , Xu          , Xu          , Xu          , Xu          , Xu          , Xu          , Xu          , Yr          , Yr          , Zw          , Uu^Ii       , Zw          
Xv          , Xu          , Xu          , Xu          , Yrh         , Zw          , Xu          , Yr          , Xu          , Uu^Ii       , Xu          , Zw          , Yrh         , Xu          , Xu          , Xu          , Xv          , Xv          , Xv          , Xv          , Xv          , Xv          , Xv          , Xu          , Xu          , Cud         , Cud         , Cud         , Cud         , Cud         , Cud         , Cud         , Cud         , Cud         , Xu          , Xg^Zse      , Ryd         , Ryd         , Ryd         , Uu^Uf       , Uu^Uf       , Uu^Uf       , Yr          , Xu          , Yr          , Xu          , Uu^Ii       , Xu          , Ryd         , Uu^Uf       , Uh          , Zw          , Yr          , Ryd         
Xv          , Xv          , Xv          , Xu          , Xu          , Xu          , Xv          , Xu          , Xv          , Xu          , Xv          , Xu          , Xu          , Xu          , Xv          , Xv          , Xv          , Xv          , Xv          , Xv          , Xv          , Xv          , Xv          , Xv          , Xv          , Xu          , Xu          , Xu          , Xu          , Xu          , Xu          , Xu          , Xu          , Xu          , Xu          , Xu          , Ryd         , Ryd         , Ryd         , Ryd         , Yl          , Uu^Uf       , Zw          , Yr          , Uh          , Yl          , Yl          , Zw          , Zw          , Uu^Uf       , Uu^Uf       , Zw          , Yl          , Yr          
Xv          , Xv          , Xv          , Xv          , Xv          , Xv          , Xv          , Xv          , Xv          , Xv          , Xv          , Xv          , Xv          , Xv          , Xv          , Xv          , Xv          , Xv          , Xv          , Xv          , Xv          , Xv          , Xv          , Xv          , Xu          , Xv          , Xu          , Xu          , Xu          , Xu          , Xu          , Xu          , Xu          , Xu          , Zw          , Xu          , Ryd         , Ryd         , Yr          , Yl          , Uu^Ii       , Uu^Uf       , Zw          , Yr          , Uh          , Yr          , Ryd         , Zw          , Zw          , Zw          , Uu^Ii       , Yr          , Yl          , Yr          
Xv          , Xv          , Xv          , Xv          , Xv          , Xv          , Xv          , Xv          , Xv          , Wo          , Wo          , Xv          , Xv          , Xv          , Xv          , Xv          , Xv          , Xv          , Xv          , Xv          , Xu          , Xu          , Xu          , Xu          , Yr          , Xu          , Xu          , Ryd         , Ryd         , Xu          , Yr          , Xu          , Zw          , Zw          , Ryd         , Zw          , Uu^Uf       , Yr          , Yr          , Yl          , Zw          , Zw          , Ryd         , Ryd         , Uh          , Ryd         , Zw          , Yl          , Zw          , Yr          , Zw          , Zw          , Uu^Uf       , Yr          
Xv          , Xv          , Xv          , Xv          , Xv          , Xv          , Wo          , Wo          , Wo          , Xv          , Xv          , Wo          , Wo          , Xv          , Xv          , Xv          , Xv          , Xv          , Xv          , Xu          , Uu^Ii       , Zw          , Zw          , Uu^Uf       , Uu          , Yr          , Yr          , Ryd         , Yr          , Yr          , Yr          , Zw          , Yr          , Ryd         , Yl          , Uu^Uf       , Uu^Uf       , Yr          , Yr          , Uh          , Uh          , Zw          , Uh          , Uh          , Xu          , Uh          , Uh          , Uu^Ii       , Uh          , Uh          , Yr          , Zw          , Uu^Uf       , Uu^Uf       
Xv          , Xv          , Xv          , Xv          , Xv          , Wo          , Wo          , Xv          , Xv          , Wo          , Xv          , Xv          , Xv          , Wo          , Wo          , Xv          , Xv          , Xv          , Xv          , Xu          , Xu          , Uu^Uf       , Uu^Uf       , Uu          , Ryd         , Ryd         , Ryd         , Ryd         , Zw          , Uu^Ii       , Yl          , Yl          , Zw          , Zw          , Yr          , Uu^Uf       , Yl          , Uu^Uf       , Uh          , Zw          , Yr          , Uh          , Xu          , Xu          , Xu          , Xu          , Xu          , Uh          , Yr          , Zw          , Yr          , Uu^Uf       , Yr          , Yl          
Xv          , Xv          , Xv          , Wo          , Wo          , Xv          , Wo          , Wo          , Xv          , Xv          , Xv          , Xv          , Wo          , Xv          , Xv          , Wo          , Wo          , Xv          , Xv          , Xv          , Xu          , Zw          , Uu          , Ryd         , Yr          , Ryd         , Yr          , Zw          , Yl          , Yl          , Yl          , Yr          , Yr          , Zw          , Yr          , Uu^Ii       , Yr          , Zw          , Zw          , Zw          , Uu^Uf       , Uh          , Xu          , Xu          , 2 Xu        , Xu          , Xu          , Uh          , Ryd         , Yr          , Zw          , Zw          , Ryd         , Ryd         
Xv          , Xv          , Xv          , Xv          , Xv          , Wo          , Xv          , Xv          , Xv          , Xv          , Wo          , Wo          , Wo          , Xv          , Xv          , Xv          , Xv          , Wo          , Wo          , Xv          , Xv          , Xu          , Zw          , Uh          , Yr          , Uu^Uf       , Uu^Ii       , Yl          , Yl          , Yl          , Ryd         , Yr          , Zw          , Ryd         , Ryd         , Yr          , Zw          , Zw          , Yl          , Uu^Uf       , Uu^Uf       , Uh          , Xu          , Xu          , Xu          , Xu          , Xu          , Uh          , Zw          , Zw          , Yr          , Uu^Ii       , Uu^Uf       , Yr          
Xv          , Xv          , Xv          , Xv          , Xv          , Xv          , Xv          , Xv          , Wo          , Wo          , Xv          , Xv          , Wo          , Wo          , Wo          , Xv          , Wo          , Xv          , Xv          , Xv          , Xv          , Xu          , Xu          , Uu          , Uu^Uf       , Uu          , Uu          , Uu          , Uu          , Ryd         , Uu^Uf       , Zw          , Zw          , Ryd         , Yr          , Yr          , Zw          , Zw          , Zw          , Uu^Uf       , Uh          , Uh          , Uh          , Xu          , Xu          , Xu          , Uh          , Uh          , Uh          , Zw          , Uu^Ii       , Yr          , Yr          , Uu^Uf       
Xv          , Xv          , Xv          , Xv          , Xv          , Xv          , Xv          , Xv          , Xv          , Xv          , Xv          , Xv          , Xv          , Xv          , Wo          , Wo          , Xv          , Xv          , Xv          , Xv          , Xv          , Xv          , Xu          , Yl          , Uu^Ii       , Uu          , Uu          , Uu          , Uu          , Uh          , Uu          , Uu^Uf       , Uu^Ii       , Yr          , Yr          , Ryd         , Zw          , Zw          , Uu^Ii       , Uh          , Yr          , Uu^Uf       , Yr          , Uh          , Uh          , Uh          , Yl          , Yl          , Yl          , Uh          , Ryd         , Ryd         , Ryd         , Yl          
Xv          , Xv          , Xv          , Xv          , Xv          , Xv          , Xv          , Xv          , Xv          , Xv          , Xv          , Xv          , Wo          , Wo          , Xv          , Xv          , Xv          , Xv          , Xv          , Xv          , Xv          , Xv          , Xu          , Xu          , Ryd         , Uu          , Uu          , Uu          , Uu          , Uu          , Uu          , Uu^Uf       , Ryd         , Yr          , Ryd         , Ryd         , Yr          , Yr          , Uu^Uf       , Uu^Uf       , Yl          , Yr          , Ryd         , Yr          , Uh          , Yr          , Zw          , Zw          , Ryd         , Yl          , Yr          , Uh          , Yl          , Yr          
Xv          , Xv          , Xv          , Xv          , Xv          , Xv          , Xv          , Xv          , Xv          , Xv          , Xv          , Xv          , Xv          , Xv          , Xv          , Xv          , Xv          , Xv          , Xv          , Xv          , Xv          , Xv          , Xu          , Ryd         , Zw          , Zw          , Ryd         , Zw          , Yr          , Uu          , Uu^Uf       , Uu^Uf       , Uu^Uf       , Ryd         , Yr          , Yr          , Ryd         , Zw          , Zw          , Ryd         , Zw          , Zw          , Uu^Uf       , Uu^Uf       , Uh          , Yr          , Yr          , Uu^Uf       , Uu^Uf       , Uu^Uf       , Yr          , Yr          , Yr          , Yr          
