Xos, Xos, Xos, Xos, Xos, Xos, Xos, Xos, Xos, Xos, Xos, Xos, Xos, Xos, Xos, Xos, Xos, Xos, Xos, Xos, Xos, Xos, Xos, Xos, Xos, Xu, Xu, Xu, Xu, Xu, Xos, Xos, Xos^Efs, Xos^Efs, Yhl, Xos, Xos, Xos, Xos, Xos, Xos, Xos, Xos, Xos, Xos^Xzm/, Xos, Yhr, Yhl, Yhl, Yhl, Xos, Xos, Xos, Xos, Xos, Xu, Xu, Xu, Xu, Xu, Xu, Xu
Xos, Xos, Xos, Xos, Xos, Xos, Xos, Xos, Xos, Xos, Xos, Xos, Xos, Xos, Xos, Xos, Xos, Xos, Xos, Xos, Xos, Xos, Xos, Xos, Xu, Xu, Xu, Xu, Xu, Xu, Xos, Xos^Xzm/, Yhl^Xp, Yhl^Xp, Xos, Xos, Xos, Xos, Xos, Xos, Xos, Xos, Xos^Xzm/, Xos^Xzm/, Yhl^Uf, Yhl^Xp, Yhr, Yhl, Xos, Xos, Xos^Efs, Xos, Xos, Xos, Xos, Xos, Xos, Xu, Xu, Xu, Xu, Xu
Xos, Xos, Xos, Xos, Xos, Xos, Xos, Xos, Xos, Xos, Xos, Xos, Xos, Xos, Xos, Xos, Xos, Xos, Xos, Xos, Xos, Xos, Xu, Xu, Xu, Xu, Xu, Xu, Xu, Xu, Yhl^Xp, Yhl, Yhl, Xos, Xos^Xzm\, Xos, Yhl, Xos^Xzm\, Xos, Xos, Xos^Efs, Xos^Efs, Yhl, Yhl, Yhl, Yhl, Xos, Xos^Xzm/, Yhl, Yhl, Yhl, Xos^Efs, Xos, Xos, Xos, Xos, Xos, Xos, Xu, Xu, Xu, Xu
Xos, Xos, Xos, Xos, Xos, Xos, Xos, Xos, Xos, Xos, Xos, Xos, Xos^Zok, Xos^Zok, Xos^Zok, Xos, Xos, Xos, Xos, Xos, Xos, Xu, Xu, Xu, Xu, Xu, Xu, Xu, Xu, Xuc, Yhl, Yhl, Yhl^Ii, Yhl^Xp, Yhl, Yhl, Uzw^Uf, Yhl^Uf, Yhl^Xp, Xos^Xzm\, Yhl, Yhl, Xos, Xos, Yhl^Xp, Xos, Yhl, Yhl, Xos, Yhl, Yhl, Yhr, Yhl, Xos^Xzm\, Xos^Efs, Xos, Xos, Xu, Xu, Xu, Xu, Xu
Xos, Xos, Xos, Xos, Xos, Xos, Xos, Xos, Xos, Xos, Xos^Zok, Xos^Zok, Xos^Zok, Xos^Zok, Xos^Zok, Xos^Zok, Xos, Xos, Xos, Xos, Xos, Xu, Xu, Xu, Xu, Xu, Xu, Xu, Xuc, Uh, Uu, Yhl, Yhl, Yhl, Yhl, Uzw, Uzw, Yhl, Uzw^Vu, Yhl, Xos, Yhl, Yhl, Xos, Xos^Xzm\, Yhl, Xos, Xos, Yhr^Xp, Yhr, Yhl, Yhl, Yhl, Yhl, Yhr, Xos^Efs, Xos, Xos, Xu, Xu, Xu, Xu
Xos, Xos, Xos, Xos, Xos, Xos, Xos, Xos, Xos^Zok, Xos^Zok, Xos^Zok, Xos^Zok, Urb^Zok, Urb^Zok, Urb, Xos, Xos, Xos, Xos^Xzm/, Xos, Uh, Xu, Xu, Xu, Uh, Xu, Xu, Xu, Xu, Uh, Uh, Yhl^Xp, Uu, Uu, Yhl, Yhr^Xp, Yhl, Yhl, Uzw, Uzw^Uf, Uzw, Yhl, Yhl^Xp, Yhr, Yhl, Yhl^Xp, Xos^Efs, Xos^Efs, Yhr, Yhr, Xos, Yhr, Yhl, Yhr, Xos, Xos, Xos, Xos, Xu, Xu, Xu, Xu
Xos, Xos, Xos, Xos, Xos, Xos, Xos, Xos, Xos, Xos^Zok, Xos^Zok, Urb^Zok, Urb, Urb, Urb, Urb, Urb, Xos^Efs, Urb^Ebur, Uh, Uu^Uf, Uh, Uu^Uf, Uh, Uu^Uf, Uh, Xu, Xu, Xu, Xu, Uu^Uf, Uh, Uu, Uu^Uf, Yhl, Yhr, Yhl, Yhl, Yhl^Xp, Uzw^Uf, Yhr, Yhr, Yhl, Yhr, Yhr, Xos, Uzw, Yhr, Xos, Yhl^Xp, Yhl^Xp, Xos^Xzm\, Yhl, Yhl, Xos, Xos, Xos, Xos, Xu, Xu, Xu, Xu
Xu, Xos, Xos, Xos, Xos, Xos, Xos, Xos, Xos, Xos, Xos, Xos, Xos, Urb, Urb, Urb, Urb, Urb, Urb, Urb, Urb, Uu^Uf, Uu^Uf, Yhl^Xp, Yhl, Yhl^Xp, Uu^Uf, Xu, Xu, Xos, Xos, Uh, Xu, Yhl^Uf, Xu, Yhl, Yhl, Yhr, Yhr, Yhr, Yhr^Xp, Xos, Xos^Efs, Yhl^Xp, Yhr^Uf, Uzw, Yhl, Yhl^Xp, Yhr, Xos, Yhl, Yhl^Xp, Yhl, Yhr, Yhl, Xos, Xu, Xu, Xu, Xu, Xu, Xu
Xu, Xu, Xu, Xos, Xos, Xos, Xos, Xos, Xos, Xos, Xos, Xos, Xos^Efs, Xos^Efs, Urb, Urb, Urb, Urb, Urb, Urb, Urb, Urb, Uu^Uf, Uzw, Yhl^Xp, Uu^Uf, Uh, Xu, Xu, Xos, Xos, Xos, Xu, Xu, Xu, Yhl^Xp, Yhl^Xp, Uu, Uu, Yhr, Yhl, Yhl^Xp, Yhr, Yhr^Emf, Uzw^Uf, Uzw^Emf, Uzw, Yhr, Yhl^Uf, Yhl, Yhl, Yhl^Vud, Yhr, Yhr^Xp, Yhl, Yhl, Yhl, Xuc, Xos, Xu, Xu, Xu
Xu, Xu, Xu, Xu, Xos, Xos, Xos, Xos, Xos, Xos, Xu, Xu, Xu, Urb^Ebur, Uzw, Uzw, Uzw, Urb, Urb, 1 Urb, Urb, Urb, Urb, Uzw, Urb, Urb, Xu, Xu, Xu, Xos, Xos, Xos, Xu, Xu, Yhl, Uu^Uf, Uu^Uf, Uu^Ii, Uu, Uh, Uzw, Uzw, Yhr, Yhl^Uf, Yhl, Yhl^Emf, Xos, Yhr, Yhl, Yhl^Uf, Yhl^Xp, Yhl, Yhl^Uf, Yhl, Yhl, Yhl, Yhl, Yhl, Xos, Xos, Xu, Xu
Ur^Br\, Xu, Xu, Xu, Xu, Xos, Xos, Xos, Xos, Xu, Xu, Xu, Xu, Xu, Xu, Urb, Uu^Uf, Uu^Uf, Yhl, Urb, Urb, Urb, Urb, Urb, Urb, Urb, Urb, Xu, Xos, Xos, Xos^Efs, Xos^Efs, Yhl, Yhl, Uu^Uf, Yhl^Xp, Yhl^Xp, Uu, Yhl, Xu, Yhl, Yhl, Yhl, Yhl, Yhl, Xos^Efs, Xos^Efs, Xos, Xos, Yhl, Yhl, Yhr^Uf, Yhl, Yhl, Xu, Yhl, Xu, Xu, Xos, Xos, Xu, Xu
Xu, Ur^Br\, Ur^Br\, Xu, Xu, Xu, Uu, Xos^Efs, Xos^Efs, Xu, Xu, Xu, Xu, Xu, Xos, Yhl, Uu^Uf, Uu^Uf, Uu^Uf, Yhl^Xp, Urb, Urb, Urb, Urb, Urb, Urb, Urb, Xos, Xos^Efs, Xos^Xzm/, Yhl, Yhl, Cud, Cud, Cud, Urb, Urb, Yhl, Yhl, Yhl, Yhl^Xp, Yhl^Xp, Yhl, Yhl, Yhl^Ii, Yhl, Yhl, Xos^Xzm\, Xos, Xos, Xos, Yhl, Xos, Xos, Xos, Xu, Xu, Xu, Xu, Xu, Xu, Xu
Xu, Xu, Xu, Ur^Br\, Ur^Pr/, Xu, Uu, Uu, Uu, Xuc, Xuc, Xu, Xu, Xu, Xos, Xos, Xos, Yhl, Uzw, Uh, Xu, Urb, Urb, Urb, Urb, Urb, Urb, Urb, Urb, Yhl^Xo, Yhl^Xo, Cud, Yhl, Yhl, Yhl, 6 Kud, Cud, Yhl, Yhl, Yhl, Yhl, Yhl, Wwg, Yhl, Yhl, Yhl, Yhr^Xp, Yhr, Yhr, Xos^Efs, Xos^Efs, Xos, Xos, Xos, Xos, Xos, Xos, Xu, Xu, Xu, Xu, Xu
Xu, Xu, Xu, Xu, Xos, Ur^Br\, Rr^Br\, Uu, Uu, Uu^Uf, Uu, Xuc, Xu, Xu, Uu^Uf, Xos, Xos, Xos, Xos, Xu, Xu, Xu, Xos, Xos, Xos^Efs, Urb, Urb, Urb, Urb, Urb, Urb, Yhl^Xo, Yhl^Xo, Yhl, Yhl, Yhl, Cud, Cud, Yhl, Yhl^Xp, Yhl, Yhl, Cud, Wwg, Wwg, Yhl, Yhl, Yhr^Uf, Yhr^Uf, Yhr, Yhr, Xos^Xzm/, Yhr, Yhr, Xu, Xos, Xu, Xu, Xu, Xu, Xu, Xu
Xu, Xu, Xu, Xos, Xos, Xos, Uu, Ur^Br\, Rr^Br\, Uu^Vu, Uu, Uu, Uu, Uu^Uf, Uu^Uf, Uh, Uu, Xos, Xu, Xu, Xu, Xos, Xos^Xzm/, Xos^Efs, Yhl, Yhl^Xo, Yhl^Xo, Urb, Urb, Urb, Urb, Urb, Urb, Yhl^Xo, Yhl^Xo, Cud, Yhl, Yhl, Yhl, Yhl, Yhr^Eff, Yhr^Eff, Yhl, Wwg, Wwg, Wwg, Yhl, Yhl^Ii, Yhl, Yhr^Uf, Yhr, Yhr, Yhl, Yhl, Xuc, Xu, Xu, Xu, Xu, Xu, Xu, Xu
Xu, Xu, Xu, Xu, Xu, Xos, Uu, Uu, Uu, Rr^Br\, Rr^Br\, Uh, Xu, Uu, Yhl^Xp, Uu, Uh, Xu, Xu, Xu, Xuc, Xos^Xzm/, Yhl, Yhl, Cud, Cud, Yhl, Yhl^Xo, Yhl^Xo, Urb, Urb, Urb, Urb, Urb, Urb, Yhl^Xo, Yhl^Xo, Yhl, Yhr^Eff, Yhr^Eff, Yhl, Yhl, Yhr^Eff, Cud, Wwg, Wwg, Wwg, Yhl^Xp, Yhl^Xp, Yhr^Uf, Yhl^Uf, Uzw^Uf, Yhl, Yhl, Xu, Xu, Wwg^Xo, Wwg, Xu, Xu, Xu, Xu
Xu, Xu, Xu, Xu, Xu, Xuc, Uu, Uh, Uu^Uf, Uu^Uf, Uu^Uf, Rr^Br\, Ur^Br\, Ur^Br\, Ur^Br\, Yhl, Yhl, Xu, Yhl, Xu, Uu^Uf, Yhl, Yhl, Cud, Cud, Yhl, Yhl, Yhl, Yhl, Yhl^Xo, Yhl^Xo, Urb, Urb, Urb, Urb, Urb, Urb^Ebn, Cud^Xo, Cud^Xo, Yhl, Yhr^Eff, Yhr^Eff, Yhl, Yhl, Cud, Wwg, Wwg, Wwg, Wwg, Yhl, Uzw^Uf, Yhl, Yhl, Yhl, Wwg, Wwg, Xu, Xu, Xu, Xu, Xu, Xu
Xu, Xu, Qxu, Qxu, Qxu, Xu, Uu, Uu^Uf, Uu^Uf, Uu, Uu, Ur, Uu^Uf, Uu^Br/, Uu, Ur^Br\, Ur^Br\, Yhl^Xp, Uu^Vu, Uu^Uf, Uu^Ii, Yhl, Yhl^Xp, Yhl, Yhl, 5 Kud, Cud, Yhl, Cud, Cud, Yhl, Yhl^Xo, Yhl^Xo, Urb, Urb^Ebn, Urb, Cud, Cud, Cud, Cud^Xo, Cud^Xo, Yhl, Yhr^Eff, Yhr^Eff, Yhl, Wwg, Wwg, Yhl, Yhl, Wwg, Wwg, Yhl, Wwg, Wwg, Xu, Xu, Xu, Xu, Xu, Xu, Xu, Xu
Xu, Xu, Qxu, Qxu, Uu, Uu, Uh, Uh, Yhl, Yhl, Uu, Uu^Uf, Yhl, Uu, Xos, Uu, Uu, Ur^Br\, Rr^Br\, Uu, Uu, Yhl^Xp, Yhl, Uu^Uf, Yhl, Yhl, Yhl, Cud, Yhl, Yhl, Yhl, Yhl, Yhr^Eff, Cud^Xo, Cud^Xo, Cud, Cud, 2 Kud, Cud, Cud, Cud^Xo, Cud^Xo, Yhl, Yhl, Xos, Yhl, Wwg, Yhl^Xp, Uzw, Uzw^Uf, Uzw^Emf, Wwg, Uu^Ii, Uu, Xu, Xu, Xu, Xu, Xu, Xu, Xu, Xu
Qxu, Qxu^Xo, Qxu, Xu, Uu, Uu^Uf, Uu^Uf, Yhl, Yhl^Xp, Yhl, Uu, Yhl, Yhl^Xp, Xos, Xos^Efs, Uu^Uf, Uu^Vud, Uu, Ur^Br/, Rr^Br\, Rr^Br\, Yhl, Cud, Yhl, Yhl, Yhl, Yhl^Uf, Yhl, Yhl, Yhl, Yhr^Eff, Yhr^Eff, Yhl, Yhl, Yhr^Eff, Cud^Xo, Cud^Xo, Cud, Cud^Xo, Cud^Xo, Yhl, Urb, Urb, Xos, Yhl, Yhl, Wwg, Yhl^Xp, Yhl, Uzw^Uf, Uh, Uu, Uu^Em, Uu^Em, Xu, Xu, Xu, Xu, Xu, Xu, Xu, Xu
Qxu, Qxu^Xo, Qxu, Uu^Uf, Yhl^Xp, Uu, Uu, Uu^Uf, Uu, Xu, Xu, Yhl, Uu, Uu, Uh, Uu, Uu, Ur^Br/, Uu, Uh, Cud, Cud, Yhl, Yhr, Yhr^Xp, Yhl^Uf, Uzw^Uf, Wwg, Cud, Yhr^Eff, Yhl, Yhl, Yhr^Eff, Yhr^Eff, Yhl, Yhl, Yhr^Eff, Cud^Xo, Yhl, Yhl, Xos, Xos, Yhl, Urb, Yhl, Yhl^Xp, Wwg, Yhl^Ii, Yhl, Yhl, Cud, Uu, Uu, Uu, Xos, Xos, Xos, Xu, Xu, Xu, Xu, Xu
Qxu, Qxu^Xo, Qxu^Xo, Qxu, Xu, Yhl, Uu^Uf, Uu^Ii, Uu, Xuc, Xu, Xu, Uu^Uf, Uu^Uf, Uh, Uu, Ur^Br/, Ur^Br|, Yhl, Uzw, Uzw, Yhl, Yhl, Yhl, Yhl, Yhr, Yhr^Xp, Wwg, Wwg, Wwg, Wwg, Cud, Wwg, Yhl, Cud, Yhr^Eff, Yhl, Yhl, Xos, Yhl, Yhl, Yhl, Yhl, Urb, Cud, Wwg, Yhl, Yhl, Yhl, Yhl, Uu, Uh, Uh, Uh, Xos, Xos, Xos, Xu, Xu, Xu, Xu, Xu
Xu, Qxu, Xu, Xu, Yhl, Uu^Uf, Uu^Uf, Uu, Yhl, Xuc, Xu, Xuc, Uu, Uu, Uu^Uf, Xu, Yhl, Yhl^Xp, Yhl^Xp, Uzw, Uzw^Uf, Uzw^Uf, Yhl^Xp, Yhl^Xp, Yhr^Xp, Uzw^Uf, Yhl, Yhr, Yhl, Wwg, Wwg, Wwg, Wwg, Wwg, Wwg, Yhl, Yhl, Xos^Xzm/, Yhl, Yhl, Yhl, Yhl^Vu, Yhl, Cud, 3 Kud, Cud, Yhl, Yhr, Yhl, Uh, Uu, Uu^Vu, Xuc, Xu, Xos, Xos, Xu, Xu, Xu, Xu, Xu, Xu
Xu, Xu, Xuc, Xuc, Yhl, Yhl, Uu, Uu^Uf, Yhl, Yhl, Yhl, Yhl, Yhl^Xp, Uu^Uf, Yhl^Uf, Yhl, Yhl, Yhl^Xp, Yhl, Yhl^Uf, Yhl^Uf, Uzw, Cud, Yhr, Yhl, Yhl^Uf, Yhl^Uf, Yhl^Ii, Yhl, Uu^Uf, Uu^Uf, Yhl, Yhl, Wwg, Wwg, Yhl, Yhl, Yhl, Yhl^Ii, Yhl, Yhl^Xp, Uu, Uu^Uf, Cud, Cud, Cud, Yhl, Yhr^Xp, Yhl, Uh, Uu, Uu, Xu, Xu, Xu, Xu, Xu, Xu, Xu, Xu, Xu, Xu
Xu, Xu, Xuc, Yhl, Yhl^Xp, Uu, Xu, Uu, Uu^Uf, Yhl, Yhl, Yhl, Yhl, Yhl, Yhl^Uf, Yhl^Xp, Yhl, Yhl, Yhl, Yhl^Uf, Yhl, Uzw, Qlf, Yhr, Yhl, Yhl, Yhl, Yhl, Yhl, Uu^Uf, Uu^Uf, Yhl, Yhl^Ii, Yhl, Yhl, Wwg, Cud, Yhl, Yhl, Yhl, Yhl^Xp, Uu^Vud, Uh, Uu^Uf, Uh, Yhl, Yhr^Vu, Yhr^Xp, Yhl^Xp, Yhl, Yhl, Yhl, Qxu, Xu, Xu, Xu, Xu, Xu, Xu, Xu, Xu, Xu
Xu, Xu, Xu, Yhl, Yhl, Uu, Uu, Uu, Yhl, Yhl, Xos, Xos, Xos, Yhl^Xp, Yhl, Yhl^Xp, Yhl, Xu, Yhl, Yhl^Xp, Yhl, Qlf, Qlf, Qlf, Cud, Yhl, Yhr, Xu, Yhl, Yhl, Yhl, Yhl, Yhl, Yhl, Wwg, Wwg, Yhl, Yhl, Yhl, Yhl, Yhl, Yhl^Xp, Yhl, Uu^Uf, Uu^Uf, Yhr, Yhl, Yhl, Yhl, Yhl, Qxu, Qxu, Qxu^Xo, Qxu^Xo, Xu, Xu, Xu, Xu, Xu, Xu, Xu, Xu
Xu, Xu, Xu, Xu, Xu, Yhl, Yhl, Yhl^Xp, Xos, Xos, Xos, Xos, Xos, Yhl, Yhl^Xp, Xos, Xos, Yhl, Yhl, Yhl, Qlf, Qlf, Qlf, Qlf, Yhl, Yhl, Yhr^Xp, Yhl, Yhl, Yhr, Yhr, Yhl, Xos, Xos, Xos, Yhl, Yhl, Yhl, Yhr, Yhl, Yhl, Yhl^Xp, Yhl, Uu^Uf, Yhl^Emf, Uu^Uf, Yhl, Yhl, Yhl, Yhl, Qxu, Qxu^Xo, Qxu, Qxu, Xu, Xu, Xu, Xu, Xu, Xu, Xu, Xu
Xu, Xu, Xu, Xu, Xu, Xu, Xos, Xos, Xos, Xos, Xos, Xos, Xos, Yhl^Xp, Yhl, Xos^Efs, Yhl, Yhl, Qlf, Qlf, Uu^Vud, Uu, Yhl, Yhl, Yhl, Yhr, Yhl, Yhl, Yhl, Yhl^Uf, Yhr^Uf, Yhl, Yhl, Xos^Xzm/, Yhr, Yhr, Yhl, Yhl, Yhr^Xp, Yhl, Yhl, Yhl, Xos, Yhl, Yhl, Uu^Uf, Yhl, Xu, Xu, Xu, Xu, Qxu^Xo, Xu, Xu, Xu, Xu, Xu, Xu, Xu, Xu, Xu, Xu
Xu, Xu, Xu, Xu, Xu, Xu, Xos, Xos, Xos, Xos, Xos^Xzm/, Xos^Xzm/, Yhl, Yhl, Yhl, Yhl, Qlf, Qlf, Yhl, Uu, Uh, Uu, Yhl, Yhl, Yhl, Yhl, Yhl, Uu^Ii, Uu^Uf, Uu^Uf, Yhl^Uf, Yhr^Xp, Yhr, Yhr, Cud, Yhr, Yhl, Yhr, Yhl, Yhl, Yhl, Xos, Xos^Xzm\, Xos, Xos, Yhl, Yhl^Xp, Xuc, Xuc, Xu, Xu, Xu, Xuc, Xu, Xu, Xu, Xu, Xu, Xu, Xu, Xu, Xu
Xu, Xu, Xu, Xu, Xu, Xu, Xu, Xos, Xos, Xos, Xu, Yhl, Yhl, Yhl, Qlf, Qlf, Uh, Yhl, Yhl, Uu, Uu, Uu^Uf, Uu, Yhl, Xos, Yhl, Yhl, Uh, Yhl, Yhl^Uf, Uu, Uu^Uf, Yhr, Yhl, Yhl, Yhl, Yhl^Xp, Yhl, Yhl, Xos, Xos, Yhl, Yhl, Xos^Xzm/, Yhl, Yhl, Yhl, Yhl, Uh, Uu, Uu, Uh, Uh, Xuc, Xu, Xu, Xu, Xu, Xu, Xu, Xu, Xu
Xu, Xu, Xu, Xu, Xu, Xu, Xu, Xu, Xu, Xu, Xu, Xu, Qlf, Qlf, Yhl, Uu, Uu, Uu, Yhl^Uf, Uu^Uf, Yhl, Uu, Xos, Xos, Xos, Xos, Xos^Efs, Yhr, Yhr^Uf, Yhl, Uu^Vu, Uh, Yhl^Xp, Yhl, Yhl, Yhl, Yhl, Yhl, Yhl^Xp, Yhl, Yhl, Xos^Xzm\, Yhl, Yhl, Yhl^Xp, Yhl, Yhl, Uu^Uf, Uu^Uf, Uu^Vud, Uu, Uu^Ii, Uh, Xu, Xu, Xu, Xu, Xu, Xu, Xu, Xu, Xu
Xu, Xu, Xu, Xu, Xu, Xu, Xu, Xu, Xu, Xu, Qlf^Xo, Qlf, Xu, Yhl, Yhl, Yhl, Yhl, Yhl, Yhl^Uf, Yhl^Uf, Yhl, Uu, Uu, Xos^Xzm\, Xos^Xzm\, Xos^Efs, Yhl, Yhr, Yhl, Yhl, Yhl, Yhl, Yhl, Yhl, Yhl, Yhl^Xp, Yhl, Yhl^Xp, Yhl, Yhl, Yhr, Yhl, Yhl^Xp, Yhl, Yhl, Yhl, Uu^Uf, Uu^Uf, Xuc, Uh, Xu, Uh, Xuc, Xuc, Xu, Xu, Xu, Xu, Xu, Xu, Xu, Xu
Xu, Xu, Xu, Xu, Xu, Xu, Xu, Xu, Xu, Qlf, Xu, Xu, Xu, Xu, Xos, Yhl, Yhl, Xu, Yhl, Yhl, Yhl, Uh, Uu, Uzw, Uu, Yhl, Yhl, Yhl, Yhl, Yhl^Xp, Yhl, Yhl, Yhl, Yhl, Yhl^Ebn, Xos, Xos, Yhr, Yhl, Yhl, Yhl, Yhl, Yhl^Xp, Yhl, Xu, Yhl, Uh, Uu^Uf, Uh, Xuc, Xu, Xu, Xu, Xu, Xu, Xu, Xu, Xu, Xu, Xu, Xu, Xu
Xu, Xu, Xu, Xu, Xu, Xu, Xu, Xu, Xu, Xu, Xu, Xu, Xu, Xos, Xos, Xos, Xos, Yhl, Yhl, Yhl, Xu, Yhl, Xu, Uu, Uu, Yhl, Xos, Xos, Xos, Yhl, Xos, Xos, Xos, Yhl, Yhl, Yhl, Xos, Xos, Xos, Yhl^Eb, Yhl^Xp, Yhl, Yhl, Xu, Xu, Xu, Uu, Uu^Em, Qxu, Xu, Qxu, Xu, Xu, Xu, Xu, Xu, Xu, Xu, Xu, Xu, Xu, Xu
Xu, Xu, Xu, Xu, Xu, Xu, Xu, Xu, Xu, Xu, Xu, Xu, Xu, Xu, Xu, Xos, Xos, Xos, Xos, Xu, Xu, Xu, Xu, Xu, Xos, Xos, Xos, Xos, Xos, Xos, Xos^Xzm/, Xos, Yhl, Yhl, Xos, Xos, Xos, Xos^Xzm/, Yhl, Yhl, Xos, Yhl, Yhl, Xuc, Xu, Xu, Xu, Qxu, Qxu^Xo, Qxu^Xo, Qxu, Qxu, Qxu, Xu, Xu, Xu, Xu, Xu, Xu, Xu, Xu, Xu
Xu, Xu, Xu, Xu, Xu, Xu, Xu, Xu, Xu, Xu, Xu, Xu, Xu, Xu, Xu, Xu, Xu, Xos, Xos, Xos, Xu, Xu, Xos, Xos, Xos, Xos, Uh, Uh, Uu, Xos^Xzm/, Rb^Gvs, Rb, Rb, Yhl, Yhl, Xos^Xzm/, Yhl, Yhl, Rb^Gvs, Xos, Xos, Xos, Xos, Xu, Xu, Xu, Xu, Qxu^Xo, Qxu, Qxu, Qxu, Qxu, Xu, Xu, Xu, Xu, Xu, Xu, Xu, Xu, Xu, Xu
Xu, Xu, Xu, Xu, Xu, Xu, Xu, Xu, Xu, Xu, Xu, Xu, Xu, Xu, Xu, Xu, Xu, Xu, Xu, Xu, Xu, Xos, Xos, Xos, Uh, Uh, Uh, Uu^Vud, Rb^Gvs, Rb^Gvs, Rb^Gvs, Rb^Gvs, Rb^Gvs, Rb, Rb, Yhl, Rb^Gvs, Rb^Gvs, Rb^Gvs, Rb^Gvs, Rb^Gvs, Xos, Xos, Xos, Xos, Xu, Xu, Qxu, Qxu, Qxu, Xu, Xu, Xu, Xu, Xu, Xu, Xu, Xu, Xu, Xu, Xu, Xu
Xu, Xu, Xu, Xu, Xu, Xu, Xu, Xu, Xu, Xu, Xu, Xu, Xu, Xu, Xu, Xu, Xu, Xu, Xu, Xu, Xu, Xu, Xu, Xu, Xuc, Uu^Vu, Rb^Gvs, Wwg, Wwg, Rb^Gvs, Rb^Gvs, Rb^Gvs, Rb, Rb, Rb^Gvs, Rb, Rb, Rb^Gvs, Rb^Gvs, Rb^Gvs, Wwg, Wwg, Xuc, Xos, Xu, Xu, Xu, Xu, Xu, Xu, Xu, Xu, Xu, Xu, Xu, Xu, Xu, Xu, Xu, Xu, Xu, Xu
Xu, Xu, Xu, Xu, Xu, Xu, Xu, Xu, Xu, Xu, Xu, Xu, Xu, Xu, Xu, Xu, Xu, Xu, Xu, Xu, Xu, Xu, Xu, Xuc, Rb^Gvs, Rb^Gvs, Rb^Gvs, Rb^Gvs, Rb^Gvs, Wwg, Wwg^Bw/, Rb, Rb^Gvs, Rb^Gvs, Rb^Gvs, Rb^Gvs, Rb^Gvs, Rb, Wwg^Bw\, Wwg, Uu^Uf, Uu^Vud, Xuc, Xu, Xu, Xu, Xu, Xu, Xu, Xu, Xu, Xu, Xu, Xu, Xu, Xu, Xu, Xu, Xu, Xu, Xu, Xu
Xu, Xu, Xu, Xu, Xu, Xu, Xu, Xu, Xu, Xu, Xu, Xu, Xu, Xu, Xu, Xu, Xu, Xu, Xu, Xu, Xu, Xu, Xu, Xu, Xu, Rb^Gvs, Rb^Gvs, Rb^Gvs, Xu, Rb, Rb^Gvs, Wwg, Wwg, Rb^Gvs, Rb^Gvs, Rb^Gvs, Wwg, Wwg, Uh, Uu, Uu, Uh, Xuc, Xu, Xu, Xu, Xu, Xu, Xu, Xu, Xu, Xu, Xu, Xu, Xu, Xu, Xu, Xu, Xu, Xu, Xu, Xu
Xu, Xu, Xu, Xu, Xu, Xu, Xu, Xu, Xu, Xu, Xu, Xu, Xu, Xu, Xu, Xu, Xu, Xu, Xu, Xu, Xu, Xu, Xu, Xu, Xu, Xuc, Xuc, Xuc, Rb^Gvs, Rb^Gvs, Rb^Gvs, Rb^Gvs, Rb^Gvs, Wwg, Wwg, Wwg, Xuc, Xu, Xu, Xu, Xu, Xuc, Xu, Xu, Xu, Xu, Xu, Xu, Xu, Xu, Xu, Xu, Xu, Xu, Xu, Xu, Xu, Xu, Xu, Xu, Xu, Xu
Xu, Xu, Xu, Xu, Xu, Xu, Xu, Xu, Xu, Xu, Xu, Xu, Xu, Xu, Xu, Xu, Xu, Xu, Xu, Xu, Xu, Xu, Xu, Xu, Xu, Xu, Xu, Xuc, Xu, Rb^Gvs, Rb^Gvs, Rb^Gvs, Xuc, Xuc, Xuc, Wwg^Es, Wwg, Xu, Xu, Xu, Xu, Xu, Xu, Xu, Xu, Xu, Xu, Xu, Xu, Xu, Xu, Xu, Xu, Xu, Xu, Xu, Xu, Xu, Xu, Xu, Xu, Xu
Xu, Xu, Xu, Xu, Xu, Xu, Xu, Xu, Xu, Xu, Xu, Xu, Xu, Xu, Xu, Xu, Xu, Xu, Xu, Xu, Xu, Xu, Xu, Xu, Xu, Xu, Xu, Xu, Xu, Xu, Xu, Xu, Xu, Xu, Xu, Xu, Xu, Wwg, Xos, Xos, Xos, Xu, Xu, Xu, Xu, Xu, Xu, Xu, Xu, Xu, Xu, Xu, Xu, Xu, Xu, Xu, Xu, Xu, Xu, Xu, Xu, Xu
Xu, Xu, Xu, Xu, Xu, Xu, Xu, Xu, Xu, Xu, Xu, Xu, Xu, Xu, Xu, Xu, Xu, Xu, Xu, Xu, Xu, Xu, Xu, Xu, Xu, Xu, Xu, Xu, Xu, Xu, Xu, Xu, Xu, Xu, Xu, Xu, Xu, Xos, Xos, Xos, Xu, Xu, Xu, Xu, Xu, Xu, Xu, Xu, Xu, Xu, Xu, Xu, Xu, Xu, Xu, Xu, Xu, Xu, Xu, Xu, Xu, Xu
Xu, Xu, Xu, Xu, Xu, Xu, Xu, Xu, Xu, Xu, Xu, Xu, Xu, Xu, Xu, Xu, Xu, Xu, Xu, Xu, Xu, Xu, Xu, Xu, Xu, Xu, Xu, Xu, Xu, Xu, Xu, Xu, Xu, Xu, Xu, Xu, Xu, Xu, Xu, Xu, Xu, Xu, Xu, Xu, Xu, Xu, Xu, Xu, Xu, Xu, Xu, Xu, Xu, Xu, Xu, Xu, Xu, Xu, Xu, Xu, Xu, Xu
Xu, Xu, Xu, Xu, Xu, Xu, Xu, Xu, Xu, Xu, Xu, Xu, Xu, Xu, Xu, Xu, Xu, Xu, Xu, Xu, Xu, Xu, Xu, Xu, Xu, Xu, Xu, Xu, Xu, Xu, Xu, Xu, Xu, Xu, Xu, Xu, Xu, Xu, Xu, Xu, Xu, Xu, Xu, Xu, Xu, Xu, Xu, Xu, Xu, Xu, Xu, Xu, Xu, Xu, Xu, Xu, Xu, Xu, Xu, Xu, Xu, Xu
Xu, Xu, Xu, Xu, Xu, Xu, Xu, Xu, Xu, Xu, Xu, Xu, Xu, Xu, Xu, Xu, Xu, Xu, Xu, Xu, Xu, Xu, Xu, Xu, Xu, Xu, Xu, Xu, Xu, Xu, Xu, Xu, Xu, Xu, Xu, Xu, Xu, Xu, Xu, Xu, Xu, Xu, Xu, Xu, Xu, Xu, Xu, Xu, Xu, Xu, Xu, Xu, Xu, Xu, Xu, Xu, Xu, Xu, Xu, Xu, Xu, Xu
