Xos, Xos, Xos, Xos, Xos, Xos, Xos, Xos, Xos, Xos, Xos, Xos, Xos, Xos, Xos, Xos, Xos, Xos, Xos, Xos, Xos, Xos, Xos, Xos, Xos, Xu, Xu, Xu, Xu, Xu, Xos, Xos, Xos^Efs, Xos^Efs, Yhl, Xos, Xos, Xos, Xos, Xos, Xos, Xos, Xos, Xos, Xos^Xzm/, Xos, Yhr, Yhl, Yhl, Yhl, Xos, Xos, Xos, Xos, Xos, Xu, Xu, Xu, Xu, Xu, Xu, Xu
Xos, Xos, Xos, Xos, Xos, Xos, Xos, Xos, Xos, Xos, Xos, Xos, Xos, Xos, Xos, Xos, Xos, Xos, Xos, Xos, Xos, Xos, Xos, Xos, Xu, Xu, Xu, Xu, Xu, Xu, Xos, Xos^Xzm/, Yhl^Xp, Yhl^Xp, Xos, Xos, Xot, Xos, Xos, Xos, Xos, Xos, Xos^Xzm/, Xos^Xzm/, Yhl^Tf, Yhl^Xp, Yhr, Yhl, Xos, Xor, Xos^Efs, Xos, Xos, Xos, Xos, Xos, Xos, Xu, Xu, Xu, Xu, Xu
Xos, Xos, Xos, Xos, Xos, Xos, Xos, Xos, Xos, Xos, Xos, Xos, Xos, Xos, Xos, Xos, Xos, Xos, Xos, Xos, Xos, Xos, Xu, Xu, Xu, Xu, Xu, Xu, Xu, Xu, Yhl^Xp, Yhl, Yhl, Xos, Xor^Xzm\, Xot, Yhl, Xot^Xzm\, Xos, Xos, Xos^Efs, Xos^Efs, Yhl, Yhl, Yhl, Yhl, Xot, Xos^Xzm/, Yhl, Yhl, Yhl, Xos^Efs, Xos, Xos, Xos, Xos, Xos, Xos, Xu, Xu, Xu, Xu
Xos, Xos, Xos, Xos, Xos, Xos, Xos, Xos, Xos, Xos, Xos, Xos, Xos^Zok, Xos^Zok, Xos^Zok, Xos, Xos, Xos, Xos, Xos, Xos, Xu, Xu, Xu, Xu, Xu, Xu, Xu, Xu, Xuc, Yhl, Yhl, Yhl^Ii, Yhl^Xp, Yhl, Yhl, Uzw^Tf, Yhl^Tf, Yhl^Xp, Xos^Exw, Yhl, Yhl, Xot, Xos, Yhl^Xp, Xos, Yhl, Yhl, Xor, Yhl^Yva, Yhl^Yva, Yhr, Yhl, Xot^Xzm\, Xos^Efs, Xos, Xos, Xu, Xu, Xu, Xu, Xu
Xos, Xos, Xos, Xos, Xos, Xos, Xos, Xos, Xos, Xos, Xos^Zok, Xos^Zok, Xos^Zok, Xos^Zok, Xos^Zok, Xos^Zok, Xos, Xos, Xos, Xos, Xos, Xu, Xu, Xu, Xu, Xu, Xu, Xu, Xuc, Uh, Uu, Yhl^Yva, Yhl, Yhl, Yhl, Uzw, Uzw, Yhl, Uzw^Vyf, Yhl, Xos, Yhl, Yhl, Xos, Xos^Xzm\, Yhl, Xos, Xor, Yhr^Xp, Yhr, Yhl, Yhl, Yhl^Yva, Yhl, Yhr, Xos^Efs, Xos, Xos, Xu, Xu, Xu, Xu
Xos, Xos, Xos, Xos, Xos, Xos, Xos, Xos, Xos^Zok, Xos^Zok, Xos^Zok, Xos^Zok, Urb^Zok, Urb^Zok, Urb, Xos^Exw, Xos^Exw, Xos, Xor^Xzm/, Xor, Uh, Xu, Xu, Xu, Uh, Xu, Xu, Xu, Xu, Uh, Uh, Yhl^Xp, Uu, Uu, Yhl^Yva, Yhr^Xp, Yhl, Yhl, Uzw, Uzw^Tf, Uzw, Yhl, Yhl^Xp, Yhr, Yhl, Yhl^Xp, Xos^Efs, Xos^Efs, Yhr, Yhr, Xos, Yhr, Yhl, Yhr, Xos, Xos, Xos, Xos, Xu, Xu, Xu, Xu
Xos, Xos, Xos, Xos, Xos, Xos, Xos, Xos, Xos, Xos^Zok, Xos^Zok, Urb^Zok, Urb, Urb, Urb, Urb, Urb, Xos^Efs, Urb^Ebur, Uh, Uu^Tf, Uh, Uu^Tf, Uh, Uu^Tf, Uh, Xu, Xu, Xu, Xu, Uu^Tf, Uh, Uu, Uu^Tf, Yhl, Yhr, Yhl^Yva, Yhl, Yhl^Xp, Uzw^Tf, Yhr, Yhr, Yhl, Yhr, Yhr, Xor, Uzw, Yhr, Xos, Yhl^Xp, Yhl^Xp, Xor^Xzm\, Yhl, Yhl, Xot, Xos, Xos, Xos, Xu, Xu, Xu, Xu
Xu, Xos, Xos, Xos, Xos, Xos, Xos, Xos, Xos, Xos, Xos, Xos, Xos, Urb, Urb, Urb, Urb, Urb, Urb, Urb, Urb, Tb^Tf, Tb^Tf, Yhl^Xp, Yhl, Yhl^Xp, Tb^Tf, Xu, Xu, Xos, Xos, Uh, Xu, Yhl^Tf, Xu, Yhl, Yhl, Yhr, Yhr, Yhr, Yhr^Xp, Xos, Xos^Efs, Yhl^Xp, Tb^Tf, Uzw, Yhl, Yhl^Xp, Yhr, Xot, Yhl, Yhl^Xp, Yhl, Yhr, Yhl, Xos, Xu, Xu, Xu, Xu, Xu, Xu
Xu, Xu, Xu, Xos, Xos, Xos, Xos, Xos, Xos, Xos, Xos, Xos, Xos^Efs, Xos^Efs, Urb, Urb, Urb, Urb, Urb, Urb, Urb, Urb, Uu^Tf, Uzw, Yhl^Xp, Tb^Tf, Uh, Xu, Xu, Xos, Xos, Xos, Xu, Xu, Xu, Yhl^Xp, Yhl^Xp, Uu, Uu, Yhr, Yhl, Yhl^Xp, Yhr, Yhr^Emf, Tb^Tf, Uzw^Emf, Uzw, Yhr, Yhl^Tf, Yhl, Yhl, Yhl^Vyv, Yhr, Yhr^Xp, Yhl^Yva, Yhl^Yva, Yhl, Xuc, Xos, Xu, Xu, Xu
Xu, Xu, Xu, Xu, Xos, Xos, Xos, Xos, Xos, Xos, Xu, Xu, Xu, Urb^Ebur, Uzw, Uzw, Uzw, Urb, Urb, 1 Urb, Urb, Urb, Urb, Uzw, Urb, Urb, Xu, Xu, Xu, Xos, Xos, Xos, Xu, Xu, Yhl, Tb^Tf, Tb^Tf, Uu^Ii, Uu, Uh, Uzw, Uzw, Yhr, Yhl^Tf, Yhl, Yhl^Emf, Xos, Yhr, Yhl, Yhl^Tf, Yhl^Xp, Yhl, Yhl^Tf, Yhl^Yva, Yhl, Yhl, Yhl, Yhl, Xos, Xos, Xu, Xu
Ur^Br\, Xu, Xu, Xu, Xu, Xos, Xoa, Xos, Xos, Xu, Xu, Xu, Xu, Xu, Xu, Urb, Tb^Tf, Uu^Tf, Yhl, Urb, Urb, Urb, Urb, Urb, Urb, Urb, Urb, Xu, Xos, Xos, Xos^Efs, Xos^Efs, Yhl, Yhl, Tb^Tf, Yhl^Xp, Yhl^Xp, Uu, Yhl^Yva, Xu, Yhl, Yhl^Yva, Yhl, Yhl, Yhl, Xos^Efs, Xos^Efs, Xos, Xos, Yhl, Yhl, Yhr^Tf, Yhl, Yhl, Xu, Yhl, Xu, Xu, Xos, Xos, Xu, Xu
Xu, Ur^Br\, Ur^Br\, Xu, Xu, Xu, Uu, Xoa^Efs, Xoa^Efs, Xu, Xu, Xu, Xu, Xu, Xos, Yhl, Tb^Tf, Tb^Tf, Tb^Tf, Yhl^Xp, Urb, Urb, Urb, Urb, Urb, Urb, Urb, Xor, Xos^Efs, Xos^Xzm/, Yhl, Yhl, Cud, Cud, Cud, Urb, Urb, Yhl, Yhl, Yhl, Yhl^Xp, Yhl^Xp, Yhl, Yhl, Yhl^Ii, Yhl, Yhl, Xos^Xzm\, Xot, Xos, Xos, Yhl, Xos, Xos, Xos, Xu, Xu, Xu, Xu, Xu, Xu, Xu
Xu, Xu, Xu, Ur^Br\, Ur^Pr/, Xu, Uu, Uu, Uu, Xuc, Xuc, Xu, Xu, Xu, Xos, Xos, Xos, Yhl, Uzw, Uh, Xu, Urb, Urb, Urb, Urb, Urb, Urb, Urb, Urb, Yhl^Xo, Yhl^Xo, Cud, Yhl, Yhl, Yhl, 6 Kud, Cud, Yhl, Yhl, Yhl, Yhl, Yhl, Wwg, Yhl, Yhl, Yhl^Yva, Yhr^Xp, Yhr, Yhr, Xos^Exw, Xos^Exw, Xos, Xos, Xot, Xot, Xos, Xos, Xu, Xu, Xu, Xu, Xu
Xu, Xu, Xu, Xu, Xoa, Ur^Br\, Rr^Br\, Uu, Uu, Uu^Tf, Uu, Xuc, Xu, Xu, Tb^Tf, Xos, Xot, Xos, Xos, Xu, Xu, Xu, Xos, Xos, Xos^Efs, Urb, Urb, Urb, Urb, Urb, Urb, Yhl^Xo, Yhl^Xo, Yhl, Yhl, Yhl, Cud, Cud, Yhl, Yhl^Xp, Yhl^Vyv, Yhl, Cud, Wwg, Wwg, Yhl, Yhl, Yhr^Tf, Tb^Tf, Yhr, Yhr, Xor^Xzm/, Yhr, Yhr, Xu, Xos, Xu, Xu, Xu, Xu, Xu, Xu
Xu, Xu, Xu, Xoa, Xoa, Xoa, Uu, Ur^Br\, Rr^Br\, Uu^Vu, Uu, Uu, Uu, Uu^Tf, Tb^Tf, Uh, Uu, Xos, Xu, Xu, Xu, Xos, Xos^Xzm/, Xos^Efs, Yhl, Yhl^Xo, Yhl^Xo, Urb, Urb, Urb, Urb, Urb, Urb, Yhl^Xo, Yhl^Xo, Cud, Yhl, Yhl, Yhl, Yhl, Yhr^Eff, Yhr^Eff, Yhl, Wwg, Wwg, Wwg, Yhl, Yhl^Ii, Yhl, Tb^Tf, Yhr, Yhr, Yhl^Yva, Yhl, Xuc, Xu, Xu, Xu, Xu, Xu, Xu, Xu
Xu, Xu, Xu, Xu, Xu, Xoa, Uu, Uu, Uu, Rr^Br\, Rr^Br\, Uh, Xu, Uu, Yhl^Xp, Uu, Uh, Xu, Xu, Xu, Xuc, Xos^Xzm/, Yhl, Yhl, Cud, Cud, Yhl, Yhl^Xo, Yhl^Xo, Urb, Urb, Urb, Urb, Urb, Urb, Yhl^Xo, Yhl^Xo, Yhl, Yhr^Eff, Yhr^Eff, Yhl, Yhl, Yhr^Eff, Cud, Wwg, Wwg, Wwg, Yhl^Xp, Yhl^Xp, Tb^Tf, Yhl^Tf, Uzw^Tf, Yhl, Yhl, Xu, Xu, Wwg^Xo, Wwg, Xu, Xu, Xu, Xu
Xu, Xu, Xu, Xu, Xu, Xuc, Uu, Uh, Tb^Tf, Uu^Tf, Uu^Tf, Rr^Br\, Ur^Br\, Ur^Br\, Ur^Br\, Yhl, Yhl, Xu, Yhl, Xu, Uu^Tf, Yhl^Yva, Yhl, Cud, Cud, Yhl, Yhl, Yhl, Yhl, Yhl^Xo, Yhl^Xo, Urb, Urb, Urb, Urb, Urb, Urb^Ebn, Cud^Xo, Cud^Xo, Yhl, Yhr^Eff, Yhr^Eff, Yhl, Yhl, Cud, Wwg, Wwg, Wwg, Wwg, Yhl, Uzw^Tf, Yhl, Yhl, Yhl, Wwg, Wwg, Xu, Xu, Xu, Xu, Xu, Xu
Xu, Xu, Qxu, Qxu, Qxu, Xu, Uu, Tb^Tf, Tb^Tf, Uu, Uu, Ur, Uu^Tf, Uu^Br/, Uu, Ur^Br\, Ur^Br\, Yhl^Xp, Uu^Vu, Uu^Tf, Uu^Ii, Yhl^Yva, Yhl^Xp, Yhl, Yhl, 5 Kud, Cud, Yhl, Cud, Cud, Yhl, Yhl^Xo, Yhl^Xo, Urb, Urb^Ebn, Urb, Cud, Cud, Cud, Cud^Xo, Cud^Xo, Yhl, Yhr^Eff, Yhr^Eff, Yhl, Wwg, Wwg, Yhl, Yhl, Wwg, Wwg, Yhl, Wwg, Wwg, Xu, Xu, Xu, Xu, Xu, Xu, Xu, Xu
Xu, Xu, Qxu, Qxu, Uu, Uu, Uh, Uh, Yhl^Yva, Yhl, Uu, Uu^Tf, Yhl, Uu, Xos, Uu, Uu, Ur^Br\, Rr^Br\, Uu, Uu, Yhl^Xp, Yhl, Uu^Tf, Yhl, Yhl, Yhl, Cud, Yhl, Yhl, Yhl, Yhl, Yhr^Eff, Cud^Xo, Cud^Xo, Cud, Cud, 2 Kud, Cud, Cud, Cud^Xo, Cud^Xo, Yhl, Yhl, Xor, Yhl, Wwg, Yhl^Xp, Uzw, Uzw^Tf, Uzw^Emf, Wwg, Uu^Ii, Uu, Xu, Xu, Xu, Xu, Xu, Xu, Xu, Xu
Qxu, Qxu^Xo, Qxu, Xu, Uu^Em, Tb^Tf, Tb^Tf, Yhl, Yhl^Xp, Yhl, Uu, Yhl, Yhl^Xp, Xos, Xos^Efs, Uu^Tf, Uu^Vyf, Uu, Ur^Br/, Rr^Br\, Rr^Br\, Yhl, Cud, Yhl, Yhl, Yhl, Yhl^Tf, Yhl, Yhl, Yhl^Vyv, Yhr^Eff, Yhr^Eff, Yhl, Yhl, Yhr^Eff, Cud^Xo, Cud^Xo, Cud, Cud^Xo, Cud^Xo, Yhl, Urb, Urb, Xos, Yhl, Yhl^Yva, Wwg, Yhl^Xp, Yhl, Uzw^Tf, Uh, Uu, Uu^Em, Uu^Em, Xu, Xu, Xu, Xu, Xu, Xu, Xu, Xu
Qxu, Qxu^Xo, Qxu, Uu^Tf, Yhl^Xp, Uu^Em, Uu^Emf, Uu^Tf, Uu, Xu, Xu, Yhl, Uu, Uu, Uh, Uu, Uu, Ur^Br/, Uu, Uh, Cud, Cud, Yhl, Yhr, Yhr^Xp, Yhl^Tf, Uzw^Tf, Wwg, Cud, Yhr^Eff, Yhl, Yhl, Yhr^Eff, Yhr^Eff, Yhl, Yhl, Yhr^Eff, Cud^Xo, Yhl, Yhl, Xor, Xos, Yhl, Urb, Yhl, Yhl^Xp, Wwg, Yhl^Ii, Yhl, Yhl, Cud, Uu, Uu, Uu, Xos, Xos, Xos, Xu, Xu, Xu, Xu, Xu
Qxu, Qxu^Xo, Qxu^Xo, Qxu, Xu, Yhl^Em, Tb^Tf, Uu^Ii, Uu, Xuc, Xu, Xu, Uu^Tf, Uu^Tf, Uh, Uu, Ur^Br/, Ur^Br|, Yhl, Uzw, Uzw, Yhl, Yhl, Yhl, Yhl, Yhr, Yhr^Xp, Wwg, Wwg, Wwg, Wwg, Cud, Wwg, Yhl, Cud, Yhr^Eff, Yhl, Yhl, Xor, Yhl, Yhl, Yhl, Yhl, Urb, Cud, Wwg, Yhl, Yhl^Yva, Yhl, Yhl, Uu, Uh, Uh, Uh, Xos, Xos, Xos, Xu, Xu, Xu, Xu, Xu
Xu, Qxu, Xu, Xu, Yhl, Tb^Tf, Tb^Tf, Uu, Yhl, Xuc, Xu, Xuc, Uu, Uu, Tb^Tf, Xu, Yhl^Yva, Yhl^Xp, Yhl^Xp, Uzw, Tb^Tf, Uzw^Tf, Yhl^Xp, Yhl^Xp, Yhr^Xp, Uzw^Tf, Yhl, Yhr, Yhl, Wwg, Wwg, Wwg, Wwg, Wwg, Wwg, Yhl, Yhl, Xos^Xzm/, Yhl, Yhl, Yhl, Yhl^Vyv, Yhl, Cud, 3 Kud, Cud, Yhl, Yhr, Yhl, Uh, Uu, Uu^Vu, Xuc, Xu, Xos, Xos, Xu, Xu, Xu, Xu, Xu, Xu
Xu, Xu, Xuc, Xuc, Yhl^Yva, Yhl^Em, Uu, Uu^Tf, Yhl, Yhl, Yhl^Yva, Yhl, Yhl^Xp, Tb^Tf, Tb^Tf, Yhl, Yhl, Yhl^Xp, Yhl, Tb^Tf, Tb^Tf, Uzw, Cud, Yhr, Yhl, Yhl^Tf, Yhl^Tf, Yhl^Ii, Yhl, Uu^Tf, Tb^Tf, Yhl^Yva, Yhl, Wwg, Wwg, Yhl, Yhl, Yhl^Yva, Yhl^Ii, Yhl, Yhl^Xp, Uu, Uu^Tf, Cud, Cud, Cud, Yhl, Yhr^Xp, Yhl, Uh, Uu, Uu, Xu, Xu, Xu, Xu, Xu, Xu, Xu, Xu, Xu, Xu
Xu, Xu, Xuc, Yhl, Yhl^Xp, Uu, Xu, Uu, Uu^Tf, Yhl, Yhl, Yhl, Yhl, Yhl, Yhl^Tf, Yhl^Xp, Yhl, Yhl, Yhl, Yhl^Tf, Yhl, Uzw, Qlf, Yhr, Yhl, Yhl, Yhl, Yhl, Yhl, Tb^Tf, Tb^Tf, Yhl, Yhl^Ii, Yhl, Yhl^Yva, Wwg, Cud, Yhl, Yhl, Yhl, Yhl^Xp, Uu^Vyf, Uh, Tb^Tf, Uh, Yhl, Yhr^Vu, Yhr^Xp, Yhl^Xp, Yhl, Yhl, Yhl, Qxu, Xu, Xu, Xu, Xu, Xu, Xu, Xu, Xu, Xu
Xu, Xu, Xu, Yhl, Yhl^Yva, Uu, Uu, Uu, Yhl, Yhl, Xos, Xos, Xos, Yhl^Xp, Yhl, Yhl^Xp, Yhl, Xu, Yhl, Yhl^Xp, Yhl^Yva, Qlf, Qlf, Qlf, Cud, Yhl, Yhr, Xu, Yhl, Yhl, Yhl, Yhl, Yhl, Yhl, Wwg, Wwg, Yhl, Yhl, Yhl, Yhl, Yhl, Yhl^Xp, Yhl, Tb^Tf, Tb^Tf, Yhr, Yhl, Yhl, Yhl, Yhl, Qxu, Qxu, Qxu^Xo, Qxu^Xo, Xu, Xu, Xu, Xu, Xu, Xu, Xu, Xu
Xu, Xu, Xu, Xu, Xu, Yhl^Yva, Yhl, Yhl^Xp, Xos, Xos, Xos, Xos, Xos, Yhl, Yhl^Xp, Xos, Xos, Yhl, Yhl^Yva, Yhl^Yva, Qlf, Qlf, Qlf, Qlf, Yhl^Yva, Yhl, Yhr^Xp, Yhl, Yhl, Yhr, Yhr, Yhl, Xor, Xos, Xos, Yhl, Yhl, Yhl, Yhr, Yhl, Yhl, Yhl^Xp, Yhl, Uu^Tf, Yhl^Emf, Tb^Tf, Yhl, Yhl, Yhl, Yhl, Qxu, Qxu^Xo, Qxu, Qxu, Xu, Xu, Xu, Xu, Xu, Xu, Xu, Xu
Xu, Xu, Xu, Xu, Xu, Xu, Xos, Xos, Xos, Xos, Xos, Xos, Xos, Yhl^Xp, Yhl, Xos^Efs, Yhl^Yva, Yhl, Qlf, Qlf, Uu^Vyf, Uu, Yhl^Yva, Yhl^Yva, Yhl, Yhr, Yhl, Yhl, Yhl, Yhl^Tf, Yhr^Tf, Yhl, Yhl, Xor^Xzm/, Yhr, Yhr, Yhl, Yhl^Yva, Yhr^Xp, Yhl, Yhl, Yhl, Xos, Yhl, Yhl, Uu^Tf, Yhl, Xu, Xu, Xu, Xu, Qxu^Xo, Xu, Xu, Xu, Xu, Xu, Xu, Xu, Xu, Xu, Xu
Xu, Xu, Xu, Xu, Xu, Xu, Xos, Xos, Xos, Xos, Xos^Xzm/, Xot^Xzm/, Yhl, Yhl, Yhl^Yva, Yhl, Qlf, Qlf, Yhl^Yva, Uu, Uh, Uu, Yhl, Yhl, Yhl, Yhl, Uu^Vyf, Uu^Ii, Tb^Tf, Tb^Tf, Tb^Tf, Yhr^Xp, Yhr, Yhr, Cud, Yhr, Yhl, Yhr, Yhl, Yhl, Yhl, Xos, Xot^Xzm\, Xos, Xos, Yhl, Yhl^Xp, Xuc, Xuc, Xu, Xu, Xu, Xuc, Xu, Xu, Xu, Xu, Xu, Xu, Xu, Xu, Xu
Xu, Xu, Xu, Xu, Xu, Xu, Xu, Xos, Xos, Xos, Xu, Yhl, Yhl, Yhl, Qlf, Qlf, Uh, Yhl, Yhl, Uu, Uu, Uu^Tf, Uu, Yhl, Xos, Yhl, Yhl, Uh, Yhl, Tb^Tf, Uu, Uu^Tf, Yhr, Yhl, Yhl, Yhl, Yhl^Xp, Yhl, Yhl, Xot, Xos, Yhl, Yhl, Xos^Xzm/, Yhl, Yhl, Yhl^Yva, Yhl, Uh, Uu, Uu, Uh, Uh, Xuc, Xu, Xu, Xu, Xu, Xu, Xu, Xu, Xu
Xu, Xu, Xu, Xu, Xu, Xu, Xu, Xu, Xu, Xu, Xu, Xu, Qlf, Qlf, Yhl, Uu, Uu, Uu, Yhl^Tf, Uu^Tf, Yhl, Uu, Xot, Xos, Xos, Xos, Xos^Efs, Yhr, Yhr^Tf, Yhl, Uu^Vu, Uh, Yhl^Xp, Yhl, Yhl, Yhl, Yhl, Yhl, Yhl^Xp, Yhl, Yhl, Xos^Xzm\, Yhl, Yhl, Yhl^Xp, Yhl, Yhl, Tb^Tf, Tb^Tf, Uu^Vud, Uu, Uu^Ii, Uh, Xu, Xu, Xu, Xu, Xu, Xu, Xu, Xu, Xu
Xu, Xu, Xu, Xu, Xu, Xu, Xu, Xu, Xu, Xu, Qlf^Xo, Qlf, Xu, Yhl, Yhl, Yhl, Yhl, Yhl, Yhl^Tf, Yhl^Tf, Yhl, Uu, Uu, Xos^Xzm\, Xot^Xzm\, Xos^Efs, Yhl, Yhr, Yhl^Yva, Yhl, Yhl, Yhl, Yhl, Yhl, Yhl, Yhl^Xp, Yhl, Yhl^Xp, Yhl, Yhl, Yhr, Yhl, Yhl^Xp, Yhl, Yhl^Yva, Yhl, Tb^Tf, Tb^Tf, Xuc, Uh, Xu, Uh, Xuc, Xuc, Xu, Xu, Xu, Xu, Xu, Xu, Xu, Xu
Xu, Xu, Xu, Xu, Xu, Xu, Xu, Xu, Xu, Qlf, Xu, Xu, Xu, Xu, Xos, Yhl, Yhl, Xu, Yhl, Yhl, Yhl, Uh, Uu, Uzw, Uu, Yhl, Yhl, Yhl, Yhl, Yhl^Xp, Yhl, Yhl^Yva, Yhl, Yhl, Yhl^Ebn, Xos, Xos, Yhr, Yhl, Yhl, Yhl, Yhl, Yhl^Xp, Yhl^Yva, Xu, Yhl, Uh, Tb^Tf, Uh, Xuc, Xu, Xu, Xu, Xu, Xu, Xu, Xu, Xu, Xu, Xu, Xu, Xu
Xu, Xu, Xu, Xu, Xu, Xu, Xu, Xu, Xu, Xu, Xu, Xu, Xu, Xos, Xos, Xos, Xos, Yhl, Yhl, Yhl, Xu, Yhl, Xu, Uu, Uu, Yhl, Xos, Xos, Xos, Yhl^Yva, Xos, Xos, Xos, Yhl, Yhl, Yhl, Xos, Xos, Xos, Yhl^Eb, Yhl^Xp, Yhl, Yhl, Xu, Xu, Xu, Uu, Uu^Em, Qxu, Xu, Qxu, Xu, Xu, Xu, Xu, Xu, Xu, Xu, Xu, Xu, Xu, Xu
Xu, Xu, Xu, Xu, Xu, Xu, Xu, Xu, Xu, Xu, Xu, Xu, Xu, Xu, Xu, Xos, Xos, Xos, Xos, Xu, Xu, Xu, Xu, Xu, Xos, Xos, Xos^Exw, Xor, Xos, Xos, Xos^Xzm/, Xot, Yhl, Yhl, Xor, Xos, Xot, Xos^Xzm/, Yhl, Yhl, Xos, Yhl^Yva, Yhl, Xuc, Xu, Xu, Xu, Qxu, Qxu^Xo, Qxu^Xo, Qxu, Qxu, Qxu, Xu, Xu, Xu, Xu, Xu, Xu, Xu, Xu, Xu
Xu, Xu, Xu, Xu, Xu, Xu, Xu, Xu, Xu, Xu, Xu, Xu, Xu, Xu, Xu, Xu, Xu, Xos, Xos, Xos, Xu, Xu, Xos, Xos, Xos^Exw, Xos^Exw, Uh, Uh, Uu, Xos^Xzm/, Rb^Gvs, Rb, Rb, Yhl, Yhl, Xos^Exw, Yhl, Yhl, Rb^Gvs, Xor, Xor, Xos, Xos, Xu, Xu, Xu, Xu, Qxu^Xo, Qxu, Qxu, Qxu, Qxu, Xu, Xu, Xu, Xu, Xu, Xu, Xu, Xu, Xu, Xu
Xu, Xu, Xu, Xu, Xu, Xu, Xu, Xu, Xu, Xu, Xu, Xu, Xu, Xu, Xu, Xu, Xu, Xu, Xu, Xu, Xu, Xos, Xos, Xos^Exw, Uh, Uh, Uh, Uu^Vud, Rb^Gvs, Rb^Gvs, Rb^Gvs, Rb^Gvs, Rb^Gvs, Rb, Rb, Yhl, Rb^Gvs, Rb^Gvs, Rb^Gvs, Rb^Gvs, Rb^Gvs, Xos^Exw, Xos^Exw, Xos, Xos, Xu, Xu, Qxu, Qxu, Qxu, Xu, Xu, Xu, Xu, Xu, Xu, Xu, Xu, Xu, Xu, Xu, Xu
Xu, Xu, Xu, Xu, Xu, Xu, Xu, Xu, Xu, Xu, Xu, Xu, Xu, Xu, Xu, Xu, Xu, Xu, Xu, Xu, Xu, Xu, Xu, Xu, Xuc, Uu^Vu, Rb^Gvs, Wwg, Wwg, Rb^Gvs, Rb^Gvs, Rb^Gvs, Rb, Rb, Rb^Gvs, Rb, Rb, Rb^Gvs, Rb^Gvs, Rb^Gvs, Wwg, Wwg, Xuc, Xos, Xu, Xu, Xu, Xu, Xu, Xu, Xu, Xu, Xu, Xu, Xu, Xu, Xu, Xu, Xu, Xu, Xu, Xu
Xu, Xu, Xu, Xu, Xu, Xu, Xu, Xu, Xu, Xu, Xu, Xu, Xu, Xu, Xu, Xu, Xu, Xu, Xu, Xu, Xu, Xu, Xu, Xuc, Rb^Gvs, Rb^Gvs, Rb^Gvs, Rb^Gvs, Rb^Gvs, Wwg, Wwg^Bw/, Rb, Rb^Gvs, Rb^Gvs, Rb^Gvs, Rb^Gvs, Rb^Gvs, Rb, Wwg^Bw\, Wwg, Tb^Tf, Uu^Vud, Xuc, Xu, Xu, Xu, Xu, Xu, Xu, Xu, Xu, Xu, Xu, Xu, Xu, Xu, Xu, Xu, Xu, Xu, Xu, Xu
Xu, Xu, Xu, Xu, Xu, Xu, Xu, Xu, Xu, Xu, Xu, Xu, Xu, Xu, Xu, Xu, Xu, Xu, Xu, Xu, Xu, Xu, Xu, Xu, Xu, Rb^Gvs, Rb^Gvs, Rb^Gvs, Xu, Rb, Rb^Gvs, Wwg, Wwg, Rb^Gvs, Rb^Gvs, Rb^Gvs, Wwg, Wwg, Uh, Uu, Uu, Uh, Xuc, Xu, Xu, Xu, Xu, Xu, Xu, Xu, Xu, Xu, Xu, Xu, Xu, Xu, Xu, Xu, Xu, Xu, Xu, Xu
Xu, Xu, Xu, Xu, Xu, Xu, Xu, Xu, Xu, Xu, Xu, Xu, Xu, Xu, Xu, Xu, Xu, Xu, Xu, Xu, Xu, Xu, Xu, Xu, Xu, Xuc, Xuc, Xuc, Rb^Gvs, Rb^Gvs, Rb^Gvs, Rb^Gvs, Rb^Gvs, Wwg, Wwg, Wwg, Xuc, Xu, Xu, Xu, Xu, Xuc, Xu, Xu, Xu, Xu, Xu, Xu, Xu, Xu, Xu, Xu, Xu, Xu, Xu, Xu, Xu, Xu, Xu, Xu, Xu, Xu
Xu, Xu, Xu, Xu, Xu, Xu, Xu, Xu, Xu, Xu, Xu, Xu, Xu, Xu, Xu, Xu, Xu, Xu, Xu, Xu, Xu, Xu, Xu, Xu, Xu, Xu, Xu, Xuc, Xu, Rb^Gvs, Rb^Gvs, Rb^Gvs, Xuc, Xuc, Xuc, Wwg^Es, Wwg, Xu, Xu, Xu, Xu, Xu, Xu, Xu, Xu, Xu, Xu, Xu, Xu, Xu, Xu, Xu, Xu, Xu, Xu, Xu, Xu, Xu, Xu, Xu, Xu, Xu
Xu, Xu, Xu, Xu, Xu, Xu, Xu, Xu, Xu, Xu, Xu, Xu, Xu, Xu, Xu, Xu, Xu, Xu, Xu, Xu, Xu, Xu, Xu, Xu, Xu, Xu, Xu, Xu, Xu, Xu, Xu, Xu, Xu, Xu, Xu, Xu, Xu, Wwg, Xos, Xos, Xos, Xu, Xu, Xu, Xu, Xu, Xu, Xu, Xu, Xu, Xu, Xu, Xu, Xu, Xu, Xu, Xu, Xu, Xu, Xu, Xu, Xu
Xu, Xu, Xu, Xu, Xu, Xu, Xu, Xu, Xu, Xu, Xu, Xu, Xu, Xu, Xu, Xu, Xu, Xu, Xu, Xu, Xu, Xu, Xu, Xu, Xu, Xu, Xu, Xu, Xu, Xu, Xu, Xu, Xu, Xu, Xu, Xu, Xu, Xos, Xos, Xos, Xu, Xu, Xu, Xu, Xu, Xu, Xu, Xu, Xu, Xu, Xu, Xu, Xu, Xu, Xu, Xu, Xu, Xu, Xu, Xu, Xu, Xu
Xu, Xu, Xu, Xu, Xu, Xu, Xu, Xu, Xu, Xu, Xu, Xu, Xu, Xu, Xu, Xu, Xu, Xu, Xu, Xu, Xu, Xu, Xu, Xu, Xu, Xu, Xu, Xu, Xu, Xu, Xu, Xu, Xu, Xu, Xu, Xu, Xu, Xu, Xu, Xu, Xu, Xu, Xu, Xu, Xu, Xu, Xu, Xu, Xu, Xu, Xu, Xu, Xu, Xu, Xu, Xu, Xu, Xu, Xu, Xu, Xu, Xu
Xu, Xu, Xu, Xu, Xu, Xu, Xu, Xu, Xu, Xu, Xu, Xu, Xu, Xu, Xu, Xu, Xu, Xu, Xu, Xu, Xu, Xu, Xu, Xu, Xu, Xu, Xu, Xu, Xu, Xu, Xu, Xu, Xu, Xu, Xu, Xu, Xu, Xu, Xu, Xu, Xu, Xu, Xu, Xu, Xu, Xu, Xu, Xu, Xu, Xu, Xu, Xu, Xu, Xu, Xu, Xu, Xu, Xu, Xu, Xu, Xu, Xu
Xu, Xu, Xu, Xu, Xu, Xu, Xu, Xu, Xu, Xu, Xu, Xu, Xu, Xu, Xu, Xu, Xu, Xu, Xu, Xu, Xu, Xu, Xu, Xu, Xu, Xu, Xu, Xu, Xu, Xu, Xu, Xu, Xu, Xu, Xu, Xu, Xu, Xu, Xu, Xu, Xu, Xu, Xu, Xu, Xu, Xu, Xu, Xu, Xu, Xu, Xu, Xu, Xu, Xu, Xu, Xu, Xu, Xu, Xu, Xu, Xu, Xu
