border_size=1
usage=map

Yhr^Zok     , Uu^Zok      , Uu^Zok      , Urb^Zok     , Yhr^Zok     , Yhr^Zok     , Uu^Zok      , Uu^Zok      , Uu^Zok      , Yhr^Zok     , Urb^Zok     , Yhr^Zok     , Yhr^Zok     , Yhr^Zok     , Urb^Zok     , Urb^Zok     , Yhr^Zok     , Yhr^Zok     , Urb^Zok     , Yhr^Zok     , Urb^Zok     , Urb^Zok     , Urb^Zok     , Urb^Zok     , Urb^Zok     , Yhr^Zok     , Urb^Zok     , Urb^Zok     , Yhr^Zok     , Urb^Zok     , Yhr^Zok     , Urb^Zok     , Urb^Zok     , Urb^Zok     , Urb^Zok     , Urb^Zok     , Yhr^Zok     , Urb^Zok     , Yhr^Zok     , Urb^Zok     , Yhr^Zok     , Yhr^Zok     
Urb^Zok     , Yhr^Zok     , Urb^Zok     , Yhr^Zok     , Yhr^Zok     , Yhr^Zok     , Yhr^Zok     , Uu^Zok      , Urb^Zok     , Yhr^Zok     , Yhr^Zok     , Yhr^Zok     , Urb^Zok     , Yhr^Zok     , Yhl^Zok     , Urb^Zok     , Yhr^Zok     , Urb^Zok     , Urb^Zok     , Yhr^Zok     , Urb^Zok     , Yhr^Zok     , Yhr^Zok     , Urb^Zok     , Urb^Zok     , Yhr^Zok     , Urb^Zok     , Urb^Zok     , Yhr^Zok     , Urb^Zok     , Urb^Zok     , Yhl^Zok     , Urb^Zok     , Yhr^Zok     , Urb^Zok     , Urb^Zok     , Urb^Zok     , Urb^Zok     , Urb^Zok     , Urb^Zok     , Yhr^Zok     , Yhr^Zok     
Yhr^Zok     , Urb^Zok     , Urb^Zok     , Urb^Zok     , Urb^Zok     , Yhr^Zok     , Urb^Zok     , Urb^Zok     , Yhr^Zok     , Urb^Zok     , Urb^Zok     , Urb^Zok     , Yhr^Zok     , Urb^Zok     , Yhl^Zok     , Yhl^Zok     , Urb^Zok     , Yhr^Zok     , Urb^Zok     , Yhr^Zok     , Urb^Zok     , Yhr^Zok     , Yhr^Zok     , Yhr^Zok     , Yhr^Zok     , Yhr^Zok     , Urb^Zok     , Yhr^Zok     , Urb^Zok     , Yhr^Zok     , Urb^Zok     , Urb^Zok     , Urb^Zok     , Urb^Zok     , Yhr^Zok     , Yhr^Zok     , Yhr^Zok     , Urb^Zok     , Yhr^Zok     , Yhl^Zok     , Urb^Zok     , Urb^Zok     
Yhr^Zok     , Urb^Zok     , Yhr^Zok     , Urb^Zok     , Yhr^Zok     , Urb^Zok     , Urb^Zok     , Uu^Zok      , Uu^Zok      , Yhr^Zok     , Urb^Zok     , Urb^Zok     , Yhl^Zok     , Yhr^Zok     , Yhl^Zok     , Yhr^Zok     , Yhr^Zok     , Urb^Zok     , Yhr^Zok     , Yhr^Zok     , Yhr^Zok     , Yhr^Zok     , Yhl^Zok     , Yhr^Zok     , Urb^Zok     , Yhr^Zok     , Urb^Zok     , Urb^Zok     , Yhr^Zok     , Urb^Zok     , Urb^Zok     , Yhl^Zok     , Yhl^Zok     , Urb^Zok     , Urb^Zok     , Yhr^Zok     , Yhr^Zok     , Yhr^Zok     , Uu^Zok      , Urb^Zok     , Urb^Zok     , Yhr^Zok     
Yhr^Zok     , Urb^Zok     , Urb^Zok     , Yhr^Zok     , Urb^Zok     , Urb^Zok     , Urb^Zok     , Uu^Zok      , Yhl^Zok     , Yhl^Zok     , Urb^Zok     , Yhr^Zok     , Urb^Zok     , Yhl^Zok     , Yhl^Zok     , Urb^Zok     , Yhr^Zok     , Yhr^Zok     , Urb^Zok     , Urb^Zok     , Yhr^Zok     , Yhr^Zok     , Yhr^Zok     , Yhl^Zok     , Urb^Zok     , Yhr^Zok     , Urb^Zok     , Urb^Zok     , Yhr^Zok     , Uu^Zok      , Uu^Zok      , Yhr^Zok     , Yhr^Zok     , Yhr^Zok     , Urb^Zok     , Yhr^Zok     , Yhr^Zok     , Uu^Zok      , Uu^Zok      , Yhr^Zok     , Urb^Zok     , Yhr^Zok     
Yhr^Zok     , Yhl^Zok     , Yhl^Zok     , Yhr^Zok     , Urb^Zok     , Yhr^Zok     , Yhr^Zok     , Yhr^Zok     , Yhl^Zok     , Yhr^Zok     , Yhr^Zok     , Yhr^Zok     , Yhr^Zok     , Yhl^Zok     , Urb^Zok     , Yhr^Zok     , Yhr^Zok     , Urb^Zok     , Yhr^Zok     , Yhr^Zok     , Urb^Zok     , Yhr^Zok     , Urb^Zok     , Urb^Zok     , Urb^Zok     , Yhr^Zok     , Urb^Zok     , Urb^Zok     , Yhr^Zok     , Uu^Zok      , Yhl^Zok     , Yhr^Zok     , Urb^Zok     , Urb^Zok     , Yhr^Zok     , Urb^Zok     , Yhl^Zok     , Uu^Zok      , Yhl^Zok     , Yhr^Zok     , Urb^Zok     , Yhl^Zok     
Urb^Zok     , Yhl^Zok     , Yhr^Zok     , Yhr^Zok     , Yhr^Zok     , Urb^Zok     , Urb^Zok     , Yhr^Zok     , Yhl^Zok     , Yhr^Zok     , Urb^Zok     , Yhr^Zok     , Uu^Zok      , Yhl^Zok     , Urb^Zok     , Yhr^Zok     , Urb^Zok     , Yhl^Zok     , Yhr^Zok     , Urb^Zok     , Urb^Zok     , Yhr^Zok     , Yhr^Zok     , Yhr^Zok     , Urb^Zok     , Urb^Zok     , Yhr^Zok     , Urb^Zok     , Urb^Zok     , Yhr^Zok     , Urb^Zok     , Urb^Zok     , Urb^Zok     , Urb^Zok     , Yhr^Zok     , Urb^Zok     , Yhr^Zok     , Uu^Zok      , Urb^Zok     , Urb^Zok     , Yhr^Zok     , Urb^Zok     
Urb^Zok     , Yhl^Zok     , Urb^Zok     , Yhr^Zok     , Urb^Zok     , Yhr^Zok     , Yhr^Zok     , Urb^Zok     , Yhl^Zok     , Yhl^Zok     , Urb^Zok     , Uu^Zok      , Uu^Zok      , Uu^Zok      , Yhr^Xp      , Yhr^Zok     , Urb         , Yhr^Zok     , Urb         , Urb^Zok     , Yhr^Xp      , Urb^Zok     , Urb         , Urb^Zok     , Urb         , Yhl^Zok     , Yhr         , Yhr^Zok     , Urb         , Yhl^Zok     , Yhr^Zok     , Urb^Zok     , Urb^Zok     , Yhr^Zok     , Urb^Zok     , Yhl^Zok     , Yhr^Zok     , Yhr^Zok     , Yhl^Zok     , Urb^Zok     , Yhr^Zok     , Yhr^Zok     
Yhr^Zok     , Yhl^Zok     , Urb^Zok     , Yhr^Zok     , Yhr^Zok     , Urb^Zok     , Yhr^Zok     , Yhr^Zok     , Yhr^Zok     , Urb^Zok     , Urb^Zok     , Yhr^Zok     , Urb^Zok     , Urb^Zok     , Urb         , Urb         , Yhr         , Urb         , Urb         , Urb         , Yhr         , Urb         , Urb         , Urb         , Yhr         , Urb         , Yhr         , Yhr^Xp      , Urb         , Yhr^Xp      , Urb^Zok     , Yhr^Zok     , Yhr^Zok     , Urb^Zok     , Yhr^Zok     , Yhl^Zok     , Yhr^Zok     , Yhr^Zok     , Urb^Zok     , Yhr^Zok     , Urb^Zok     , Urb^Zok     
Yhr^Zok     , Urb^Zok     , Yhr^Zok     , Urb^Zok     , Uu^Zok      , Urb^Zok     , Uu^Zok      , Yhr^Zok     , Yhr^Zok     , Yhr^Zok     , Yhr^Zok     , Yhr^Zok     , Urb^Zok     , Urb^Zok     , Urb         , Yhr         , Urb         , Yhr^Xp      , Yhr         , Urb         , Urb         , Urb         , Yhr         , Urb         , Urb         , Urb         , Urb         , Yhr         , Urb         , Yhr         , Yhr^Zok     , Yhr^Zok     , Yhr^Zok     , Yhl^Zok     , Urb^Zok     , Urb^Zok     , Urb^Zok     , Urb^Zok     , Yhr^Zok     , Urb^Zok     , Urb^Zok     , Urb^Zok     
Urb^Zok     , Urb^Zok     , Urb^Zok     , Yhr^Zok     , Uu^Zok      , Uu^Zok      , Yhr^Zok     , Yhr^Zok     , Yhr^Zok     , Yhl^Zok     , Uu^Zok      , Urb^Zok     , Yhr^Zok     , Urb^Zok     , Yhr         , Urb         , Yhr         , Urb         , Urb         , Yhl         , Urb         , Yhr^Xp      , Urb         , Yhr         , Yhr         , Urb         , Urb         , Urb         , Yhr         , Yhr         , Urb^Zok     , Urb^Zok     , Yhr^Zok     , Urb^Zok     , Urb^Zok     , Urb^Zok     , Yhr^Zok     , Yhr^Zok     , Yhl^Zok     , Urb^Zok     , Yhl^Zok     , Yhr^Zok     
Urb^Zok     , Urb^Zok     , Urb^Zok     , Yhr^Zok     , Urb^Zok     , Yhr^Zok     , Yhr^Zok     , Yhr^Zok     , Yhr^Zok     , Uu^Zok      , Uu^Zok      , Urb^Zok     , Yhr^Zok     , Yhr^Zok     , Urb         , Urb         , Yhr^Xp      , Urb         , Urb         , Yhr         , Yhr         , Yhr         , Yhr         , Urb         , Yhr         , Yhr^Xp      , Yhr         , Urb         , Urb         , Yhr         , Urb^Zok     , Yhr^Zok     , Urb^Zok     , Yhl^Zok     , Yhl^Zok     , Urb^Zok     , Yhr^Zok     , Yhr^Zok     , Urb^Zok     , Yhl^Zok     , Yhr^Zok     , Yhr^Zok     
Yhr^Zok     , Urb^Zok     , Yhr^Zok     , Yhl^Zok     , Yhl^Zok     , Urb^Zok     , Yhr^Zok     , Urb^Zok     , Yhr^Zok     , Urb^Zok     , Urb^Zok     , Yhr^Zok     , Yhr^Zok     , Urb^Zok     , Urb         , Yhr         , Yhl         , Yhr         , Urb         , Yhr         , Urb         , 1 Yhr       , Urb         , Urb         , Urb         , Urb         , Yhl         , Urb         , Yhr         , Urb         , Yhr^Zok     , Yhr^Zok     , Urb^Zok     , Yhl^Zok     , Yhr^Zok     , Urb^Zok     , Urb^Zok     , Urb^Zok     , Urb^Zok     , Yhr^Zok     , Urb^Zok     , Yhr^Zok     
Urb^Zok     , Yhr^Zok     , Urb^Zok     , Yhr^Zok     , Urb^Zok     , Urb^Zok     , Yhl^Zok     , Yhl^Zok     , Yhr^Zok     , Urb^Zok     , Urb^Zok     , Yhr^Zok     , Yhr^Zok     , Yhl^Zok     , Urb         , Urb         , Urb         , Urb         , Yhr         , Yhr         , Urb         , Urb         , Yhr         , Yhr^Xp      , Urb         , Yhr         , Yhr         , Yhr         , Urb         , Yhr         , Urb^Zok     , Urb^Zok     , Urb^Zok     , Yhr^Zok     , Uu^Zok      , Urb^Zok     , Yhr^Zok     , Yhr^Zok     , Yhl^Zok     , Urb^Zok     , Urb^Zok     , Urb^Zok     
Urb^Zok     , Urb^Zok     , Urb^Zok     , Yhr^Zok     , Yhr^Zok     , Urb^Zok     , Yhr^Zok     , Yhr^Zok     , Yhr^Zok     , Urb^Zok     , Uu^Zok      , Urb^Zok     , Yhr^Zok     , Uu^Zok      , Uu          , Uu          , Urb         , Yhl         , Yhr         , Urb         , Yhr         , Yhl         , Yhr         , Yhr         , Yhr         , Urb         , Urb         , Urb         , Yhr         , Yhl         , Urb^Zok     , Urb^Zok     , Yhr^Zok     , Yhr^Zok     , Yhr^Zok     , Uu^Zok      , Yhr^Zok     , Urb^Zok     , Urb^Zok     , Urb^Zok     , Yhr^Zok     , Urb^Zok     
Urb^Zok     , Urb^Zok     , Urb^Zok     , Urb^Zok     , Yhr^Zok     , Urb^Zok     , Yhr^Zok     , Yhr^Zok     , Uu^Zok      , Uu^Zok      , Uu^Zok      , Uu^Zok      , Uu^Zok      , Uu^Zok      , Uu          , Yhr         , Yhr         , Yhr         , Urb         , Urb         , Urb         , Urb         , Urb         , Yhl         , Urb         , Yhl         , Urb         , Urb         , Urb         , Yhr         , Yhr^Zok     , Urb^Zok     , Urb^Zok     , Urb^Zok     , Urb^Zok     , Uu^Zok      , Uu^Zok      , Yhl^Zok     , Yhr^Zok     , Yhl^Zok     , Urb^Zok     , Urb^Zok     
Yhr^Zok     , Urb^Zok     , Urb^Zok     , Yhr^Zok     , Yhr^Zok     , Urb^Zok     , Urb^Zok     , Yhr^Zok     , Uu^Zok      , Uu^Zok      , Urb^Zok     , Uu^Zok      , Uu^Zok      , Yhr^Zok     , Urb         , Urb         , Yhr^Xp      , Urb         , Yhr         , Yhr         , Urb         , Urb         , Urb         , Yhr         , Urb         , Yhr         , Yhr         , Urb         , Yhr         , Yhr         , Yhr^Zok     , Yhr^Zok     , Yhr^Zok     , Urb^Zok     , Urb^Zok     , Uu^Zok      , Uu^Zok      , Uu^Zok      , Yhr^Zok     , Yhr^Zok     , Urb^Zok     , Urb^Zok     
Urb^Zok     , Yhr^Zok     , Urb^Zok     , Urb^Zok     , Yhl^Zok     , Yhr^Zok     , Yhr^Zok     , Urb^Zok     , Urb^Zok     , Urb^Zok     , Urb^Zok     , Yhr^Zok     , Yhr^Zok     , Urb^Zok     , Urb         , Urb         , Urb         , Urb         , Urb         , Urb         , Yhr         , Yhr         , Urb         , Yhr         , Yhr         , Uu          , Uu          , Yhr         , Yhr         , Yhr^Xp      , Uu^Zok      , Yhr^Zok     , Urb^Zok     , Yhl^Zok     , Urb^Zok     , Uu^Zok      , Uu^Zok      , Urb^Zok     , Urb^Zok     , Yhr^Zok     , Urb^Zok     , Urb^Zok     
Urb^Zok     , Urb^Zok     , Urb^Zok     , Yhr^Zok     , Uu^Zok      , Uu^Zok      , Yhr^Zok     , Urb^Zok     , Urb^Zok     , Yhr^Zok     , Urb^Zok     , Urb^Zok     , Urb^Zok     , Yhl^Zok     , Yhr         , Yhl         , Urb         , Urb         , Urb         , Urb         , Urb         , Urb         , Yhl         , Yhr         , Urb         , Yhr         , Uu          , Yhr         , Urb         , Uu          , Uu^Zok      , Uu^Zok      , Uu^Zok      , Yhr^Zok     , Urb^Zok     , Yhr^Zok     , Yhr^Zok     , Yhl^Zok     , Urb^Zok     , Yhr^Zok     , Urb^Zok     , Urb^Zok     
Urb^Zok     , Urb^Zok     , Yhr^Zok     , Uu^Zok      , Urb^Zok     , Uu^Zok      , Yhr^Zok     , Urb^Zok     , Yhr^Zok     , Yhr^Zok     , Urb^Zok     , Urb^Zok     , Urb^Zok     , Yhr^Zok     , Yhr^Xp      , Yhr         , Yhr         , Yhr         , Urb         , Urb         , Urb         , Yhr         , Yhr         , Yhr         , Urb         , Yhr         , Yhr         , Uu          , Urb         , Uu          , Yhr^Zok     , Urb^Zok     , Urb^Zok     , Urb^Zok     , Yhr^Zok     , Urb^Zok     , Urb^Zok     , Yhr^Zok     , Yhr^Zok     , Yhr^Zok     , Urb^Zok     , Urb^Zok     
Yhr^Zok     , Yhr^Zok     , Urb^Zok     , Urb^Zok     , Yhr^Zok     , Yhl^Zok     , Yhr^Zok     , Yhr^Zok     , Urb^Zok     , Urb^Zok     , Urb^Zok     , Urb^Zok     , Yhr^Zok     , Yhr^Zok     , Uu          , Urb         , Urb         , Urb         , Yhr         , Yhl         , Yhr         , Urb         , Urb         , Urb         , Yhl         , Yhr         , Yhr^Xp      , Urb         , Yhl         , Yhr         , Urb^Zok     , Urb^Zok     , Urb^Zok     , Urb^Zok     , Yhr^Zok     , Yhr^Zok     , Urb^Zok     , Yhr^Zok     , Yhr^Zok     , Yhr^Zok     , Yhr^Zok     , Yhl^Zok     
Yhr^Zok     , Urb^Zok     , Yhr^Zok     , Urb^Zok     , Urb^Zok     , Yhr^Zok     , Urb^Zok     , Urb^Zok     , Yhr^Zok     , Urb^Zok     , Yhr^Zok     , Urb^Zok     , Urb^Zok     , Uu^Zok      , Uu          , Uu          , Urb         , Urb         , Urb         , Yhr^Xp      , Yhr^Xp      , Urb         , Urb         , Urb         , Urb         , Yhr         , Yhr         , Yhr         , Urb         , Yhr         , Urb^Zok     , Urb^Zok     , Yhr^Zok     , Yhr^Zok     , Uu^Zok      , Urb^Zok     , Urb^Zok     , Yhr^Zok     , Yhr^Zok     , Urb^Zok     , Urb^Zok     , Yhr^Zok     
Yhr^Zok     , Yhr^Zok     , Urb^Zok     , Urb^Zok     , Yhr^Zok     , Yhr^Zok     , Urb^Zok     , Urb^Zok     , Urb^Zok     , Yhr^Zok     , Yhr^Zok     , Urb^Zok     , Urb^Zok     , Urb^Zok     , Urb         , Yhr         , Yhr         , Yhl         , Yhr         , Urb         , Yhr^Xp      , 3 Yhr       , Urb         , Yhl         , Yhr         , Yhr         , Urb         , Urb         , Urb         , Yhr         , Urb^Zok     , Urb^Zok     , Uu^Zok      , Uu^Zok      , Urb^Zok     , Yhl^Zok     , Yhr^Zok     , Urb^Zok     , Urb^Zok     , Urb^Zok     , Yhr^Zok     , Yhr^Zok     
Urb^Zok     , Urb^Zok     , Urb^Zok     , Urb^Zok     , Urb^Zok     , Urb^Zok     , Urb^Zok     , Yhr^Zok     , Yhr^Zok     , Yhr^Zok     , Urb^Zok     , Urb^Zok     , Yhr^Zok     , Urb^Zok     , Urb         , Urb         , Urb         , Yhr         , Urb         , Urb         , Urb         , Urb         , Yhr         , Yhl         , Urb         , Yhr         , Yhr         , Urb         , Urb         , Yhr         , Yhr^Zok     , Yhr^Zok     , Urb^Zok     , Uu^Zok      , Yhr^Zok     , Yhr^Zok     , Yhr^Zok     , Yhr^Zok     , Yhr^Zok     , Urb^Zok     , Urb^Zok     , Urb^Zok     
Yhr^Zok     , Yhr^Zok     , Urb^Zok     , Yhl^Zok     , Yhr^Zok     , Urb^Zok     , Urb^Zok     , Yhr^Zok     , Urb^Zok     , Yhr^Zok     , Urb^Zok     , Urb^Zok     , Yhl^Zok     , Yhl^Zok     , Urb         , Urb         , Yhr^Xp      , Yhl         , Urb         , Urb         , Yhr         , Urb         , Urb         , Yhl         , Yhl         , Urb         , Urb         , Urb         , Yhl         , Yhr         , Urb^Zok     , Urb^Zok     , Urb^Zok     , Urb^Zok     , Urb^Zok     , Urb^Zok     , Urb^Zok     , Yhr^Zok     , Urb^Zok     , Urb^Zok     , Urb^Zok     , Urb^Zok     
Yhr^Zok     , Urb^Zok     , Urb^Zok     , Yhr^Zok     , Yhr^Zok     , Urb^Zok     , Yhr^Zok     , Yhr^Zok     , Urb^Zok     , Urb^Zok     , Yhr^Zok     , Yhr^Zok     , Yhr^Zok     , Yhl^Zok     , Urb^Zok     , Yhr         , Yhr^Zok     , Urb         , Yhr^Zok     , Yhr         , Yhr^Zok     , Yhr         , Yhr^Zok     , Urb         , Yhr^Zok     , Yhr         , Yhr^Zok     , Yhr         , Urb^Zok     , Yhr^Zok     , Yhr^Zok     , Urb^Zok     , Yhr^Zok     , Urb^Zok     , Yhr^Zok     , Urb^Zok     , Urb^Zok     , Urb^Zok     , Yhl^Zok     , Yhr^Zok     , Urb^Zok     , Urb^Zok     
Yhr^Zok     , Yhr^Zok     , Urb^Zok     , Urb^Zok     , Urb^Zok     , Urb^Zok     , Yhr^Zok     , Urb^Zok     , Yhr^Zok     , Yhr^Zok     , Yhr^Zok     , Yhr^Zok     , Yhl^Zok     , Urb^Zok     , Urb^Zok     , Yhl^Zok     , Urb^Zok     , Urb^Zok     , Urb^Zok     , Urb^Zok     , Yhl^Zok     , Urb^Zok     , Urb^Zok     , Urb^Zok     , Urb^Zok     , Yhr^Zok     , Yhr^Zok     , Urb^Zok     , Urb^Zok     , Yhr^Zok     , Yhr^Zok     , Urb^Zok     , Urb^Zok     , Uu^Zok      , Uu^Zok      , Urb^Zok     , Yhr^Zok     , Yhr^Zok     , Yhr^Zok     , Urb^Zok     , Urb^Zok     , Urb^Zok     
Yhr^Zok     , Yhr^Zok     , Yhr^Zok     , Yhl^Zok     , Uu^Zok      , Uu^Zok      , Yhr^Zok     , Urb^Zok     , Yhr^Zok     , Yhl^Zok     , Yhr^Zok     , Yhr^Zok     , Uu^Zok      , Uu^Zok      , Urb^Zok     , Urb^Zok     , Yhr^Zok     , Yhl^Zok     , Urb^Zok     , Urb^Zok     , Yhr^Zok     , Urb^Zok     , Urb^Zok     , Yhr^Zok     , Yhr^Zok     , Yhr^Zok     , Urb^Zok     , Yhr^Zok     , Urb^Zok     , Urb^Zok     , Yhl^Zok     , Yhr^Zok     , Uu^Zok      , Uu^Zok      , Uu^Zok      , Urb^Zok     , Yhr^Zok     , Yhr^Zok     , Urb^Zok     , Yhr^Zok     , Yhr^Zok     , Urb^Zok     
Urb^Zok     , Urb^Zok     , Urb^Zok     , Yhr^Zok     , Yhr^Zok     , Uu^Zok      , Yhr^Zok     , Yhr^Zok     , Yhr^Zok     , Urb^Zok     , Urb^Zok     , Urb^Zok     , Uu^Zok      , Uu^Zok      , Urb^Zok     , Yhr^Zok     , Yhr^Zok     , Yhr^Zok     , Yhr^Zok     , Yhr^Zok     , Yhl^Zok     , Yhr^Zok     , Yhr^Zok     , Urb^Zok     , Yhr^Zok     , Yhr^Zok     , Urb^Zok     , Urb^Zok     , Urb^Zok     , Yhr^Zok     , Urb^Zok     , Yhr^Zok     , Yhr^Zok     , Uu^Zok      , Uu^Zok      , Yhr^Zok     , Yhr^Zok     , Yhr^Zok     , Urb^Zok     , Yhr^Zok     , Yhl^Zok     , Urb^Zok     
Urb^Zok     , Urb^Zok     , Urb^Zok     , Urb^Zok     , Urb^Zok     , Yhr^Zok     , Yhr^Zok     , Urb^Zok     , Urb^Zok     , Urb^Zok     , Urb^Zok     , Yhr^Zok     , Uu^Zok      , Urb^Zok     , Yhr^Zok     , Yhl^Zok     , Urb^Zok     , Yhr^Zok     , Yhr^Zok     , Urb^Zok     , Urb^Zok     , Uu^Zok      , Uu^Zok      , Yhl^Zok     , Yhr^Zok     , Urb^Zok     , Yhl^Zok     , Urb^Zok     , Urb^Zok     , Yhr^Zok     , Urb^Zok     , Urb^Zok     , Urb^Zok     , Yhr^Zok     , Uu^Zok      , Yhr^Zok     , Yhr^Zok     , Urb^Zok     , Yhr^Zok     , Urb^Zok     , Urb^Zok     , Urb^Zok     
Urb^Zok     , Yhr^Zok     , Urb^Zok     , Uu^Zok      , Uu^Zok      , Yhr^Zok     , Yhr^Zok     , Urb^Zok     , Yhr^Zok     , Urb^Zok     , Urb^Zok     , Yhr^Zok     , Urb^Zok     , Urb^Zok     , Yhl^Zok     , Yhl^Zok     , Yhr^Zok     , Yhl^Zok     , Urb^Zok     , Urb^Zok     , Uu^Zok      , Uu^Zok      , Yhr^Zok     , Yhr^Zok     , Urb^Zok     , Urb^Zok     , Urb^Zok     , Urb^Zok     , Urb^Zok     , Urb^Zok     , Urb^Zok     , Urb^Zok     , Urb^Zok     , Yhr^Zok     , Uu^Zok      , Yhr^Zok     , Urb^Zok     , Yhr^Zok     , Urb^Zok     , Urb^Zok     , Yhr^Zok     , Urb^Zok     
Yhr^Zok     , Yhr^Zok     , Urb^Zok     , Yhr^Zok     , Uu^Zok      , Uu^Zok      , Yhr^Zok     , Yhr^Zok     , Yhr^Zok     , Urb^Zok     , Urb^Zok     , Yhr^Zok     , Urb^Zok     , Urb^Zok     , Urb^Zok     , Yhl^Zok     , Yhr^Zok     , Yhr^Zok     , Yhr^Zok     , Urb^Zok     , Urb^Zok     , Yhr^Zok     , Yhr^Zok     , Urb^Zok     , Yhr^Zok     , Yhr^Zok     , Yhr^Zok     , Urb^Zok     , Urb^Zok     , Yhr^Zok     , Urb^Zok     , Urb^Zok     , Yhr^Zok     , Urb^Zok     , Yhr^Zok     , Yhr^Zok     , Urb^Zok     , Yhr^Zok     , Urb^Zok     , Yhl^Zok     , Yhr^Zok     , Yhr^Zok     
Yhr^Zok     , Urb^Zok     , Yhr^Zok     , Yhr^Zok     , Yhr^Zok     , Uu^Zok      , Yhr^Zok     , Urb^Zok     , Urb^Zok     , Yhr^Zok     , Yhr^Zok     , Yhr^Zok     , Urb^Zok     , Urb^Zok     , Yhr^Zok     , Urb^Zok     , Urb^Zok     , Urb^Zok     , Yhr^Zok     , Urb^Zok     , Urb^Zok     , Yhr^Zok     , Urb^Zok     , Urb^Zok     , Urb^Zok     , Urb^Zok     , Urb^Zok     , Urb^Zok     , Urb^Zok     , Yhr^Zok     , Yhl^Zok     , Yhr^Zok     , Urb^Zok     , Yhr^Zok     , Urb^Zok     , Urb^Zok     , Yhr^Zok     , Yhr^Zok     , Urb^Zok     , Urb^Zok     , Urb^Zok     , Urb^Zok     
Urb^Zok     , Urb^Zok     , Urb^Zok     , Urb^Zok     , Yhr^Zok     , Urb^Zok     , Yhr^Zok     , Urb^Zok     , Urb^Zok     , Urb^Zok     , Yhr^Zok     , Urb^Zok     , Yhr^Zok     , Yhr^Zok     , Urb^Zok     , Urb^Zok     , Yhr^Zok     , Yhr^Zok     , Urb^Zok     , Urb^Zok     , Urb^Zok     , Urb^Zok     , Urb^Zok     , Yhr^Zok     , Yhr^Zok     , Urb^Zok     , Yhr^Zok     , Urb^Zok     , Yhl^Zok     , Yhr^Zok     , Urb^Zok     , Urb^Zok     , Urb^Zok     , Yhr^Zok     , Urb^Zok     , Urb^Zok     , Yhr^Zok     , Uu^Zok      , Uu^Zok      , Urb^Zok     , Yhr^Zok     , Urb^Zok     
Urb^Zok     , Urb^Zok     , Yhr^Zok     , Uu^Zok      , Urb^Zok     , Urb^Zok     , Urb^Zok     , Urb^Zok     , Yhr^Zok     , Yhr^Zok     , Yhr^Zok     , Yhr^Zok     , Yhr^Zok     , Uu^Zok      , Uu^Zok      , Urb^Zok     , Yhr^Zok     , Yhr^Zok     , Yhr^Zok     , Urb^Zok     , Yhr^Zok     , Yhr^Zok     , Urb^Zok     , Urb^Zok     , Urb^Zok     , Yhr^Zok     , Urb^Zok     , Yhr^Zok     , Yhr^Zok     , Yhr^Zok     , Yhr^Zok     , Yhr^Zok     , Yhr^Zok     , Yhr^Zok     , Yhr^Zok     , Urb^Zok     , Urb^Zok     , Yhr^Zok     , Uu^Zok      , Yhr^Zok     , Yhr^Zok     , Urb^Zok     
Yhr^Zok     , Yhl^Zok     , Uu^Zok      , Uu^Zok      , Uu^Zok      , Yhr^Zok     , Urb^Zok     , Urb^Zok     , Urb^Zok     , Yhl^Zok     , Urb^Zok     , Yhr^Zok     , Yhr^Zok     , Uu^Zok      , Uu^Zok      , Yhr^Zok     , Uu^Zok      , Urb^Zok     , Yhr^Zok     , Yhr^Zok     , Yhr^Zok     , Yhr^Zok     , Yhr^Zok     , Yhr^Zok     , Yhr^Zok     , Urb^Zok     , Yhr^Zok     , Yhr^Zok     , Yhr^Zok     , Yhl^Zok     , Yhr^Zok     , Uu^Zok      , Yhr^Zok     , Urb^Zok     , Urb^Zok     , Urb^Zok     , Urb^Zok     , Urb^Zok     , Uu^Zok      , Uu^Zok      , Yhr^Zok     , Urb^Zok     
