border_size=1
usage=map

Yhl, Urb, Urb, Urb, Urb, Urb, Urb, Urb, Urb, Urb, Yhl, Urb, Urb, Urb, Urb, Urb, Urb, Urb, Yhl, Urb, Urb, Urb, Urb, Urb, Urb, Yhl, Yhl, Urb, Urb, Yhl, Yhl, Urb, Urb, Urb, Yhl, Urb, Urb, Urb, Urb, Urb, Yhl, Urb, Urb, Urb
Urb, Yhl, Yhl, Urb, Urb, Urb, Urb, Urb, Urb, Yhl, Yhl, Urb, Urb, Urb, Yhl, Urb, Yhl, Yhl, Yhl, Yhl, Urb, Urb, Urb, Urb, Urb, Yhl, Urb, Yhl, Yhl, Yhl, Urb, Urb, Urb, Urb, Urb, Yhl, Yhl, Urb, Urb, Yhl, Urb, Urb, Urb, Urb
Urb, Urb, Urb, Urb, Urb, Urb, Yhl, Urb, Urb, Urb, Yhl, Yhl, Urb, Urb, Yhl, Yhl, Urb, Yhl, Urb, Urb, Urb, Urb, Urb, Urb, Urb, Urb, Yhl, Yhl, Urb, Yhl, Urb, Urb, Urb, Urb, Urb, Urb, Urb, Yhl, Yhl, Yhl, Urb, Urb, Urb, Urb
Urb, Urb, Urb, Urb, Yhl, Yhl, Urb, Urb, Urb, Urb, Urb, Urb, Urb, Urb, Yhl, Yhl, Urb, Urb, Yhl, Yhl, Yhl, Urb, Urb, Urb, Urb, Urb, Yhl, Urb, Urb, Yhl, Yhl, Urb, Urb, Urb, Yhl, Urb, Yhl, Yhl, Yhl, Urb, Urb, Urb, Urb, Urb
Yhl, Yhl, Urb, Urb, Yhl, Yhl, Yhl, Urb, Yhl, Yhl, Urb, Urb, Urb, Urb, Urb, Yhl, Urb, Urb, Urb, Urb, Urb, Yhl, Yhl, Urb, Urb, Yhl, Urb, Urb, Urb, Yhl, Yhl, Urb, Urb, Urb, Urb, Yhl, Urb, Urb, Urb, Urb, Urb, Urb, Yhl, Yhl
Urb, Yhl, Urb, Yhl, Urb, Urb, Urb, Yhl, Urb, Urb, Urb, Urb, Urb, Urb, Urb, Yhl, Urb, Urb, Urb, Urb, Urb, Urb, Urb, Yhl, Yhl, Urb, Urb, Urb, Yhl, Yhl, Urb, Yhl, Yhl, Urb, Yhl, Yhl, Urb, Urb, Urb, Urb, Urb, Urb, Yhl, Urb
Urb, Yhl, Urb, Urb, Urb, Urb, Yhl, Yhl, Urb, Urb, Urb, Yhl, Yhl, Urb, Urb, Yhl, Urb, Urb, Urb, Urb, Urb, Urb, Urb, Urb, Urb, Urb, Urb, Urb, Yhl, Urb, Urb, Yhl, Yhl, Yhl, Yhl, Urb, Yhl, Urb, Urb, Urb, Urb, Yhl, Urb, Urb
Urb, Yhl, Yhl, Urb, Urb, Urb, Urb, Urb, Urb, Urb, Urb, Yhl, Yhl, Urb, Urb, Urb, Urb, Urb, Urb, Urb, Urb, Urb, Urb, Urb, Yhl, Urb, Urb, Urb, Urb, Urb, Urb, Yhl, Urb, Urb, Urb, Urb, Yhl, Urb, Urb, Urb, Urb, Urb, Yhl, Yhl
Urb, Urb, Urb, Urb, Urb, Urb, Urb, Urb, Urb, Urb, Urb, Urb, Urb, Yhl, Yhl, Urb, Urb, Urb, Urb, Urb, Yhl, Yhl, Urb, Urb, Yhl, Urb, Urb, Urb, Urb, Urb, Urb, Urb, Yhl, Urb, Urb, Urb, Urb, Urb, Yhl, Yhl, Urb, Urb, Urb, Urb
Urb, Urb, Urb, Yhl, Yhl, Urb, Urb, Urb, Yhl, Yhl, Urb, Urb, Urb, Urb, Urb, Urb, Uu, Urb, Urb, Yhl, Urb, Urb, Yhl, Yhl, Urb, Urb, Yhl, Urb, Uu, Yhl, Yhl, Urb, Urb, Yhl, Yhl, Urb, Urb, Urb, Urb, Yhl, Yhl, Urb, Urb, Urb
Yhl, Urb, Urb, Urb, Urb, Yhl, Urb, Urb, Urb, Urb, Urb, Urb, Urb, Yhl, Urb, Urb, Uu, Uu, Uu, Urb, Urb, Urb, Urb, Urb, Urb, Yhl, Uu, Uu, Uu, Uu, Urb, Yhl, Yhl, Urb, Urb, Yhl, Urb, Urb, Urb, Urb, Yhl, Urb, Urb, Urb
Yhl, Urb, Urb, Urb, Yhl, Urb, Urb, Urb, Yhl, Yhl, Urb, Urb, Urb, Yhl, Yhl, Urb, Uh, Uu, Yhl^Es, Uu, Urb, Urb^Es, Yhl, Urb^Es, Urb, Yhl, Yhl, Uh, Urb, Urb, Urb, Urb, Yhl, Urb, Yhl, Urb, Urb, Urb, Urb, Urb, Urb, Urb, Yhl, Yhl
Yhl, Urb, Urb, Yhl, Urb, Urb, Urb, Urb, Urb, Yhl, Yhl, Urb, Urb, Urb, Yhl, Yhl, Yhl, Yhl, Yhl, Yhl, Yhl, Yhl^Es, Urb, Urb^Edt, Urb, Urb, Urb^Es, Urb, Urb, Yhl, Urb, Urb, Urb, Yhl, Yhl, Yhl, Urb, Urb, Urb, Urb, Urb, Yhl, Yhl, Urb
Urb, Urb, Yhl, Yhl, Urb, Urb, Yhl, Yhl, Urb, Urb, Urb, Yhl, Urb, Urb, Uu, Uu, Yhl^Es, Yhl, Urb, Urb, Urb, Urb, Urb, Urb^Edt, Urb, 1 Urb, Urb, Yhl^Es, Urb, Yhl, Uu, Urb, Urb, Urb, Yhl, Uu, Yhl, Urb, Urb, Urb, Urb, Yhl, Urb, Urb
Urb, Yhl, Urb, Urb, Urb, Urb, Yhl, Urb, Yhl, Yhl, Urb, Yhl, Yhl, Yhl, Uu, Yhl^Es, Urb, Urb, Urb, Urb^Es, Urb, Urb, Urb, Urb, Urb, Urb, Yhl, Yhl, Urb^Edt, Urb, Uh, Uu, Urb, Urb, Uu, Uu, Uu, Yhl, Yhl, Yhl, Urb, Urb, Urb, Urb
Urb, Urb, Urb, Urb, Yhl, Yhl, Yhl, Yhl, Urb, Urb, Yhl, Yhl, Yhl, Uu, Uu^Edt, Urb, Urb, Urb, Urb^Edb, Urb, Urb^Edb, Urb, Urb, Urb, Urb, Urb, Urb, Urb^Edt, Yhl, Uu, Urb, Urb, Yhl, Urb, Uu, Uu, Yhl, Yhl, Yhl, Yhl, Urb, Urb, Urb, Yhl
Urb, Urb, Urb, Urb, Urb, Urb, Urb, Urb, Urb, Urb, Yhl, Uu, Uu, Uu, Uh, Urb^Es, Urb, Urb, Urb^Edb, 2 Urb, Urb^Edt, Urb, Yhl, Urb, Urb^Es, Urb, Yhl^Edt, Urb^Edt, Urb, Urb, Urb, Yhl, Urb, Yhl, Uh, Uh, Urb, Urb, Urb, Urb, Yhl, Urb, Urb, Urb
Yhl, Urb, Urb, Yhl, Yhl, Urb, Urb, Urb, Urb, Urb, Urb, Uu, Uu, Uh, Urb, Urb, Urb^Edt, Urb, Urb, Urb^Edb, Urb^Edb, Urb, Yhl, Yhl, Yhl, Urb, Urb, Yhl, Yhl, Urb, Urb, Urb, Yhl, Uu, Urb, Urb, Urb, Urb, Yhl, Yhl, Urb, Urb, Urb, Urb
Yhl, Urb, Urb, Yhl, Yhl, Urb, Urb, Urb, Urb, Yhl, Yhl, Urb, Uu, Uu, Yhl, Urb^Edt, Urb^Edt, Urb^Es, Urb^Edb, Urb^Edb, Yhl, Urb, Urb, Yhl, Urb, Urb^Edt, Yhl, Urb, Uu, Urb, Yhl, Urb, Uu, Uu, Urb, Urb, Yhl, Urb, Urb, Urb, Yhl, Urb, Urb, Urb
Yhl, Yhl, Yhl, Urb, Yhl, Yhl, Urb, Urb, Yhl, Yhl, Yhl, Urb, Urb, Uu, Urb, Yhl, Uu, Urb^Edt, Urb, Urb, Yhl, Yhl^Es, Urb, Urb, Urb^Edt, Urb^Edt, Urb, Uu, Uh, Urb, Yhl, Yhl, Uu, Uu, Urb, Yhl, Urb, Urb, Urb, Urb, Urb, Yhl, Yhl, Urb
Urb, Urb, Yhl, Yhl, Yhl, Urb, Urb, Urb, Urb, Yhl, Yhl, Urb, Urb, Urb, Urb, Urb, Yhl, Uh, Uu, Yhl, Yhl, Urb, Urb, Urb, Urb^Edt, Urb, Uu, Uu, Uu, Urb, Yhl, Yhl, Yhl, Yhl, Yhl, Yhl, Urb, Urb, Urb, Yhl, Yhl, Urb, Urb, Yhl
Urb, Urb, Yhl, Yhl, Urb, Yhl, Yhl, Urb, Urb, Yhl, Yhl, Yhl, Uu, Urb, Uu, Urb, Urb, Yhl, Yhl, Yhl, Yhl, Yhl, Yhl, Urb, Urb, Urb, Uh, Yhl, Yhl, Yhl, Yhl, Urb, Urb, Yhl, Yhl, Yhl, Yhl, Urb, Urb, Urb, Yhl, Yhl, Urb, Urb
Urb, Yhl, Urb, Urb, Urb, Urb, Yhl, Urb, Urb, Urb, Urb, Urb, Urb, Urb, Uu, Uu, Urb, Urb, Urb, Urb, Urb, Yhl, Urb, Urb, Urb, Urb, Urb, Yhl, Urb, Yhl, Urb, Urb, Urb, Urb, Yhl, Yhl, Yhl, Urb, Urb, Yhl, Urb, Urb, Urb, Urb
Yhl, Yhl, Urb, Urb, Urb, Urb, Urb, Yhl, Yhl, Urb, Urb, Urb, Urb, Urb, Uu, Uu, Urb, Urb, Urb, Urb, Urb, Urb, Uu, Uu, Urb, Urb, Yhl, Urb, Urb, Urb, Urb, Urb, Urb, Yhl, Urb, Urb, Urb, Yhl, Yhl, Urb, Urb, Urb, Urb, Urb
Urb, Urb, Urb, Yhl, Yhl, Urb, Urb, Urb, Urb, Urb, Urb, Urb, Yhl, Urb, Urb, Uu, Urb, Urb, Yhl, Urb, Urb, Urb, Yhl, Urb, Urb, Urb, Urb, Yhl, Urb, Urb, Urb, Urb, Yhl, Yhl, Urb, Urb, Urb, Urb, Urb, Urb, Urb, Yhl, Yhl, Urb
Urb, Urb, Urb, Yhl, Yhl, Yhl, Yhl, Yhl, Urb, Urb, Urb, Urb, Yhl, Urb, Urb, Urb, Urb, Urb, Yhl, Urb, Yhl, Yhl, Yhl, Urb, Urb, Urb, Urb, Yhl, Yhl, Yhl, Urb, Urb, Urb, Urb, Urb, Urb, Urb, Urb, Urb, Urb, Urb, Urb, Urb, Yhl
Urb, Urb, Yhl, Yhl, Urb, Urb, Urb, Yhl, Urb, Urb, Yhl, Urb, Urb, Yhl, Yhl, Urb, Urb, Urb, Urb, Urb, Urb, Yhl, Yhl, Yhl, Urb, Urb, Yhl, Yhl, Urb, Urb, Urb, Urb, Urb, Urb, Urb, Yhl, Yhl, Urb, Urb, Urb, Urb, Urb, Urb, Yhl
Urb, Yhl, Urb, Yhl, Yhl, Urb, Yhl, Urb, Urb, Urb, Yhl, Urb, Urb, Yhl, Yhl, Yhl, Yhl, Urb, Urb, Urb, Urb, Urb, Urb, Yhl, Yhl, Yhl, Urb, Urb, Urb, Yhl, Yhl, Urb, Yhl, Urb, Urb, Urb, Urb, Yhl, Yhl, Urb, Urb, Urb, Urb, Urb
Urb, Urb, Urb, Urb, Yhl, Yhl, Urb, Urb, Urb, Urb, Urb, Yhl, Yhl, Yhl, Urb, Urb, Urb, Urb, Urb, Yhl, Urb, Urb, Urb, Yhl, Urb, Urb, Urb, Urb, Urb, Urb, Urb, Urb, Urb, Yhl, Yhl, Urb, Urb, Urb, Yhl, Yhl, Yhl, Yhl, Urb, Urb
Urb, Urb, Yhl, Yhl, Urb, Yhl, Urb, Urb, Urb, Urb, Yhl, Yhl, Urb, Yhl, Urb, Urb, Yhl, Urb, Urb, Urb, Urb, Urb, Urb, Yhl, Urb, Urb, Urb, Urb, Yhl, Urb, Urb, Urb, Yhl, Yhl, Urb, Urb, Yhl, Yhl, Urb, Urb, Urb, Urb, Urb, Urb
Yhl, Urb, Urb, Urb, Yhl, Yhl, Urb, Urb, Yhl, Urb, Urb, Urb, Urb, Urb, Urb, Urb, Urb, Urb, Urb, Yhl, Yhl, Urb, Urb, Yhl, Urb, Urb, Yhl, Yhl, Yhl, Urb, Urb, Urb, Urb, Urb, Urb, Urb, Urb, Yhl, Urb, Urb, Urb, Urb, Urb, Urb
Yhl, Urb, Urb, Urb, Urb, Urb, Urb, Urb, Urb, Yhl, Yhl, Urb, Urb, Urb, Urb, Urb, Urb, Urb, Yhl, Urb, Urb, Yhl, Yhl, Urb, Urb, Urb, Yhl, Yhl, Urb, Urb, Urb, Urb, Urb, Urb, Urb, Yhl, Urb, Urb, Urb, Urb, Urb, Yhl, Yhl, Urb
Urb, Yhl, Urb, Urb, Urb, Urb, Yhl, Urb, Urb, Urb, Urb, Yhl, Yhl, Yhl, Urb, Yhl, Yhl, Urb, Yhl, Urb, Yhl, Yhl, Urb, Urb, Urb, Yhl, Urb, Urb, Urb, Urb, Urb, Urb, Urb, Urb, Urb, Yhl, Urb, Urb, Urb, Urb, Yhl, Urb, Urb, Yhl
Urb, Yhl, Yhl, Urb, Urb, Urb, Urb, Urb, Yhl, Yhl, Yhl, Yhl, Urb, Urb, Urb, Urb, Urb, Yhl, Yhl, Yhl, Yhl, Urb, Urb, Urb, Urb, Yhl, Urb, Urb, Urb, Urb, Urb, Urb, Urb, Yhl, Yhl, Yhl, Urb, Urb, Urb, Urb, Yhl, Urb, Urb, Yhl
