border_size=1
usage=map

Xu, Xu, Xu, Xu, Xu, Xu, Xu, Xu, Xu, Xu, Xu, Xu, Xu, Xu, Xu, Xu, Xu, Xu, Xu, Xu, Xu, Xos, Xos, Xos, Xos, Urb, Urb, Urb, Urb, Urb^Es, Urb, Xos, Uu, Uu, Xos, Xos, Xos, Xos, Xos, Xos, Xos, Xu, Xu, Xu, Xu, Xu, Xu, Xu, Xu, Xu, Xu, Xu, Xu, Xu, Xu, Xu
Xu, Xu, Xu, Xu, Xu, Xu, Xu, Xu, Xu, Xu, Xu, Xu, Xu, Xu, Xu, Xu, Xu, Xu, Xu, Xu, Xu, Xu, Xu, Xos, Xos, Xos, Xos, Urb^Ii, Urb^Es, Urb, Urb^Ii, Urb^Es, Urb^Es, Xol, Xol, Xos, Xos, Xos, Yhr^Xp, Xos, Xos, Xos, Xu, Xu, Xu, Xu, Xu, Xu, Xu, Xu, Xu, Xu, Xu, Xu, Xu, Xu
Xu, Xu, Xu, Xu, Xu, Xu, Xu, Xu, Xu, Xu, Xu, Xu, Xu, Xu, Xu, Xu, Xu, Xu, Xu, Xu, Xu, Xu, Xu, Xos, Xos, Xos, Xos, Xos, Uu^Es, Urb^Es, Urb^Dr, Urb^Es, Urb^Ii, Urb, Urb, Xos, Uu^Es, Uu, Xos, Xos, Xos, Xos, Xos, Xu, Xu, Xu, Xu, Xu, Xu, Xu, Xu, Xu, Xu, Xu, Xu, Xu
Xu, Xu, Xu, Xu, Xu, Xu, Xu, Xu, Xu, Xu, Xu, Xu, Xu, Xu, Xu, Xu, Xu, Xu, Xu, Xu, Xu, Xu, Xu, Xu, Xos, Xos, Yhr^Xp, Uu, Xos, Xos, Xos, Urb^Es, Urb^Ii, Urb^Ii, Urb^Es, Urb^Dr, Urb^Es, Xos, Xol, Xos, Xos, Xos, Xos, Xos, Xos, Xu, Xu, Xu, Xu, Xu, Xu, Xu, Xu, Xu, Xu, Xu
Xu, Xu, Xu, Xu, Xu, Xu, Xu, Xu, Xu, Xu, Xu, Xu, Xu, Xu, Xu, Xu, Xu, Xu, Xu, Xu, Xu, Xu, Xu, Xu, Xos, Xos, Xos, Xos, Xos, Xos, Xos, Xos, Uu, Urb, Urb^Es, Urb, Urb^Es, Urb, Urb^Ii, Xol, Xu, Xos, Xu, Xos, Xos, Xos, Xu, Xu, Xu, Xu, Xu, Xu, Xu, Xu, Xu, Xu
Xu, Xu, Xu, Xu, Xu, Xu, Xu, Xu, Xu, Xu, Xu, Xu, Xu, Xu, Xu, Xu, Xu, Xu, Xu, Xu, Xu, Xu, Xu, Xu, Xu, Xos, Xos, Xos, Xos, Xos, Yhr^Xp, Uu, Xos, Xos, Xos, Urb^Dr, Urb^Edt, Urb^Es, Urb^Edt, Urb, Uu^Ii, Uh^Ii, Uh, Xu, Xos, Xos, Xos, Xu, Xu, Xu, Xu, Xu, Xu, Xu, Xu, Xu
Xu, Xu, Xu, Xu, Xu, Xu, Xu, Xu, Xu, Xu, Xu, Xu, Xu, Xu, Xu, Xu, Xu, Xu, Xu, Xu, Xu, Xu, Xu, Xu, Xu, Xu, Xu, Xos, Xos, Xos, Xos, Xos, Xos, Xos, Xos, Xos, Uh^Ii, Urb^Edt, Urb^Es, Uh, Uu, Uh, Ql, Uh, Xos, Xos, Xos, Xu, Xu, Xu, Xu, Xu, Xu, Xu, Xu, Xu
Xu, Xu, Xu, Xu, Xu, Xu, Xu, Xu, Xu, Xu, Xu, Xu, Xu, Xu, Xu, Xu, Xu, Xu, Xu, Xu, Xu, Xu, Xu, Xu, Xu, Xu, Xu, Xu, Xos, Xos, Xos, Xos, Xos, Xos, Xu, Uh, Uu^Ii, Urb^Edt, Urb^Es, Urb, Urb^Ii, Xu, Uh, Xu, Xu, Xos, Xos, Xos, Xu, Xu, Xu, Xu, Xu, Xu, Xu, Xu
Xu, Xu, Xu, Xu, Xu, Xu, Xu, Xu, Xu, Xu, Xu, Xu, Xu, Xu, Xu, Xu, Xu, Xu, Xu, Xu, Xu, Xu, Xu, Xu, Xu, Xu, Xu, Xu, Xos, Xos, Xos, Xos, Xu, Xu, Xu, Xu, Uh, Urb^Dr, Urb, Urb^Ii, Urb^Ii, Uh, Uh^Ii, Xu, Xu, Uh, Uh, Xu, Xu, Xu, Xu, Xu, Xu, Xu, Xu, Xu
Xu, Xu, Xu, Xu, Xu, Xu, Xu, Xu, Xu, Xu, Xu, Xu, Xu, Xu, Xu, Xu, Xu, Xu, Ql, Xu, Ql, Xu, Xu, Xu, Xu, Xu, Xu, Xu, Xos, Xos, Ql, Ql, Ql^Xo, Xu, Ql, Xu, Qlf, Uu, Cud, Urb^Ii, Urb, Uu^Ii, Uh, Uh, Uh, Uh, Ql, Uh, Xu, Xu, Xu, Xu, Xu, Xu, Xu, Xu
Xu, Xu, Xu, Xu, Xu, Xu, Xu, Xu, Xu, Xu, Xu, Xu, Xu, Xu, Xu, Xu, Ql, Ql, Ql, Ql, Ql, Xu, Xu, Xu, Xu, Xu, Xu, Xu, Xu, Ql, Ql, Ql^Xo, Ql, Ql, Ql, Qlf, Xu, Qlf, Urb, 4 Kud, Cud, Uu, Xu, Xu, Xu, Ql, Ql, Uh, Uh, Xu, Xu, Xu, Xu, Xu, Xu, Xu
Xu, Xu, Xu, Xu, Xu, Xu, Xu, Xu, Xu, Xu, Xu, Xu, Xu, Xu, Xu, Xu, Xu, Ql, Ql, Ql, Ql^Xo, Ql^Xo, Ql, Xu, Xos, Xu, Xu, Xu, Xu, Xu, Ql, Ql^Xo, Ql, Ql, Ql, Ql, Uu, Qlf, Urb^Es, Urb, Ql, Xu, Xu, Xu, Xu, Xu, Xu, Ql, Ql, Xu, Xu, Xu, Xu, Xu, Xu, Xu
Xu, Xu, Xu, Xu, Xu, Xu, Xu, Xu, Xu, Xu, Xu, Xu, Xu, Xu, Xu, Ql, Ql, Ql, Ql^Xo, Ql^Xo, Ql, Ql, Urb, Xos, Xos, Xos, Xos, Xu, Xu, Xu, Xu, Xu, Xu, Ql, Ql, Uu, Urb^Ii, Urb^Edt, Ql, Ql, Ql, Xu, Ql, Xu, Xu, Xu, Xu, Xu, Ql^Xo, Ql^Xo, Xu, Xu, Xu, Xu, Xu, Xu
Xu, Xu, Xu, Xu, Xu, Xu, Xu, Xu, Xu, Xu, Xu, Xu, Xu, Xu, Xu, Xu, Xu, Xu, Xu, Ql, Uh, Urb, Uu, Urb, Urb, Xos, Xos, Xos, Xos, Xu, Xu, Xu, Urb, Urb, Urb, Urb, Urb, Urb^Edt, Xu, Ql, Ql, Ql, Ql, Ql, Ql, Ql, Xu, Xu, Xu, Ql, Xu, Xu, Xu, Xu, Xu, Xu
Xu, Xu, Xu, Xu, Xu, Xu, Xu, Xu, Xu, Xu, Xu, Xu, Xu, Xu, Xu, Xu, Xu, Xu, Xos, Xos, Xos, Uh, Uu, Uu^Ii, Uh, Uh, Uh, Xos, Xos, Xos, Xos, Uu^Ii, Uu, Urb^Es, Uu, Uu^Ii, Ql, Xu, Xu, Xu, Xu, Ql, Ql, Cud, Ql, Ql, Ql^Xo, Xu, Xu, Xu, Xu, Xu, Xu, Xu, Xu, Xu
Xu, Xu, Xu, Xu, Xu, Xu, Xu, Xu, Xu, Xu, Xu, Xu, Xu, Xu, Xu, Xu, Xu, Xu, Xu, Xos, Xos, Xos, Xos, Uu, Uh, Urb, Urb, Urb, Urb, Xos, Qlf, Urb, Uu, Urb, Qlf, Ql, Xu, Xu, Xu, Uh, Uu, Ql, Ql, Ql, Qlf, Ql^Xo, Ql, Xu, Xu, Xu, Xu, Xu, Xu, Xu, Xu, Xu
Xu, Xu, Xu, Xu, Xu, Xu, Xu, Xu, Xu, Xu, Xu, Xu, Xu, Xu, Xu, Xu, Xu, Xu, Xu, Xu, Xu, Xos, Xos, Xos, Xos, Uh, Urb, Urb, Urb, Urb, Urb^Es, Urb, Uh, Qlf, Xu, Xu, Uh, Xu, Ql, Xu, Uu^Edt, Uu^Edt, Uu, Uu, Qlf, Qlf^Xo, Ql, Ql, Xu, Xu, Xu, Xu, Xu, Xu, Xu, Xu
Xu, Xu, Xu, Xu, Xu, Xu, Xu, Xu, Xu, Xu, Xu, Xu, Xu, Xu, Xu, Xu, Xu, Xu, Xu, Xu, Xu, Xu, Xu, Xos, Xos, Xos, Uh, Uh, Urb, Uh, Urb, Urb, Qlf, Urb, Ql, Ql, Ql, Ql, Ql, Uu, Uu^Dr, Rb^Edt, Xu, Xu, Xu, Xu, Xu, Ql, Xu, Xu, Xu, Xu, Xu, Xu, Xu, Xu
Xu, Xu, Xu, Xu, Xu, Xu, Xu, Xu, Xos, Xos, Xos, Xu, Xu, Xu, Xu, Xu, Xu, Xu, Qlf, Xu, Xu, Xu, Xu, Xu, Xu, Xu, Xu, Urb, Uh, Urb, Xu, Uu, Uh, Uu, Rb^Es, Ql, Ql, Ql, Uh, Uh, Uh, Uh, Uh, Xu, Xu, Xu, Xos, Xos, Xos, Xos, Xos, Xu, Xu, Xu, Xu, Xu
Xu, Xu, Xu, Xu, Xu, Xu, Xos, Xos, Xos, Xos, Xu, Xu, Xu, Xu, Xu, Xu, Qlf, Qlf, Qlf, Qlf, Qlf, Qlf, Xu, Xu, Xu, Xu, Xu, Uh, Xu, Xu, Xu, Xu, Xu, Uu, Rb^Es, Uu^Dr, Uh, Xu, Xu, Uh, Rb^Edt, Xu, Uh, Xu, Xu, Xos, Xos, Xos, Xos, Xos, Xos, Xu, Xu, Xu, Xu, Xu
Xu, Xu, Xu, Xu, Xos, Xos, Xos, Xos, Yhl, Yhl, Yhl, Uh, Xu, Xu, Xu, Xu, Qlf^Xo, Qlf^Xo, Qlf^Xo, Qlf^Xo, Qlf^Xo, Qlf, Xu, Xu, Xu, Xu, Xu, Xu, Xu, Xu, Xu, Xu, Xu, Xu, Uh, Rb^Es, Ur, Xu, Uu^Edt, Uu^Edt, Uu^Edt, Uu, Qlf, Qlf, Yhl^Xp, Xu, Qlf, Xos, Xos, Xos, Xu, Xu, Xu, Xu, Xu, Xu
Xu, Xu, Xos, Xos, Xos, Xos, Qlf, Qlf, Qlf, Yhl^Xp, Yhl, Xu, Xu, Xu, Xos, Xu, Xos, Qlf, Ql, Qlf, Qlf, Xu, Xu, Xu, Xu, Xu, Uh, Xu, Yhl, Xu, Xu, Xu, Qlf, Qlf, Uu, Uu, Ur^Es, Ur^Edt, Uu^Edt, Ur^Edt, Yhl, Yhl, Yhl^Edt, Qlf, Yhl, Yhl, Qlf, Xu, Xu, Xu, Xu, Xu, Xu, Xu, Xu, Xu
Xu, Xu, Xu, Xos, Xu, Qlf, Qlf, Qlf, Qlf, Yhl, Xu, Xu, Xu, Xos, Xos, Xos, Xos, Xos, Xos, Ql, Ql, Ql, Ql, Xu, Ql, Xu, Ql, Yhl, Yhl, Yhl, Xu, Xu, Xu, Qlf, Qlf, Rb, Uu, Uu, Xu, Xu, Qlf, Yhl, Qlf, Qlf, Yhl^Xp, Qlf, Qlf, Yhl, Qlf, Xu, Xu, Xu, Xu, Xu, Xu, Xu
Xu, Xu, Xu, Xu, Xu, Xu, Qlf, Yhl, Yhl^Xp, Yhl, Xu, Xu, Xu, Qlf, Qlf, Xos, Xos, Xos, Xos, Xos, Xos, Ql, Ql, Ql, Xu, Ql, Xu, Ql, Ql, Uu, Uh, Xu, Yhl, Yhl, Qlf, Uu^Ii, Uu, Ur^Es, Xu, Xu, Xu, Qlf, Xu, Yhl, Yhl, Yhl^Xp, Qlf, Qlf, Qlf^Xo, Qlf^Xo, Qlf, Xu, Xu, Xu, Xu, Xu
Xu, Xu, Xu, Xu, Xu, Xu, Xu, Yhl, Yhl, Yhl, Yhl^Xp, Xu, Uu, Qlf, Uu^Ii, Qlf, Xu, Xos, Xos, Xos, Xos, Xos, Xos, Ql, Qlf, Xu, Xu, Xu, Ql, Uh, Uh, Uh, Yhl, Yhl^Xp, Qlf, Uu, Uh, Ur^Em, Ur, Cud, Cud, Xu, Xu, Xu, Xu, Qlf, Qlf^Xo, Qlf^Xo, Qlf, Qlf, Xu, Xu, Xu, Xu, Xu, Xu
Xu, Xu, Xu, Xu, Xu, Xos, Xos, Xu, Yhl, Xu, Uu, Uu, Uu, Qlf, Urb, Qlf, Xu, Xu, Urb, Yhl^Xp, Xos, Xos, Xos, Ql, Qlf, Qlf, Xu, Xu, Xu, Ql, Ql, Ql, Ql, Ql, Ql, Uh, Ur, Uu^Es, Uu, Uu^Bzu, Uu, Cud, Xu, Xu, Xu, Xu, Xu, Qlf, Xu, Xu, Xu, Xu, Xu, Xu, Xu, Xu
Xu, Xu, Xu, Xu, Xu, Xos, Xos, Xos, Xu, Yhl^Xp, Uu, Qlf, Urb, Urb, Urb^Edt, Qlf, Urb, Urb^Edt, Urb^Edt, Xos, Yhl^Xp, Xos, Xos, Qlf, Yhl, Qlf, Yhl, Uh, Uh, Yhl, Yhl, Ql, Ql, Ql, Yhl, Ur, Uu, Uu, Uh, Uh, Rb, Cud, Xu, Xu, Xu, Xu, Xu, Xu, Xu, Xu, Xu, Xu, Xu, Xu, Xu, Xu
Xu, Xu, Xu, Xu, Xu, Xos, Xos, Xos, Xu, Xu, Urb^Es, Urb, Qlf, Urb^Edt, Urb^Edt, Urb, Urb, Urb^Edt, Urb, Urb, Xos, Xos, Uu, Yhl, Uu, Yhl, Uh, Yhl, Qlf, Yhl, Yhr, Yhr^Xp, Uu, Yhr, Yhl^Es, Yhl^Xp, Ql, Uu^Ii, Uu, Rb, Xu, Xu, Xu, Xu, Xos, Xu, Xu, Xu, Xu, Xu, Xu, Xu, Xu, Xu, Xu, Xu
Xu, Xu, Xu, Xu, Xu, Xos, Xos, Xos, Urb, Urb, Urb, Urb^Es, Urb, Urb, Urb^Edt, Urb, Qlf, Qlf, Urb, Urb^Edt, Yhl^Xp, Uu^Z\, Xos, Uu, Yhl, Yhl, Yhl, Yhl^Xp, Yhl, Qlf, Yhr, Uh, Uu, Yhr, Uh, Qlf, Ql, Ql, Uh, Uh, Uh, Xu, Xu, Xos, Xos, Xu, Xu, Xu, Xu, Xu, Xu, Xu, Xu, Xu, Xu, Xu
Xu, Xu, Xu, Xu, Ql, Xu, Ql, Urb, Yhr^Xp, Yhr^Edt, Urb, Urb^Es, Urb^Edt, Urb, Urb, Urb, Urb, Qlf, Urb, Urb, Xol, Xos, Xos, Xos, Qlf, Yhl, Yhl, Yhl^Es, Yhr^Es, Yhr, Yhl^Xp, Yhr^Dr, Yhl, Xu, Xu, Ql, Ql, Ql, Ur, Uh, Uh, Uh, Uh, Xos, Xos, Xu, Xu, Xu, Xu, Xu, Xu, Xu, Xu, Xu, Xu, Xu
Ql, Ql, Ql, Ql, Ql, Ql, Yhr^Xp, Yhr, Uu^Ii, Uu, Yhr, Yhr^Xp, Xos, Xos, Xos, Urb, Uu, Qlf, Qlf, Uu, Yhl^Xp, Xol, Yhl^Z\, Uu, Qlf, Yhl, Uh, Yhr, Yhl^Es, Yhl, Uu^Ii, Yhr, Qlf, Qlf, Ql, Ql, Ql, Uh, Uh, Uh, Uh, Xu, Xu, Xos, Xu, Xu, Xu, Xu, Xu, Xu, Xu, Xu, Xu, Xu, Xu, Xu
Ql, Ql, Qlf, Qlf, Qlf, Xu, Yhr, Yhr, Urb, Uu, Yhr^Xp, Yhr, Ql, Xos, Xos, Xos, Yhl^Xp, Uu, Uu, Uu, Uu, Yhl, Xu, Xu, Xu, Uh, Uh, Uh, Yhl, Yhl, Ur, Uh, Uh, Xu, Xu, Ql, Ql, Uu, Ur, Uu, Xu, Xu, Xu, Xu, Xu, Xu, Xu, Xu, Xu, Xu, Xu, Xu, Xu, Xu, Xu, Xu
Ql, Qlf, Qlf, Qlf, Qlf, Qlf, Qlf, Urb, Qlf, Qlf, Yhr, Yhr^Xp, Ql, Xu, Xos, Xos, Xos, Xos, Uu, Ur^Em, Ur, Uh, Xu, Xu, Ql, Ql, Ql, Ql, Ql, Uh, Ur, Uh, Yhl, Xu, Xu, Ql, Ql, Ql, Ql, Yhl^Xp, Qlf, Xu, Xu, Xu, Xu, Xu, Xu, Xu, Xu, Xu, Xu, Xu, Xu, Xu, Xu, Xu
Xu, Xu, Xu, Xu, Qlf, Qlf, Urb, Urb, Urb, Qlf, Qlf, Qlf, Ql, Ql, Xos, Xos, Xos, Xos, Uh, Ur, Ur, Xu, Xu, Xu, Ql^Xo, Ql, Ql^Xo, Ql, Ql^Xo, Ql, Xu, Uu, Yhl, Yhl, Uh, Qlf, Ql, Ql, Ql, Qlf, Qlf, Qlf, Qlf^Xo, Qlf, Xu, Xu, Xu, Xu, Xu, Xu, Xu, Xu, Xu, Xu, Xu, Xu
Xu, Xu, Xu, Xu, Qlf, Urb, Urb, Urb, Qlf, Qlf, Xu, Qlf, Ql, Ql, Xu, Xu, Xu, Xos, Ql, Uu, Uu, Xu, Xu, Xu, Ql, Ql^Xo, Ql, Ql^Xo, Ql, Ql^Xo, Xu, Xu, Xu, Uh, Uu^Em, Uu, Ur, Ql, Ql, Qlf, Qlf, Qlf, Qlf^Xo, Qlf, Xu, Xu, Xu, Xu, Xu, Xu, Xu, Xu, Xu, Xu, Xu, Xu
Xu, Xu, Xu, Xos, Xos, Urb, 2 Urb, Urb, Xos, Xu, Xu, Xu, Xu, Ql, Ql^Xo, Xu, Xu, Ql, Ql, Ql, Ql, Xu, Xu, Xu, Xu, Ql, Xu, Ql, Xu, Xu, Xu, Xu, Uh, Uu^Uf, Uu, Ur, Uu, Ql, Xu, Ql, Ql, Xu, Xu, Xu, Xu, Xu, Xu, Xu, Xu, Xu, Xu, Xu, Xu, Xu, Xu, Xu
Xu, Xu, Xu, Xos, Xos, Urb, Urb, Urb, Xos, Xos, Xu, Xu, Xu, Ql^Xo, Ql, Xu, Ql^Xo, Ql, Ql, Ql, Ql, Ql, Xu, Xu, Xu, Xu, Xu, Xu, Xu, Xu, Xu, Uh, Ql, Uu, Ur, Uh, Uh, Xu, Xu, Ql, Ql, Xu, Xu, Xu, Xu, Xu, Xu, Xu, Xu, Xu, Xu, Xu, Xu, Xu, Xu, Xu
Xu, Xu, Xu, Xos, Xos^Zok, Urb, Urb, Urb, Xos^Zok, Xos, Xu, Xu, Xu, Xu, Xu, Ql, Xu, Ql, Ql, Ql, Ql, Ql, Ql, Xu, Xu, Xu, Xu, Xu, Xu, Xu, Xu, Xu, Uu, Uu, Ql, Ql, Xu, Uh, Xu, Xu, Xu, Ql, Ql^Xo, Xu, Xu, Xu, Xu, Xu, Xu, Xu, Xu, Xu, Xu, Xu, Xu, Xu
Xu, Xu, Xu, Xos^Zok, Xos^Zok, Urb^Zok, Urb^Zok, Urb^Zok, Xos^Zok, Xos^Zok, Xu, Xu, Xu, Xu, Xu, Xu, Xu, Xu, Xu, Ql, Ql, Ql, Ql, Ql^Xo, Ql, Xu, Xu, Xu, Uh, Xu, Xu, Uu, Ql, Ur, Uu, Ql, Uh, Xu, Xu, Xu, Xu, Xu, Xu, Ql, Xu, Xu, Xu, Xu, Xu, Xu, Xu, Xu, Xu, Xu, Xu, Xu
Xu, Xu, Xu, Xos^Zok, Xos^Zok, Xos^Zok, Xos^Zok, Xos^Zok, Xos^Zok, Xos^Zok, Xu, Xu, Xu, Xu, Xu, Xu, Xu^Zok, Xu, Xu, Xu, Xu, Ql, Xu, Ql^Xo, Xu, Ql, Uu, Uu, Uu, Xu, Xu, Xu, Xu, Uu, Uu^Ii, Uu, Uu^Uf, Xu, Xu, Xu, Xu, Xu, Xu, Xu, Xu, Xu, Xu, Xu, Xu, Xu, Xu, Xu, Xu, Xu, Xu, Xu
Xu, Xu, Xu, Xos^Zok, Xos^Zok, Xos^Zok, Xos^Zok, Xos^Zok, Xos^Zok, Xos^Zok, Xu, Xu, Xu, Xu, Xu, Xu, Xu^Zok, Xu^Zok, Xu^Zok, Xu, Xu^Zok, Xu, Xu, Xu, Xu, Uu, Uu, Uu^Ii, Uu, Uu, Xu, Xu, Xu, Uu, Uu, Ql, Ql, Xu, Xu, Xu, Xu, Xu, Xu, Xu, Xu, Xu, Xu, Xu, Xu, Xu, Xu, Xu, Xu, Xu, Xu, Xu
Xu, Xu, Xu, Xu, Xu, Xos^Zok, Xos^Zok, Xos^Zok, Xu, Xu, Xu, Xu, Xu, Xu, Xu^Zok, Xu^Zok, Urb^Zok, Xu^Zok, Xu^Zok, Xu^Zok, Qxua^Zok, Xu^Zok, Xu^Zok, Xu^Zok, Xu^Zok, Xu, Xu, Uu, Xu, Uh, Xu, Xu, Xu, Xu, Xu, Ql, Xu, Xu, Xu, Xu, Xu, Xu, Xu, Xu, Xu, Xu, Xu, Xu, Xu, Xu, Xu, Xu, Xu, Xu, Xu, Xu
Xu, Xu, Xu, Xu, Xu, Xu, Xu, Xu, Xu, Xu, Xu, Xu, Xu, Xu^Zok, Urb^Zok, Urb^Zok, Urb^Zok, Urb^Zok, Urb^Zok, Qxua^Zok, Qxua^Zok, Qxua^Zok, Qxua^Zok, Qxua^Zok, Xos^Zok, Xu^Zok, Xu^Zok, Xu, Xu, Xu, Xu, Xu, Xu, Xu, Xu, Xu, Xu, Xu, Xu, Xu, Xu, Xu, Xu, Xu, Xu, Xu, Xu, Xu, Xu, Xu, Xu, Xu, Xu, Xu, Xu, Xu
Xu, Xu, Xu, Xu, Xu, Xu, Xu, Xu, Xu, Xu, Xu, Xu, Xu, Xu^Zok, Qxua^Zok, Urb^Zok, Urb^Zok, Urb^Zok, Urb^Zok, Qxua^Zok, Qxua^Zok, Qxua^Zok, Qxua^Zok, Qxua^Zok, Qxua^Zok, Xu^Zok, Xu^Zok, Xu, Xu, Xu, Xu, Xu, Xu, Xu, Xu, Xu, Xu, Xu, Xu, Xu, Xu, Xu, Xu, Xu, Xu, Xu, Xu, Xu, Xu, Xu, Xu, Xu, Xu, Xu, Xu, Xu
Xu, Xu, Xu, Xu, Xu, Xu, Xu, Xu, Xu, Xu, Xu, Xu^Zok, Xu^Zok, Xu^Zok, Qxua^Zok, Qxua^Zok, Qxua^Zok, Urb^Zok, Urb^Zok, Urb^Zok, Urb^Zok, Qxua^Zok, Qxua, Qxua^Zok, Qxua^Zok, Qxua^Zok, Xu^Zok, Xu, Xu, Xu, Xu, Xu, Xu, Xu, Xu, Xu, Xu, Xu, Xu, Xu, Xu, Xu, Xu, Xu, Xu, Xu, Xu, Xu, Xu, Xu, Xu, Xu, Xu, Xu, Xu, Xu
Xu, Xu, Xos, Xu, Xos, Xu, Xu, Xu, Xu, Xu, Xu^Zok, Xu^Zok, Xu^Zok, Xu^Zok, Qxua^Zok, Qxua^Zok, Qxua^Zok, Qxua^Zok, Qxua^Zok, Urb^Zok, Urb, Urb, Aa, Qxua, Qxua, Qxua^Zok, Xu^Zok, Xu, Xu, Xu, Xu, Xu, Xu, Xu, Xu, Xu, Xu, Xu, Xu, Xu, Xu, Xu, Xu, Xu, Xu, Xu, Xu, Xu, Xu, Xu, Xu, Xu, Xu, Xu, Xu, Xu
Xos, Xos, Xos, Xos, Xos, Xos, Xos, Xu, Xu, Xu, Xu, Xu^Zok, Xu^Zok, Xu^Zok, Qxua^Zok, Qxua^Zok, Qxua^Zok, Qxua^Zok, Qxua, Qxua, Uu, Urb, Aa, Qxua, Qxua, Qxua^Zok, Xu, Xu, Xu, Xu, Xu, Xu, Xu, Xu, Xu, Xu, Xu, Xu, Xu, Xu, Xu, Xu, Xu, Xu, Xu, Xu, Xu, Xu, Xu, Xu, Xu, Xu, Xu, Xu, Xu, Xu
Xos, Xos, Yhl, Yhl, Xos, Xos, Xos, Xos, Xos, Xu, Xu, Xu^Zok, Xu^Zok, Xu^Zok, Qxua^Zok, Qxua^Zok, Qxua^Zok, Qxua^Zok, Aa, Qxua, Qxua, Urb, Urb, Xos, Qxua, Qxua, Qxua, Xu, Xu, Xu, Xos, Xos, Xos, Xu, Xu, Xu, Xu, Xu, Xu, Xu, Xu, Xu, Xu, Xu, Xu, Xu, Xu, Xu, Xu, Xu, Xu, Xu, Xu, Xu, Xu, Xu
Xos, Xos, Yhl, Yhl, Xos, Xos, Wog, Xos, Xos, Xos, Xu, Xu, Xu^Zok, Qxua^Zok, Qxua^Zok, Qxua^Zok, Qxua, Qxua, Aa, Qxua, Uu, Uu, Urb, Urb, Urb, Qxua, Qxua, Qxua, Xos, Xos, Xos, Xos, Xos, Xos, Xos, Xu, Xu, Xu, Xu, Xu, Xu, Xu, Xu, Xu, Xu, Xu, Xu, Xu, Xu, Xu, Xu, Xu, Xu, Xu, Xu, Xu
Xos, Xos, Yhl, Yhl, Xos, Xos, Xos, Wog, Xos, Xos, Xos, Xu, Xu, Xu^Zok, Xu, Qxua, Qxua, Aa, Aa, Uu, Uh, Aa, Urb, Uu, Urb, Qxua, Qxua, Qxua, Qxua, Xos, Xos, Xos, Xos, Xos, Xos, Xos, Xu, Xu, Xu, Xu, Xu, Xu, Xu, Xu, Xu, Xu, Xu, Xu, Xu, Xu, Xu, Xu, Xu, Xu, Xu, Xu
Xos, Xos, Yhl, Yhl, Xos, Xos, Xos, Wog^Xo, Wog, Xos, Xos, Xos, Xos, Xu, Xu, Qxua, Qxua, Qxua, Aa, Aa, Qxua, Xos, Urb, Aa, Aa, Qxua, Qxua, Qxua, Qxua, Qxua, Qxua, Xos, Xos, Xos, Xu, Xu, Xu, Xu, Xu, Xu, Xu, Xu, Xu, Xu, Xu, Xu, Xu, Xu, Xu, Xu, Xu, Xu, Xu, Xu, Xu, Xu
Xos, Xos, Yhl^Xo, Yhl^Xo, Yhl, Xos, Xos, Xos, Xos, Wog, Wog, Xos, Xos, Xu, Xu, Xu, Aa, Qxua, Uu, Aa, Qxua, Uu, Aa, Aa, Aa, Qxua, Qxua, Qxua, Qxua, Xu, Qxua, Qxua, Qxua, Xu, Xu, Xu, Xu, Xu, Xu, Xu, Xu, Xu, Xu, Xu, Xu, Xu, Xu, Xu, Xu, Xu, Xu, Xu, Xu, Xu, Xu, Xu
Xos, Xos, Xos, Yhl, Yhl, Xos, Xos, Xos, Wwg, Wog, Wwg, Wog, Wwf, Xu, Xu, Xu, Xu, Aa, Uu, Uu, Uh, Uh, Uu, Aa, Urb, Aa, Uh, Uu, Qxua, Qxua, Qxua, Qxua, Qxua, Xu, Xu, Xu, Xu, Xu, Xu, Xu, Xu, Xu, Xu, Xu, Xu, Xu, Xu, Xu, Xu, Xu, Xu, Xu, Xu, Xu, Xu, Xu
Xos, Xos, Yhl^Ebur, Yhl, Urb, Uu, Uu, Wwg, Yhl, Wwf, Uh, Wwg, Wwf, Xu, Yhl^Xp, Xu, Aa, Aa, Urb, Uu, Uu, Uu, Yhl, Urb, Aa, Xos, Aa, Uu, Urb, Aa, Xu, Xu, Xos, Xu, Xu, Xu, Xu, Xu, Xu, Xu, Xu, Xu, Xu, Xu, Xu, Xu, Xu, Xu, Xu, Xu, Xu, Xu, Xu, Xu, Xu, Xu
Xos, Uu^Ebur, Uh, Uu, Urb, Urb, Uu, Uh, Uh, Uh, Uu, Uh, Yhl, Uu, Yhl, Yhl, Yhl, Urb, Yhl, Yhl, Urb, Urb, Yhl, Yhl^Xp, Qxua, Urb, Aa, Uu, Aa, Xu, Xu, Xu, Xos, Xos, Xu, Xu, Xu, Xu, Xu, Xu, Xu, Xu, Xu, Xu, Xu, Xu, Xu, Xu, Xu, Xu, Xu, Xu, Xu, Xu, Xu, Xu
Uu, Uu, Yhl, Urb, Urb, Uh, Uu, Xu, Urb, Uh, Urb, Urb, Yhl, Yhl, Yhl, Yhl, Uh, Yhl^Xp, Uu, Uu, Xu, Uu, Xu, Aa, Qxua, Qxua, Qxua, Qxu, Aa, Aa, Xu, Xu, Xu, Xos, Xu, Xu, Xu, Xu, Xu, Xu, Xu, Xu, Xu, Xu, Xu, Xu, Xu, Xu, Xu, Xu, Xu, Xu, Xu, Xu, Xu, Xu
Uh, Uh, Uu, Yhl^Xp, Urb, Uh, Urb, Urb, Urb, Urb, Yhl, Urb, Yhl, Yhl, Uu, Xu, Uu, Yhl, Yhl, Uh, Xu, Xu, Xu, Xu, Qxua, Qxua, Aa, Qxua, Qxua, Aa, Xu, Xu, Xu, Xu, Xu, Xu, Xu, Xu, Xu, Xu, Xu, Xu, Xu, Xu, Xu, Xu, Xu, Xu, Xu, Xu, Xu, Xu, Xu, Xu, Xu, Xu
Uu, Uu, Urb, Urb, Urb, Urb, Yhl^Xp, Yhl, Urb, Yhl, Yhl, Uu, Yhl, Yhl^Xp, Uh, Urb, Uu, Yhl, Xu, Xu, Xu, Xu, Xu, Xu, Qxua, Qxua, Aa, Aa, Qxua, Qxua, Xu, Xu, Xu, Xu, Xu, Xu, Xu, Xu, Xu, Xu, Xu, Xu, Xu, Xu, Xu, Xu, Xu, Xu, Xu, Xu, Xu, Xu, Xu, Xu, Xu, Xu
Yhl, Uu, Yhl, Urb, Urb, Urb, Urb, Yhl, 1 Urb, Urb, Yhl, Yhl, Urb, Uu, Uu, Uu, Uu, Xu, Xu, Xu, Wog, Uh, Xu, Xu, Xu, Xu, Xu, Xu, Qxua, Qxua, Qxua^Xo, Xu, Xu, Xu, Xu, Xu, Xu, Xu, Xu, Xu, Xu, Xu, Xu, Xu, Xu, Xu, Xu, Xu, Xu, Xu, Xu, Xu, Xu, Xu, Xu, Xu
Yhl, Yhl, Yhl^Xp, Yhl, Uu, Urb, Urb, Urb, Yhl^Xp, Urb, Urb, Urb, Urb, Uh, Uu, Uu, Uh, Uh, Wog, Wog, Wog, Xu, Xu, Xu, Xu, Xu, Xu, Xu, Xu, Qxua^Xo, Qxua, Qxua, Xu, Xu, Xu, Xu, Xu, Xu, Xu, Xu, Xu, Xu, Xu, Xu, Xu, Xu, Xu, Xu, Xu, Xu, Xu, Xu, Xu, Xu, Xu, Xu
Xu, Yhl, Uu, Yhl, Uu, Urb, Yhl, Urb, Urb, Urb, Urb, Urb, Yhl, Yhl, Xu, Xu, Xu, Wog, Wog, Wog, Xu, Xu, Xu, Xu, Xu, Xu, Xu, Xu, Xu, Xu, Xu, Xu, Xu, Xu, Xu, Xu, Xu, Xu, Xu, Xu, Xu, Xu, Xu, Xu, Xu, Xu, Xu, Xu, Xu, Xu, Xu, Xu, Xu, Xu, Xu, Xu
Xu, Xu, Xu, Uu, Urb, Urb, Yhl, Yhl, Yhl^Xp, Yhl^Xp, Yhl, Yhl, Xu, Xu, Xu, Xu, Xu, Wog, Wog, Wog, Wog^Xo, Xu, Xu, Xu, Xu, Xu, Xu, Xu, Xu, Xu, Xu, Xu, Xu, Xu, Xu, Xu, Xu, Xu, Xu, Xu, Xu, Xu, Xu, Xu, Xu, Xu, Xu, Xu, Xu, Xu, Xu, Xu, Xu, Xu, Xu, Xu
Xu, Xu, Xos, Urb, Urb, Urb, Uu, Yhl, Yhl, Yhl, Xu, Xu, Xu, Xu, Xu, Xu, Xu, Xu, Wog^Xo, Wog^Xo, Wog, Wog, Xu, Xu, Xu, Xu, Xu, Xu, Xu, Xu, Xu, Xu, Xu, Xu, Xu, Xu, Xu, Xu, Xu, Xu, Xu, Xu, Xu, Xu, Xu, Xu, Xu, Xu, Xu, Xu, Xu, Xu, Xu, Xu, Xu, Xu
Xu, Xu, Xos, Xos, Urb^Xo, Urb, Urb^Xo, Yhl^Xp, Xos, Xos, Xos, Xu, Xu, Xu, Xu, Xu, Xu, Xu, Wog, Wog, Wog, Wog, Xu, Xu, Xu, Xu, Xu, Xu, Xu, Xu, Xu, Xu, Xu, Xu, Xu, Xu, Xu, Xu, Xu, Xu, Xu, Xu, Xu, Xu, Xu, Xu, Xu, Xu, Xu, Xu, Xu, Xu, Xu, Xu, Xu, Xu
Xu, Xu, Xos, Xos, Yhl, Urb^Xo, Urb, Xos, Xos, Xos, Xos, Xos, Xos, Xu, Xu, Xu, Xu, Xu, Xu, Wog, Xu, Xu, Xu, Xu, Xu, Xu, Xu, Xu, Xu, Xu, Xu, Xu, Xu, Xu, Xu, Xu, Xu, Xu, Xu, Xu, Xu, Xu, Xu, Xu, Xu, Xu, Xu, Xu, Xu, Xu, Xu, Xu, Xu, Xu, Xu, Xu
Xu, Xu, Xos, Xos, Yhl, Urb, Urb, Xos, Xos, Xos, Xos, Xos, Xos, Xos, Xos, Xu, Xu, Xu, Xu, Xu, Xu, Xu, Xu, Xu, Xu, Xu, Xu, Xu, Xu, Xu, Xu, Xu, Xu, Xu, Xu, Xu, Xu, Xu, Xu, Xu, Xu, Xu, Xu, Xu, Xu, Xu, Xu, Xu, Xu, Xu, Xu, Xu, Xu, Xu, Xu, Xu
Xu, Xu, Xos, Xos, Xos, Urb, Urb, Urb, Urb, Xos, Xos, Xos, Xos, Xos, Xos, Xos, Xos, Xu, Xu, Xu, Xu, Xu, Xu, Xu, Xu, Xu, Xu, Xu, Xu, Xu, Xu, Xu, Xu, Xu, Xu, Xu, Xu, Xu, Xu, Xu, Xu, Xu, Xu, Xu, Xu, Xu, Xu, Xu, Xu, Xu, Xu, Xu, Xu, Xu, Xu, Xu
