border_size=1
usage=map

Xu          , Xu          , Xu          , Xu          , Xu          , Xu          , Xu          , Xos         , Xos         , Xos         , Xos         , Xos         , Xos         , Xos         , Xu          , Xu          , Xu          , Xu          , Xu          , Xu          , Xu          , Xu          , Xu          , Xu          , Xu          , Xu          , Xu          , Xu          , Xu          , Xu          , Qlf         , Qlf         , Qlf         , Xu          , Xu          , Xu          , Xu          , Xu          , Xu          , Xu          , Xu          , Xu          
Xu          , Xu          , Xu          , Xu          , Xu          , Xu          , Xu          , Xu          , Xos         , Xos         , Xos         , Xos         , Xu          , Xu          , Xu          , Xu          , Xu          , Xu          , Xu          , Xu          , Xu          , Xu          , Xu          , Xu          , Xu          , Xu          , Xu          , Xu          , Xu          , Xu          , Xu          , Qlf         , Qlf         , Xu          , Ryd         , Yr          , Yr          , Yr          , Ryd         , Yr          , Yr          , Yr          
Xos         , Xu          , Xu          , Xu          , Xu          , Xu          , Xu          , Xu          , Xos         , Xos         , Xos         , Xos         , Xu          , Xu          , Xu          , Xu          , Xu          , Xu          , Xu          , Xu          , Xu          , Xu          , Yr^Xp       , Xu          , Yr^Xp       , Xu          , Xu          , Xu          , Xu          , Yr^Xp       , Zw          , Qlf         , Yr          , Qlf         , Ryd         , Ryd         , Ryd         , Ryd         , Ryd         , Ryd         , Yr          , Yr          
Xos         , Xos         , Xos         , Xu          , Xu          , Xu          , Xos         , Xos         , Xos         , Xos         , Xos         , Xos         , Xu          , Ql          , Xu          , Xu          , Qlf         , Xu          , Xu          , Xu          , Xu          , Qlf         , Zw          , Xu          , Zw          , Qlf         , Qlf         , Xu          , Xu          , Xu          , Xu          , Ryd         , Yr          , Yr          , Xu          , Xu          , Zw          , Xu          , Zw          , Xu          , Xu          , Xu          
Xos         , Xos         , Xos         , Xos         , Xos         , Xos         , Xos         , Xos         , Xos         , Xos         , Xu          , Xu          , Xu          , Ql          , Ql          , Ql          , Ql          , Qlf         , Qlf         , Xu          , Xu          , Qlf         , Qlf         , Xu          , Zw          , Qlf         , Xu          , Xu          , Xu          , Yr^Xp       , Zw          , Yr          , Ryd         , Xu          , Xu          , Xu          , Yr^Xp       , Xu          , Yr^Xp       , Xu          , Xu          , Xu          
Xu          , Xos         , Xos         , Xos         , Xos         , Xos         , Xos         , Xos         , Xos         , Ql          , Ql          , Xu          , Xu          , Ql          , Ql          , Xos         , Xos         , Qlf         , Qlf         , Yr          , Zw          , Xu          , Yr          , Zw          , Zw          , Zw          , Zw          , Ryd         , Ryd         , Xu          , Ryd         , Yr          , Yr          , Xu          , Xu          , Xu          , Xu          , Xu          , Xu          , Xu          , Xu          , Xu          
Xu          , Xu          , Xu          , Xos         , Xos         , Xos         , Xos         , Xos         , Xos         , Xos         , Ql          , Xu          , Ql          , Ql          , Xos         , Xos         , Xu          , Qlf         , Xu          , Qlf         , Xu          , Yr          , Zw          , Qlf         , Qlf         , Zw          , Qlf         , Zw          , Zw          , Ryd         , Ryd         , Ryd         , Xu          , Zw          , Yr^Xp       , Xu          , Xu          , Xu          , Xu          , Xu          , Xu          , Xu          
Xu          , Xu          , Xu          , Xos         , Xos         , Xos         , Xos         , Xos         , Xos         , Xos         , Ql          , Xu          , Ql          , Ql          , Xos         , Xu          , Xu          , Xu          , Xu          , Qlf         , Yr          , Yr^Xp       , Zw          , Qlf         , Qlf         , Xu          , Xu          , Qlf         , Xu          , Ryd         , Xu          , Zw          , Yr^Xp       , Xu          , Xu          , Xu          , Xu          , Xu          , Xu          , Xu          , Xu          , Xu          
Xu          , Xu          , Xu          , Xu          , Xos         , Xos         , Xos         , Xos         , Xos         , Xos         , Ql          , Ql          , Ql          , Xos         , Xu          , Xu          , Xu          , Yr^Xp       , Xu          , Qlf         , Qlf         , Yr          , Ryd         , Xu          , Qlf         , Qlf         , Zw          , Xu          , Xu          , Xu          , Xu          , Xu          , Xu          , Xu          , Xu          , Xu          , Yr^Xp       , Xu          , Xu          , Xu          , Xu          , Xu          
Xu          , Xu          , Xu          , Xu          , Xos         , Xos         , Xu          , Ql          , Ql          , Ql          , Ql          , Ql          , Ql          , Xos         , Xu          , Yr^Xp       , Zw          , Zw          , Xu          , Qlf         , Qlf         , Ryd         , Yr          , Yr          , Zw          , Qlf         , Yr          , Yr          , Yr          , Yr^Xp       , Zw          , Qlf         , Qlf         , Qlf         , Yr          , Zw          , Xu          , Xu          , Yr^Xp       , Xu          , Xu          , Xu          
Xu          , Xu          , Xu          , Xu          , Xu          , Xu          , Xu          , Xu          , Xu          , Xu          , Qlf         , Qlf         , Ql          , Xos         , Xu          , Xu          , Xu          , Ryd         , Qlf         , Qlf         , Xu          , Qlf         , Ql          , Yr          , Xu          , Zw          , Xu          , Ryd         , Ryd         , Ryd         , Yr          , Zw          , Zw          , Yr          , Yr          , Ryd         , Ryd         , Zw          , Xu          , Xu          , Yr^Xp       , Xu          
Xu          , Xu          , Xu          , Xu          , Yr^Xp       , Xu          , Qlf         , Xu          , Qlf         , Xu          , Qlf         , Qlf         , Ql          , Ql          , Xu          , Xu          , Ryd         , Yr          , Yr          , Ryd         , Yr          , Qlf         , Qlf         , Ql          , Xu          , Xu          , Ql          , Ql          , Xu          , Ryd         , Xu          , Yr          , Zw          , Qlf         , Qlf         , Ryd         , Ryd         , Ryd         , Ryd         , Zw          , Xos         , Xos         
Xu          , Xu          , Yr^Xp       , Xu          , Xu          , Zw          , Zw          , Qlf         , Qlf         , Qlf         , Qlf         , Ql          , Ql          , Ql          , Yr          , Ql          , Ql          , Yr          , Xu          , Ryd         , Yr          , Qlf         , Qlf         , Ql          , Ql          , Xu          , Ql          , Zw          , Qlf         , Xu          , Xu          , Xu          , Xu          , Xu          , Qlf         , Qlf         , Xu          , Yr          , Ryd         , Xos         , Xos         , Xos         
Qlf         , Xu          , Xu          , Zw          , Zw          , Xu          , Ryd         , Ryd         , Qlf         , Ryd         , Ryd         , Ryd         , Yr          , Ryd         , Ql          , Ryd         , Ryd         , Ryd         , Xu          , Yr^Xp       , Yr          , Qlf         , Xg^Zse      , Ql          , Ql          , Xu          , Xu          , Ql          , Qlf         , Qlf         , Yr          , Xu          , Qlf         , Xu          , Qlf         , Qlf         , Qlf         , Yr          , Ryd         , Qlf         , Xos         , Xos         
Xu          , Qlf         , Qlf         , Xu          , Ryd         , Ryd         , Ryd         , Ryd         , Yr          , Yr          , Ryd         , Yr          , Ql          , Ryd         , Ql          , Yr^Xp       , Xu          , Xu          , Xu          , Ryd         , Qlf         , Ryd         , Ryd         , Ql          , Ql          , Xu          , Xg^Zsw      , Qlf         , Ryd         , Ryd         , Qlf         , Ryd         , Qlf         , Xu          , Xu          , Qlf         , Qlf         , Ryd         , Yr          , Qlf         , Xos         , Xos         
Xu          , Xu          , Qlf         , Qlf         , Yr          , Ryd         , Qlf         , Qlf         , Zw          , Qlf         , Xu          , Xu          , Ql          , Ql          , Ql          , Xu          , Xu          , Ql          , Qlf         , Xu          , Qlf         , Qlf         , Yr          , Yr          , Ryd         , Qlf         , Yr          , Ryd         , Qlf         , Qlf         , Qlf         , Ryd         , Ryd         , Xu          , Xu          , Xu          , Qlf         , Yr          , Ryd         , Ryd         , Zw          , Xos         
Qlf         , Qlf         , Xu          , Qlf         , Yr          , Yr^Xp       , Qlf         , Yr          , Xu          , Qlf         , Qlf         , Qlf         , Qlf         , Ql          , Ql          , Xu          , Ql          , Ql          , Qlf         , Qlf         , Qlf         , Qlf         , Xu          , Yr^Xp       , Xu          , Ryd         , Xu          , Xos         , Xos         , Qlf         , Yr          , Ryd         , Xg^Zsw      , Xu          , Xu          , Qlf         , Yr          , Yr          , Zw          , Xos         , Yr^Xp       , Xos         
Xu          , Xu          , Xu          , Qlf         , Ryd         , Yr          , Ryd         , Zw          , Yr^Xp       , Xu          , Qlf         , Qlf         , Ql          , Ql          , Xu          , Ql          , Ql          , Qlf         , Ql          , Qlf         , Xu          , Xu          , Xu          , Zw          , Xu          , Xu          , Xu          , Xu          , Xos         , Qlf         , Ryd         , Qlf         , Qlf         , Xu          , Qlf         , Ryd         , Ryd         , Xos         , Yr^Xp       , Xos         , Xos         , Xos         
Xu          , Xu          , Xu          , Qlf         , Xu          , Yr          , Ryd         , Yr          , Yr          , Ryd         , Qxu         , Qlf         , Ql          , Xu          , Xu          , Ql          , Xu          , Ql          , Xu          , Xu          , Xu          , Xu          , Xu          , Zw          , Xu          , Xu          , Yr          , Yr          , Yr          , Xos         , Ryd         , Xg^Zse      , Qlf         , Xu          , Yr          , Yr          , Yr          , Xos         , Xos         , Xos         , Xos         , Xos         
Xu          , Xu          , Xu          , Xu          , Xu          , Qlf         , Qlf         , Ryd         , Ryd         , Ryd         , Qxu         , Qlf         , Xu          , Xu          , Xu          , Ql          , Xu          , Ql          , Ql          , Xu          , Xu          , Xu          , Xu          , Zw          , Zw          , Xu          , Yr          , Zw          , Yr          , Xos         , Xos         , Ryd         , Ryd         , Ryd         , Ryd         , Qlf         , Qlf         , Xos         , Xos         , Xos         , Xu          , Xu          
Xu          , Xu          , Xu          , Xu          , Xu          , Qlf         , Qlf         , Qxu         , Qxu         , Qxu         , Xos         , Xos         , Xu          , Xu          , Xu          , Xu          , Xu          , Xu          , Xu          , Xu          , Xu          , Xu          , Xu          , Xu          , Xu          , Xu          , Xu          , Yr          , Xu          , Xos         , Xos         , Xos         , Xos         , Yr^Xp       , Xos         , Qlf         , Xos         , Xos         , Xu          , Xu          , Xu          , Xu          
Xu          , Xu          , Xu          , Xu          , Xu          , Xu          , Xu          , Xu          , Xu          , Xu          , Xu          , Xu          , Xu          , Xu          , Xu          , Xu          , Xu          , Xu          , Xu          , Xu          , Xu          , Xu          , Xu          , Xu          , Xu          , Xu          , Xu          , Xu          , Xu          , Xos         , Xos         , Xos         , Xos         , Xos         , Xos         , Xos         , Xu          , Xu          , Xu          , Xu          , Xu          , Xu          
Xv          , Xv          , Xv          , Xv          , Xv          , Xv          , Xv          , Xv          , Xv          , Xv          , Xv          , Xv          , Xv          , Xv          , Xv          , Xv          , Xv          , Xv          , Xv          , Xv          , Xv          , Xv          , Xv          , Xv          , Xv          , Xv          , Xv          , Xv          , Xv          , Xv          , Xv          , Xv          , Xv          , Xv          , Xv          , Xv          , Xv          , Xv          , Xv          , Xv          , Xv          , Xv          
Xv          , Xv          , Xv          , Xv          , Xv          , Xv          , Xv          , Xv          , Xv          , Xv          , Xv          , Xv          , Xv          , Xv          , Xv          , Xv          , Xv          , Xv          , Xv          , Xv          , Xv          , Xv          , Xv          , Xv          , Xv          , Xv          , Xv          , Xv          , Xv          , Xv          , Xv          , Xv          , Xv          , Xv          , Xv          , Xv          , Xv          , Xv          , Xv          , Xv          , Xv          , Xv          
Wo          , Ai          , Wo          , Wo          , Ai          , Wo          , Wo          , Ai          , Wo          , Wo          , Ai          , Ai          , Wo          , Ai          , Aa          , Aa          , Ai          , Wo          , Wo          , Ai          , Wo          , Wo          , Wo          , Ai          , Ai          , Wo          , Wo          , Ai          , Wo          , Ai          , Ai          , Ai          , Ryd         , Ai          , Wo          , Ai          , Ryd         , Ai          , Wo          , Ai          , Cud         , Ai          
Wo          , Ai          , Wo          , Wo          , Aa          , Ai          , Wo          , Ai          , Ai          , Wo          , Wo          , Wo          , Wo          , Wo          , Wo          , Wo          , Aa          , Ai          , Ai          , Wo          , Ai          , Ai          , Ai          , Ai          , Cud         , Ai          , Cud         , Cud         , Ai          , Wo          , Ai          , Ryd         , Ai          , Wo          , Wo          , Ai          , Ai          , Ryd         , Ai          , Ai          , Ai          , Cud         
Ai          , Aa          , Wo          , Aa          , Wo          , Ai          , Wo          , Ai          , Ai          , Wo          , Wo          , Ai          , Wo          , Ai          , Aa          , Aa          , Ai          , Wo          , Aa          , Ai          , Cud         , Wo          , Ai          , Cud         , Ai          , Cud         , Ai          , Ai          , Wo          , Wo          , Ai          , Ai          , Aa          , Aa          , Xos         , Wo          , Aa          , Ai          , Wo          , Ryd         , Ai          , Cud         
Ai          , Ai          , Ai          , Aa          , Ai          , Wo          , Wo          , Wo          , Wo          , Wo          , Wo          , Ai          , Wo          , Wo          , Ai          , Ai          , Wo          , Wo          , Ai          , Cud         , Ai          , Ai          , Wo          , Ai          , Wo          , Ai          , Ai          , Ai          , Wo          , Ryd         , Ai          , Aa          , Xos         , Aa          , Aa          , Wo          , Xos         , Aa          , Wo          , Ryd         , Ai          , Ai          
Ai          , Wo          , Wo          , Wo          , Ai          , Wo          , Wo          , Ai          , Ai          , Wo          , Wo          , Ai          , Ai          , Wo          , Wo          , Ai          , Wo          , Ai          , Wo          , Cud         , Ai          , Aa          , Aa          , Ai          , Wo          , Wo          , Ai          , Wo          , Ai          , Ryd         , Aa          , Aa          , Aa          , Aa          , Ryd         , Wo          , Aa          , Aa          , Ai          , Wo          , Ai          , Wo          
Ai          , Wo          , Ai          , Wo          , Wo          , Ai          , Wo          , Ai          , Ai          , Ai          , Wo          , Wo          , Ai          , Ai          , Wo          , Wo          , Aa          , Aa          , Wo          , Wo          , Ai          , Ai          , Wo          , Aa          , Wo          , Wo          , Aa          , Ai          , Ai          , Ai          , Aa          , Xos         , Aa          , Ryd         , Qxs         , Ryd         , Aa          , Xos         , Wo          , Wo          , Ai          , Cud         
Xu          , Xu          , Xu          , Xu          , Xu          , Xu          , Xu          , Xu          , Xu          , Ai          , Wo          , Ai          , Ai          , Wo          , Wo          , Ai          , Ai          , Aa          , Cud         , Cud         , Ai          , Wo          , Wo          , Aa          , Ai          , Aa          , Ryd         , Ryd         , Ai          , Ai          , Ai          , Aa          , Aa          , Ryd         , Ryd         , Yr^Xp       , Yl          , Aa          , Aa          , Ai          , Ai          , Cud         
Xu          , Xu          , Xu          , Xu          , Xu          , Ww          , Xu          , Xu          , Xu          , Xu          , Xu          , Xu          , Xu          , Ai          , Ai          , Wo          , Ai          , Cud         , Wo          , Wo          , Ai          , Wo          , Ai          , Wo          , Ai          , Ai          , Ryd         , Ai          , Ai          , Ai          , Ai          , Xos         , Aa          , Aa          , Yl          , Yr          , Yr          , Yr^Xp       , Aa          , Aa          , Wo          , Ai          
Xu          , Ww          , Xu          , Xu          , Xu          , Ww          , Ww          , Xu          , Xu          , Xu          , Ww          , Ww          , Xu          , Wo          , Wo          , Ai          , Wo          , Ai          , Wo          , Ai          , Wo          , Wo          , Ai          , Ai          , Wo          , Ai          , Ai          , Ai          , Ryd         , Ryd         , Ryd         , Ai          , Ai          , Xos         , Aa          , Yr^Xp       , Ryd         , Yr^Xp       , Ryd         , Wo          , Wo          , Ai          
Xu          , Wwf         , Wwf         , Xu          , Xu          , Wwf         , Xu          , Wwf         , Wwf         , Xu          , Wwf         , Xu          , Ww          , Xu          , Xu          , Xu          , Xu          , Cud         , Ai          , Ai          , Ai          , Ai          , Ai          , Ai          , Wo          , Wo          , Zw          , Zw          , Ryd         , Yl          , Yl          , Yr          , Yr          , Ai          , Ai          , Aa          , Yl          , Yr          , Ryd         , Aa          , Aa          , Ai          
Ryd         , Xu          , Yl          , Xu          , Yl          , Wwf         , Xu          , Xu          , Wwf         , Xu          , Wwf         , Xu          , Xu          , Wwf         , Xu          , Xu          , Ryd         , Xu          , Zw          , Ai          , Zw          , Zw          , Zw          , Zw          , Zw          , Zw          , Yl          , Yl          , Ryd         , Ryd         , Yl          , Yl^Xp       , Ryd         , Ryd         , Yl          , Ai          , Yl          , Yr^Xp       , Yl          , Ryd         , Ai          , Ai          
Yl          , Yl          , Ryd         , Ryd         , Ryd         , Yl          , Yl^Xp       , Yl          , Ryd         , Ryd         , Ryd         , Xu          , Yl          , Yl^Xp       , Yl          , Ryd         , Ryd         , Ryd         , Yl          , Zw          , Ryd         , Yl          , Yl^Xp       , Ryd         , Ryd         , Ryd         , Yl          , Yl          , Ai          , Ai          , Ai          , Yl          , Ai          , Yl          , Yl          , Ai          , Yl          , Yl          , Yl          , Ryd         , Ai          , Wo          
Yl          , Ryd         , Ryd         , Ryd         , Yl          , Yl          , Ryd         , Yl          , Yl          , Ryd         , Yl          , Yl          , Ryd         , Ryd         , Ryd         , Yl          , Yl^Xp       , Yl          , Ryd         , Ryd         , Zw          , Yl          , Zw          , Ryd         , Zw          , Yl          , Ai          , Wo          , Wo          , Ai          , Wo          , Wo          , Wo          , Yl          , Yr          , Yr^Xp       , Yl^Xp       , Yl          , Yr          , Ai          , Wo          , Wo          
Ryd         , Yl          , Yl^Xp       , Yl          , Ryd         , Ryd         , Ryd         , Ryd         , Yl          , Yl^Xp       , Yl          , Ryd         , Ryd         , Ryd         , Xu          , Xu          , Xu          , Xu          , Xu          , Xu          , Xu          , Xu          , Xu          , Ai          , Ai          , Ai          , Ai          , Wo          , Wo          , Wo          , Wo          , Wo          , Wo          , Ryd         , Yr^Xp       , Yr          , Ryd         , Yl^Xp       , Wo          , Wo          , Ai          , Ai          
Yl          , Yl          , Ryd         , Yl          , Yl          , 1 Ryd       , Yl          , Yl          , Ryd         , Ryd         , Ryd         , Yl          , Yl^Xp       , Yl          , Ryd         , Xu          , Wwf         , Xu          , Ww          , Xu          , Xu          , Xu          , Ww          , Xu          , Xu          , Ai          , Ai          , Wo          , Wo          , Ai          , Wo          , Ai          , Wo          , Ai          , Ai          , Yl          , Ai          , Ai          , Wo          , Ai          , Wo          , Ai          
Ryd         , Ryd         , Ryd         , Ryd         , Yl          , Yl^Xp       , Yl          , Ryd         , Ryd         , Ryd         , Yl          , Yl          , Ryd         , Yl          , Yl          , Ryd         , Xu          , Wwf         , Xu          , Ww          , Ww          , Ww          , Ww          , Xu          , Xu          , Xu          , Xu          , Ai          , Wo          , Ai          , Ai          , Wo          , Ai          , Wo          , Wo          , Ai          , Wo          , Ai          , Wo          , Wo          , Ai          , Wo          
Ryd         , Ryd         , Yl          , Yl          , Ryd         , Ryd         , Ryd         , Yl          , Yl^Xp       , Yl          , Ryd         , Ryd         , Ryd         , Ryd         , Yl          , Yl^Xp       , Wwf         , Xu          , Ww          , Xu          , Ww          , Xu          , Xu          , Ww          , Xu          , Xu          , Xu          , Xu          , Xu          , Ai          , Wo          , Wo          , Ai          , Wo          , Ai          , Wo          , Wo          , Ai          , Wo          , Ai          , Wo          , Wo          
Ryd         , Yl          , Ryd         , Ryd         , Ryd         , Ryd         , Yl          , Yl          , Ryd         , Yl          , Yl          , Ryd         , Yl          , Yl          , Ryd         , Ryd         , Wwf         , Wwf         , Xu          , Xu          , Xu          , Ww          , Ww          , Xu          , Xu          , Xu          , Xu          , Xu          , Xu          , Wo          , Wo          , Wo          , Ai          , Ai          , Wo          , Wo          , Ai          , Wo          , Ai          , Ai          , Ai          , Wo          
