Xu, Xu, Xu, Xu, Xu, Xu, Xu, Xu, Xu, Xu, Xu, Xu, Xu, Xu, Xu, Xu, Xu, Xu, Xu, Xu, Xu, Xos, Xos, Xos, Xor, Urb, Urb, Urb, Urb, Urb^Es, Urb, Xos, Uu, Uu, Xos, Xos, Xos, Xos, Xos, Xos, Xos, Xu, Xu, Xu, Xu, Xu, Xu, Xu, Xu, Xu, Xu, Xu, Xu, Xu, Xu, Xu, Xu, Xu
Xu, Xu, Xu, Xu, Xu, Xu, Xu, Xu, Xu, Xu, Xu, Xu, Xu, Xu, Xu, Xu, Xu, Xu, Xu, Xu, Xu, Xu, Xu, Xos, Xos, Xor, Xor, Urb^Ii, Urb^Es, Urb, Urb^Ii, Urb^Es, Urb^Es, Xor^Efs, Xos^Efs, Xos, Xos, Xos, Yhr^Xp, Xos, Xos, Xos, Xu, Xu, Xu, Xu, Xu, Xu, Xu, Xu, Xu, Xu, Xu, Xu, Xu, Xu, Xu, Xu
Xu, Xu, Xu, Xu, Xu, Xu, Xu, Xu, Xu, Xu, Xu, Xu, Xu, Xu, Xu, Xu, Xu, Xu, Xu, Xu, Xu, Xu, Xu, Xos, Xos, Xos, Xor^Xzm/, Xor, Uu^Es, Urb^Es, Urb^Dr, Urb^Es, Urb^Ii, Urb, Urb, Xos^Xzm\, Uu^Es, Uu, Xos, Xos, Xos, Xos, Xos, Xu, Xu, Xu, Xu, Xu, Xu, Xu, Xu, Xu, Xu, Xu, Xu, Xu, Xu, Xu
Xu, Xu, Xu, Xu, Xu, Xu, Xu, Xu, Xu, Xu, Xu, Xu, Xu, Xu, Xu, Xu, Xu, Xu, Xu, Xu, Xu, Xu, Xu, Xu, Xos, Xos, Yhr^Xp, Uu, Xos, Xos, Xor, Urb^Es, Urb^Ii, Urb^Ii, Urb^Es, Urb^Dr, Urb^Es, Xos^Efs, Xor^Efs, Xos, Xos, Xos, Xos, Xos, Xos, Xu, Xu, Xu, Xu, Xu, Xu, Xu, Xu, Xu, Xu, Xu, Xu, Xu
Xu, Xu, Xu, Xu, Xu, Xu, Xu, Xu, Xu, Xu, Xu, Xu, Xu, Xu, Xu, Xu, Xu, Xu, Xu, Xu, Xu, Xu, Xu, Xu, Xos, Xos, Xos, Xos, Xos, Xos, Xor, Xor, Uu, Urb, Urb^Es, Urb, Urb^Es, Urb, Urb^Ii, Xor, Xur, Xos, Xuc, Xos, Xos, Xos, Xu, Xu, Xu, Xu, Xu, Xu, Xu, Xu, Xu, Xu, Xu, Xu
Xu, Xu, Xu, Xu, Xu, Xu, Xu, Xu, Xu, Xu, Xu, Xu, Xu, Xu, Xu, Xu, Xu, Xu, Xu, Xu, Xu, Xu, Xu, Xu, Xu, Xos, Xos, Xos, Xos, Xos^Xzm/, Yhr^Xp, Uu, Xos, Xos, Xos, Urb^Dr, Urb^Edt, Urb^Es, Urb^Edt, Urb, Uu^Ii, Uh^Ii, Uh, Xu, Xos, Xos, Xos, Xu, Xu, Xu, Xu, Xu, Xu, Xu, Xu, Xu, Xu, Xu
Xu, Xu, Xu, Xu, Xu, Xu, Xu, Xu, Xu, Xu, Xu, Xu, Xu, Xu, Xu, Xu, Xu, Xu, Xu, Xu, Xu, Xu, Xu, Xu, Xu, Xu, Xu, Xos, Xos, Xos, Xos, Xos, Xos, Xos, Xos, Xos, Uh^Ii, Urb^Edt, Urb^Es, Uh, Uu, Uh, Ql, Uh, Xos, Xos, Xos, Xu, Xu, Xu, Xu, Xu, Xu, Xu, Xu, Xu, Xu, Xu
Xu, Xu, Xu, Xu, Xu, Xu, Xu, Xu, Xu, Xu, Xu, Xu, Xu, Xu, Xu, Xu, Xu, Xu, Xu, Xu, Xu, Xu, Xu, Xu, Xu, Xu, Xu, Xu, Xos, Xos, Xos, Xos, Xos, Xos, Xu, Uh, Uu^Ii, Urb^Edt, Urb^Es, Urb, Urb^Ii, Xur, Uh, Xuc, Xu, Xor, Xor, Xos, Xu, Xu, Xu, Xu, Xu, Xu, Xu, Xu, Xu, Xu
Xu, Xu, Xu, Xu, Xu, Xu, Xu, Xu, Xu, Xu, Xu, Xu, Xu, Xu, Xu, Xu, Xu, Xu, Xu, Xu, Xu, Xu, Xu, Xu, Xu, Xu, Xu, Xu, Xos, Xos, Xor, Xos, Xu, Xu, Xu, Xur, Uh, Urb^Dr, Urb, Urb^Ii, Urb^Ii, Uh, Uh^Ii, Xuc, Xur, Uh, Uh, Xur, Xur, Xu, Xu, Xu, Xu, Xu, Xu, Xu, Xu, Xu
Xu, Xu, Xu, Xu, Xu, Xu, Xu, Xu, Xu, Xu, Xu, Xu, Xu, Xu, Xu, Xu, Xu, Xu, Ql, Xu, Ql, Xu, Xu, Xu, Xu, Xu, Xu, Xu, Xos, Xor, Ql, Ql, Ql^Xo, Xu, Ql, Xur, Qlf, Uu, Cud, Urb^Ii, Urb, Uu^Ii, Uh, Uh, Uh, Uh, Ql, Uh, Xuc, Xu, Xu, Xu, Xu, Xu, Xu, Xu, Xu, Xu
Xu, Xu, Xu, Xu, Xu, Xu, Xu, Xu, Xu, Xu, Xu, Xu, Xu, Xu, Xu, Xu, Ql, Ql, Ql, Ql, Ql, Xu, Xur, Xu, Xu, Xu, Xu, Xu, Xu, Ql, Ql, Ql^Xo, Ql, Ql, Ql, Qlf, Xur, Qlf, Urb, 4 Kud, Cud, Uu, Xu, Xu, Xu, Ql, Ql, Uh, Uh, Xuc, Xu, Xu, Xu, Xu, Xu, Xu, Xu, Xu
Xu, Xu, Xu, Xu, Xu, Xu, Xu, Xu, Xu, Xu, Xu, Xu, Xu, Xu, Xu, Xu, Xu, Ql, Ql, Ql, Ql^Xo, Ql^Xo, Ql, Xur, Xos, Xu, Xu, Xu, Xu, Xu, Ql, Ql^Xo, Ql, Ql, Ql, Ql, Uu, Qlf, Urb^Es, Urb, Ql, Xur, Xu, Xu, Xu, Xu, Xu, Ql, Ql, Xur, Xu, Xu, Xu, Xu, Xu, Xu, Xu, Xu
Xu, Xu, Xu, Xu, Xu, Xu, Xu, Xu, Xu, Xu, Xu, Xu, Xu, Xu, Xu, Ql, Ql, Ql, Ql^Xo, Ql^Xo, Ql, Ql, Urb, Xor, Xor, Xos, Xos, Xu, Xu, Xu, Xu, Xu, Xu, Ql, Ql, Uu, Urb^Ii, Urb^Edt, Ql, Ql, Ql, Xu, Ql, Xu, Xu, Xu, Xu, Xu, Ql^Xo, Ql^Xo, Xu, Xu, Xu, Xu, Xu, Xu, Xu, Xu
Xu, Xu, Xu, Xu, Xu, Xu, Xu, Xu, Xu, Xu, Xu, Xu, Xu, Xu, Xu, Xu, Xu, Xu, Xu, Ql, Uh, Urb, Uu, Urb, Urb, Xos, Xor, Xos, Xos, Xu, Xuc, Xuc, Urb, Urb, Urb, Urb, Urb, Urb^Edt, Xu, Ql, Ql, Ql, Ql, Ql, Ql, Ql, Xu, Xu, Xu, Ql, Xu, Xu, Xu, Xu, Xu, Xu, Xu, Xu
Xu, Xu, Xu, Xu, Xu, Xu, Xu, Xu, Xu, Xu, Xu, Xu, Xu, Xu, Xu, Xu, Xu, Xu, Xos, Xos, Xos, Uh, Uu, Uu^Ii, Uh, Uh, Uh, Xor, Xor, Xos, Xor, Uu^Ii, Uu, Urb^Es, Uu, Uu^Ii, Ql, Xu, Xur, Xur, Xur, Ql, Ql, Cud, Ql, Ql, Ql^Xo, Xu, Xu, Xu, Xu, Xu, Xu, Xu, Xu, Xu, Xu, Xu
Xu, Xu, Xu, Xu, Xu, Xu, Xu, Xu, Xu, Xu, Xu, Xu, Xu, Xu, Xu, Xu, Xu, Xu, Xu, Xos, Xos, Xos, Xos, Uu, Uh, Urb, Urb, Urb, Urb, Xos, Qlf, Urb, Uu, Urb, Qlf, Ql, Xu, Xur, Xur, Uh, Uu, Ql, Ql, Ql, Qlf, Ql^Xo, Ql, Xu, Xu, Xu, Xu, Xu, Xu, Xu, Xu, Xu, Xu, Xu
Xu, Xu, Xu, Xu, Xu, Xu, Xu, Xu, Xu, Xu, Xu, Xu, Xu, Xu, Xu, Xu, Xu, Xu, Xu, Xu, Xu, Xos, Xos, Xos, Xos, Uh, Urb, Urb, Urb, Urb, Urb^Es, Urb, Uh, Qlf, Xor, Xu, Uh, Xur, Ql, Xur, Uu^Edt, Uu^Edt, Uu, Uu, Qlf, Qlf^Xo, Ql, Ql, Xu, Xu, Xu, Xu, Xu, Xu, Xu, Xu, Xu, Xu
Xu, Xu, Xu, Xu, Xu, Xu, Xu, Xu, Xu, Xu, Xu, Xu, Xu, Xu, Xu, Xu, Xu, Xu, Xu, Xu, Xu, Xu, Xu, Xos, Xos, Xos, Uh, Uh, Urb, Uh, Urb, Urb, Qlf, Urb, Ql, Ql, Ql, Ql, Ql, Uu, Uu^Dr, Rb^Edt, Xuc, Xu, Xu, Xu, Xu, Ql, Xu, Xu, Xu, Xu, Xu, Xu, Xu, Xu, Xu, Xu
Xu, Xu, Xu, Xu, Xu, Xu, Xu, Xu, Xos, Xos, Xos, Xu, Xu, Xu, Xu, Xu, Xu, Xu, Qlf, Xu, Xu, Xu, Xu, Xu, Xu, Xu, Xur, Urb, Uh, Urb, Xu, Uu, Uh, Uu, Rb^Es, Ql, Ql, Ql, Uh, Uh, Uh, Uh, Uh, Xu, Xu, Xu, Xos, Xos, Xos, Xos, Xos, Xu, Xu, Xu, Xu, Xu, Xu, Xu
Xu, Xu, Xu, Xu, Xu, Xu, Xos, Xos, Xos, Xos, Xuc, Xuc, Xu, Xu, Xu, Xu, Qlf, Qlf, Qlf, Qlf, Qlf, Qlf, Xu, Xu, Xu, Xu, Xu, Uh, Xu, Xu, Xu, Xu, Xu, Uu, Rb^Es, Uu^Dr, Uh, Xu, Xuc, Uh, Rb^Edt, Xur, Uh, Xur, Xu, Xos, Xos, Xos, Xos, Xos, Xos, Xu, Xu, Xu, Xu, Xu, Xu, Xu
Xu, Xu, Xu, Xu, Xos, Xos, Xot, Xot, Yhl, Yhl, Yhl^Yva, Uh, Xu, Xu, Xu, Xu, Qlf^Xo, Qlf^Xo, Qlf^Xo, Qlf^Xo, Qlf^Xo, Qlf, Xu, Xu, Xu, Xu, Xu, Xu, Xu, Xu, Xu, Xu, Xu, Xu, Uh, Rb^Es, Ur, Xuc, Uu^Edt, Uu^Edt, Uu^Edt, Uu, Qlf, Qlf, Yhl^Xp, Xu, Qlf, Xos, Xos, Xos, Xu, Xu, Xu, Xu, Xu, Xu, Xu, Xu
Xu, Xu, Xos, Xos, Xor, Xor, Qlf, Qlf, Qlf, Yhl^Xp, Yhl^Yva, Xuc, Xu, Xu, Xos, Xu, Xos, Qlf, Ql, Qlf, Qlf, Xu, Xu, Xu, Xu, Xu, Uh, Xu, Yhl, Xu, Xu, Xu, Qlf, Qlf, Uu, Uu, Ur^Es, Ur^Edt, Uu^Edt, Ur^Edt, Yhl, Yhl, Yhl^Edt, Qlf, Yhl, Yhl, Qlf, Xu, Xu, Xu, Xu, Xu, Xu, Xu, Xu, Xu, Xu, Xu
Xu, Xu, Xu, Xos, Xu, Qlf, Qlf, Qlf, Qlf, Yhl, Xu, Xuc, Xu, Xos, Xot, Xos, Xos, Xos, Xos, Ql, Ql, Ql, Ql, Xu, Ql, Xu, Ql, Yhl, Yhl, Yhl, Xu, Xu, Xur, Qlf, Qlf, Rb, Uu, Uu, Xu, Xu, Qlf, Yhl, Qlf, Qlf, Yhl^Xp, Qlf, Qlf, Yhl^Yva, Qlf, Xu, Xu, Xu, Xu, Xu, Xu, Xu, Xu, Xu
Xu, Xu, Xu, Xu, Xu, Xu, Qlf, Yhl, Yhl^Xp, Yhl, Xuc, Xu, Xur, Qlf, Qlf, Xos, Xos, Xos, Xos, Xos, Xos, Ql, Ql, Ql, Xu, Ql, Xu, Ql, Ql, Uu, Uh, Xur, Yhl^Yva, Yhl, Qlf, Uu^Ii, Uu, Ur^Es, Xur, Xu, Xu, Qlf, Xu, Yhl, Yhl, Yhl^Xp, Qlf, Qlf, Qlf^Xo, Qlf^Xo, Qlf, Xu, Xu, Xu, Xu, Xu, Xu, Xu
Xu, Xu, Xu, Xu, Xu, Xu, Xu, Yhl, Yhl, Yhl, Yhl^Xp, Xur, Uu, Qlf, Uu^Ii, Qlf, Xu, Xos, Xor, Xot, Xot, Xos, Xos, Ql, Qlf, Xu, Xu, Xu, Ql, Uh, Uh, Uh, Yhl, Yhl^Xp, Qlf, Uu, Uh, Ur^Em, Ur, Cud, Cud, Xur, Xur, Xu, Xu, Qlf, Qlf^Xo, Qlf^Xo, Qlf, Qlf, Xu, Xu, Xu, Xu, Xu, Xu, Xu, Xu
Xu, Xu, Xu, Xu, Xu, Xos, Xos, Xu, Yhl, Xu, Uu, Uu, Uu, Qlf, Urb, Qlf, Xu, Xuc, Urb, Yhl^Xp, Xos, Xos, Xos, Ql, Qlf, Qlf, Xur, Xu, Xu, Ql, Ql, Ql, Ql, Ql, Ql, Uh, Ur, Uu^Es, Uu, Uu^Eb, Uu, Cud, Xur, Xu, Xu, Xu, Xu, Qlf, Xu, Xu, Xu, Xu, Xu, Xu, Xu, Xu, Xu, Xu
Xu, Xu, Xu, Xu, Xu, Xos, Xos, Xos, Xu, Yhl^Xp, Uu, Qlf, Urb, Urb, Urb^Edt, Qlf, Urb, Urb^Edt, Urb^Edt, Xor^Xzm/, Yhl^Xp, Xos, Xor, Qlf, Yhl, Qlf, Yhl, Uh, Uh, Yhl, Yhl, Ql, Ql, Ql, Yhl, Ur, Uu, Uu, Uh, Uh, Rb, Cud, Xu, Xu, Xu, Xu, Xu, Xu, Xu, Xu, Xu, Xu, Xu, Xu, Xu, Xu, Xu, Xu
Xu, Xu, Xu, Xu, Xu, Xos, Xos, Xos, Xuc, Xuc, Urb^Es, Urb, Qlf, Urb^Edt, Urb^Edt, Urb, Urb, Urb^Edt, Urb, Urb, Xor^Efs, Xor, Uu, Yhl, Uu, Yhl, Uh, Yhl, Qlf, Yhl, Yhr, Yhr^Xp, Uu, Yhr, Yhl^Es, Yhl^Xp, Ql, Uu^Ii, Uu, Rb, Xur, Xu, Xu, Xu, Xos, Xu, Xu, Xu, Xu, Xu, Xu, Xu, Xu, Xu, Xu, Xu, Xu, Xu
Xu, Xu, Xu, Xu, Xu, Xos, Xos^Xzm/, Xos, Urb, Urb, Urb, Urb^Es, Urb, Urb, Urb^Edt, Urb, Qlf, Qlf, Urb, Urb^Edt, Yhl^Xp, Uu^Pr\, Xos, Uu, Yhl, Yhl, Yhl, Yhl^Xp, Yhl, Qlf, Yhr, Uh, Uu, Yhr, Uh, Qlf, Ql, Ql, Uh, Uh, Uh, Xuc, Xuc, Xos, Xos, Xu, Xu, Xu, Xu, Xu, Xu, Xu, Xu, Xu, Xu, Xu, Xu, Xu
Xu, Xu, Xu, Xu, Ql, Xu, Ql, Urb, Yhr^Xp, Yhr^Edt, Urb, Urb^Es, Urb^Edt, Urb, Urb, Urb, Urb, Qlf, Urb, Urb, Xor, Xos, Xor, Xor, Qlf, Yhl, Yhl, Yhl^Es, Yhr^Es, Yhr, Yhl^Xp, Yhr^Dr, Yhl, Xur, Xu, Ql, Ql, Ql, Ur, Uh, Uh, Uh, Ur, Xos, Xos, Xu, Xoa, Xu, Xu, Xu, Xu, Xu, Xu, Xu, Xu, Xu, Xu, Xu
Ql, Ql, Ql, Ql, Ql, Ql, Yhr^Xp, Yhr, Uu^Ii, Uu, Yhr, Yhr^Xp, Xot, Xos, Xos, Urb, Uu, Qlf, Qlf, Uu, Yhl^Xp, Xor^Efs, Yhl^Pr\, Uu, Qlf, Yhl, Uh, Yhr, Yhl^Es, Yhl, Uu^Ii, Yhr, Qlf, Qlf, Ql, Ql, Ql, Uh, Uh, Uh, Uh, Xu, Xu, Xos, Ur, Xu, Isa^Es, Xuc, Xoa^Efs, Xu, Xu, Xu, Xu, Xu, Xu, Xu, Xu, Xu
Ql, Ql, Qlf, Qlf, Qlf, Xur, Yhr, Yhr, Urb, Uu, Yhr^Xp, Yhr, Ql, Xos, Xos, Xos, Yhl^Xp, Uu, Uu, Uu, Uu, Yhl, Xuc, Xu, Xu, Uh, Uh, Uh, Yhl^Yva, Yhl, Ur, Uh, Uh, Xur, Xur, Ql, Ql, Uu, Ur, Uu, Xu, Xu, Xu, Xu, Xu, Isa^Em, Isa, Isa, Isa^Edt, Xoa, Xuc, Xu, Xu, Xu, Qxv, Xu, Xu, Xu
Ql, Qlf, Qlf, Qlf, Qlf, Qlf, Qlf, Urb, Qlf, Qlf, Yhr, Yhr^Xp, Ql, Xu, Xos, Xos, Xos, Xos, Uu, Ur^Em, Ur, Uh, Xuc, Xu, Ql, Ql, Ql, Ql, Ql, Uh, Ur, Uh, Yhl, Xur, Xur, Ql, Ql, Ql, Ql, Yhl^Xp, Xu, Xu, Xu, Xu, Xu, Xuc, Uu^Tf, Isa, Isa^Edt, Isa^Edt, Isa^Es, Xuc, Xu, Qxv, Qxv, Qxv, Xu, Xu
Xu, Xu, Xu, Xu, Qlf, Qlf, Urb, Urb, Urb, Qlf, Qlf, Qlf, Ql, Ql, Xos, Xos, Xos, Xos, Uh, Ur, Ur, Xuc, Xu, Xu, Ql^Xo, Ql, Ql^Xo, Ql, Ql^Xo, Ql, Xu, Uu, Yhl, Yhl, Uh, Qlf, Ql, Ql, Ql, Qlf, Qlf, Xu, Qlf, Xu, Xu, Xuc, Tb^Tf, Xoa, Isa^Es, Isa, Isa^Es, Xuc, Uh, Qxv^Xo, Qxv^Xo, Qxv, Xu, Xu
Xu, Xu, Xu, Xu, Qlf, Urb, Urb, Urb, Qlf, Qlf, Xu, Qlf, Ql, Ql, Xu, Xu, Xu, Xos, Ql, Uu, Uu, Xur, Xu, Xu, Ql, Ql^Xo, Ql, Ql^Xo, Ql, Ql^Xo, Xu, Xu, Xur, Uh, Uu^Em, Uu, Ur, Ql, Ql, Qlf, Qlf, Qlf^Xo, Qlf, Xu, Xu, Xu, Uh, Uu^Eb, Isa^Edt, Isa, Tb^Tf, Isa^Em, Uu^Em, Qxv, Uh, Xu, Xu, Xu
Xu, Xu, Xu, Xos, Xos, Urb, 2 Urb, Urb, Xos, Xu, Xu, Xu, Xu, Ql, Ql^Xo, Xu, Xu, Ql, Ql, Ql, Ql, Xur, Xu, Xu, Xu, Ql, Xu, Ql, Xu, Xu, Xur, Xu, Uh, Tb^Tf, Uu, Ur, Uu, Ql, Xu, Ql, Ql^Xo, Xu, Xu, Xu, Xu, Xuc, Xuc, Isa^Edt, Isa, Qxv, Uu^Emf, Tb^Tf, Yhs^Emf, Uh, Xuc, Xu, Xu, Xu
Xu, Xu, Xu, Xos, Xos, Urb, Urb, Urb, Xos, Xos, Xu, Xu, Xu, Ql^Xo, Ql, Xu, Ql^Xo, Ql, Ql, Ql, Ql, Ql, Xu, Xu, Xu, Xu, Xu, Xu, Xu, Xu, Xu, Uh, Ql, Uu, Ur, Uh, Uh, Xu, Xu, Ql^Xo, Ql, Xu, Qxv, Qxv, Xu, Xu, Isa, Isa^Em, Uu^Emf, Qxv, Qxv, Uh, Xu, Uh, Xu, Xu, Xu, Xu
Xu, Xu, Xu, Xos, Xos^Zok, Urb, Urb, Urb, Xos^Zok, Xos, Xu, Xu, Xu, Xu, Xu, Ql, Xu, Ql, Ql, Ql, Ql, Ql, Ql, Xu, Xu, Xu, Xu, Xu, Xu, Xu, Xu, Xur, Uu, Uu, Ql, Ql, Xur, Uh, Xu, Xu, Qxv, Qxv, Qxv, Qxv, Qxv, Xu, Isa^Edt, Isa^Em, Uu^Ii, Xu, Xu, Xu, Xu, Xu, Xu, Xu, Xu, Xu
Xu, Xu, Xu, Xos^Zok, Xos^Zok, Urb^Zok, Urb^Zok, Urb^Zok, Xos^Zok, Xos^Zok, Xu, Xu, Xu, Xu, Xu, Xu, Xu, Xu, Xu, Ql, Ql, Ql, Ql, Ql^Xo, Ql, Xu, Xur, Xur, Uh, Xu, Xu, Uu, Ql, Ur, Uu, Ql, Uh, Xur, Xu, Xu, Xu, Qxv, Qxv^Xo, Qxv^Xo, Qxv^Xo, Qxv^Xo, Uu^Edt, Isa^Edt, Isa^Tf, Tb^Tf, Xuc^Efs, Xu, Xoa, Xu, Xu, Xu, Xu, Xu
Xu, Xu, Xu, Xos^Zok, Xos^Zok, Xos^Zok, Xos^Zok, Xos^Zok, Xos^Zok, Xos^Zok, Xu, Xu, Xu, Xu, Xu, Xu, Xu^Zok, Xu, Xu, Xu, Xu, Ql, Xu, Ql^Xo, Xu, Ql, Uu, Uu, Uu, Xur, Xur, Xu, Xur, Uu, Uu^Ii, Uu, Uu^Tf, Xu, Xu, Xu, Qxv, Qxv, Xu, Uu, Uh, Uh, Uh, Isa^Edt, Isa, Isa, Isa, Tb^Tf, Uh, Xoa^Xzm\, Xoa, Xu, Xu, Xu
Xu, Xu, Xu, Xos^Zok, Xos^Zok, Xos^Zok, Xos^Zok, Xos^Zok, Xos^Zok, Xos^Zok, Xu, Xu, Xu, Xu, Xu, Xu, Xu^Zok, Xu^Zok, Xu^Zok, Xu, Xu^Zok, Xu, Xu, Xu, Xu, Uu, Uu, Uu^Ii, Uu, Uu, Xur, Xu, Xu, Uu, Uu, Ql, Ql, Xur, Xu, Xu, Qxv, Xu, Xu, Xu, Tb^Tf, Yhs, Xu, Xuc, Xuc, Isa^Edt, Isa, Isa^Edt, Isa, Uh, Xuc, Xoa, Xu^Zok, Xu
Xu, Xu, Xu, Xu, Xu, Xos^Zok, Xos^Zok, Xos^Zok, Xu, Xu, Xu, Xu, Xu, Xu, Xu^Zok, Xu^Zok, Urb^Zok, Xu^Zok, Xu^Zok, Xu^Zok, Qxua^Zok, Xu^Zok, Xu^Zok, Xu^Zok, Xu^Zok, Xu, Xu, Uu, Xur, Uh, Xu, Xu, Xu, Xu, Xu, Ql, Xu, Xu, Xu, Xu, Xu, Xu, Xu, Xu, Xu, Xu, Xu, Xu, Xu, Uh, Tb^Tf, Isa, Isa, Isa, Isa^Zok, Xu^Zok, Xu^Zok, Xu^Zok
Xu, Xu, Xu, Xu, Xu, Xu, Xu, Xu, Xu, Xu, Xu, Xu, Xu, Xu^Zok, Urb^Zok, Urb^Zok, Urb^Zok, Urb^Zok, Urb^Zok, Qxua^Zok, Qxua^Zok, Qxua^Zok, Qxua^Zok, Qxua^Zok, Xos^Zok, Xu^Zok, Xu^Zok, Xu, Xu, Xu, Xu, Xu, Xu, Xu, Xu, Xu, Xu, Xu, Xu, Xu, Xu, Xu, Xu, Xu, Xu, Xu, Xu, Xu, Xoa, Uh, Uh, Tb^Tf, Xu^Zok, Isa^Zok, Isa^Zok, Isa^Zok, Isa^Zok, Xu^Zok
Xu, Xu, Xu, Xu, Xu, Xu, Xu, Xu, Xu, Xu, Xu, Xu, Xu, Xu^Zok, Qxua^Zok, Urb^Zok, Urb^Zok, Urb^Zok, Urb^Zok, Qxua^Zok, Qxua^Zok, Qxua^Zok, Qxua^Zok, Qxua^Zok, Qxua^Zok, Xu^Zok, Xu^Zok, Xu, Xu, Xu, Xu, Xu, Xu, Xu, Xu, Xu, Xu, Xu, Xu, Xu, Xu, Xu, Xu, Xu, Xu, Xu, Xu, Xu, Xu, Xoa, Xoa, Xu, Xu, Xu^Zok, Xu^Zok, Isa^Zok, Isa^Zok, Isa^Zok
Xu, Xu, Xu, Xu, Xu, Xu, Xu, Xu, Xu, Xu, Xu, Xu^Zok, Xu^Zok, Xu^Zok, Qxua^Zok, Qxua^Zok, Qxua^Zok, Urb^Zok, Urb^Zok, Urb^Zok, Urb^Zok, Qxua^Zok, Qxua, Qxua^Zok, Qxua^Zok, Qxua^Zok, Xu^Zok, Xu, Xu, Xu, Xu, Xu, Xu, Xu, Xu, Xu, Xu, Xu, Xu, Xu, Xu, Xu, Xu, Xu, Xu, Xu, Xu, Xu, Xu, Xu, Xu, Xu, Xu, Xu, Xu, Xu^Zok, Xu^Zok, Isa^Zok
Xu, Xu, Xos, Xu, Xos, Xu, Xu, Xu, Xu, Xu, Xu^Zok, Xu^Zok, Xu^Zok, Xu^Zok, Qxua^Zok, Qxua^Zok, Qxua^Zok, Qxua^Zok, Qxua^Zok, Urb^Zok, Urb, Urb, Aa, Qxua, Qxua, Qxua^Zok, Xu^Zok, Xu, Xu, Xu, Xu, Xu, Xu, Xu, Xu, Xu, Xu, Xu, Xu, Xu, Xu, Xu, Xu, Xu, Xu, Xu, Xu, Xu, Xu, Xu, Xu, Xu, Xu, Xu, Xu, Xu, Xu, Xu^Zok
Xos, Xos, Xos, Xos, Xos, Xos, Xos, Xu, Xu, Xu, Xu, Xu^Zok, Xu^Zok, Xu^Zok, Qxua^Zok, Qxua^Zok, Qxua^Zok, Qxua^Zok, Qxua, Qxua, Uu, Urb^Esa, Aa^Esa, Qxua, Qxua, Qxua^Zok, Xu, Xu, Xu, Xu, Xu, Xu, Xu, Xu, Xu, Xu, Xu, Xu, Xu, Xu, Xu, Xu, Xu, Xu, Xu, Xu, Xu, Xu, Xu, Xu, Xu, Xu, Xu, Xu, Xu, Xu, Xu, Xu
Xos, Xos, Yhl, Yhl, Xos, Xos, Xos, Xos, Xos, Xu, Xu, Xu^Zok, Xu^Zok, Xu^Zok, Qxua^Zok, Qxua^Zok, Qxua^Zok, Qxua^Zok, Aa, Qxua, Qxua, Urb^Esa, Urb^Esa, Xor, Qxua, Qxua, Qxua, Xu, Xu, Xu, Xos, Xos, Xos, Xu, Xu, Xu, Xu, Xu, Xu, Xu, Xu, Xu, Xu, Xu, Xu, Xu, Xu, Xu, Xu, Xu, Xu, Xu, Xu, Xu, Xu, Xu, Xu, Xu
Xos, Xos, Yhl, Yhl, Xos, Xos, Wog, Xos, Xos, Xos, Xu, Xu, Xu^Zok, Qxua^Zok, Qxua^Zok, Qxua^Zok, Qxua, Qxua, Aa, Qxua, Uu, Uu, Urb, Urb, Urb, Qxua, Qxua, Qxua, Xos, Xos, Xos, Xos, Xos, Xos, Xos, Xu, Xu, Xu, Xu, Xu, Xu, Xu, Xu, Xu, Xu, Xu, Xu, Xu, Xu, Xu, Xu, Xu, Xu, Xu, Xu, Xu, Xu, Xu
Xos, Xos, Yhl, Yhl, Xos, Xos, Xos, Wog, Xos, Xos, Xos, Xu, Xu, Xu^Zok, Xu, Qxua, Qxua, Aa^Esa, Aa, Uu, Uh, Aa, Urb, Uu, Urb^Esa, Qxua, Qxua, Qxua, Qxua, Xos, Xos, Xos, Xos, Xos, Xos, Xos, Xu, Xu, Xu, Xu, Xu, Xu, Xu, Xu, Xu, Xu, Xu, Xu, Xu, Xu, Xu, Xu, Xu, Xu, Xu, Xu, Xu, Xu
Xos, Xos, Yhl, Yhl, Xot, Xos, Xos, Wog^Xo, Wog, Xot, Xos, Xos, Xos, Xu, Xu, Qxua, Qxua, Qxua, Aa, Aa^Esa, Qxua, Xor, Urb^Esa, Aa, Aa, Qxua, Qxua, Qxua, Qxua, Qxua, Qxua, Xos, Xos, Xos, Xu, Xu, Xu, Xu, Xu, Xu, Xu, Xu, Xu, Xu, Xu, Xu, Xu, Xu, Xu, Xu, Xu, Xu, Xu, Xu, Xu, Xu, Xu, Xu
Xos, Xos, Yhl^Xo, Yhl^Xo, Yhl, Xos, Xos, Xos, Xos, Wog, Wog, Xot, Xos, Xu, Xu, Xu, Aa, Qxua, Uu^Esa, Aa^Esa, Qxua, Uu, Aa, Aa^Esa, Aa, Qxua, Qxua, Qxua, Qxua, Xu, Qxua, Qxua, Qxua, Xu, Xu, Xu, Xu, Xu, Xu, Xu, Xu, Xu, Xu, Xu, Xu, Xu, Xu, Xu, Xu, Xu, Xu, Xu, Xu, Xu, Xu, Xu, Xu, Xu
Xos, Xos, Xor, Yhl, Yhl, Xor, Xor, Xot, Wwg, Wog, Wwg, Wog, Wwf, Xu, Xu, Xu, Xur, Aa^Esa, Uu^Esa, Uu, Uh, Uh, Uu, Aa^Esa, Urb^Esa, Aa, Uh, Uu, Qxua, Qxua, Qxua, Qxua, Qxua, Xu, Xu, Xu, Xu, Xu, Xu, Xu, Xu, Xu, Xu, Xu, Xu, Xu, Xu, Xu, Xu, Xu, Xu, Xu, Xu, Xu, Xu, Xu, Xu, Xu
Xos, Xos, Yhl^Ebur, Yhl^Yva, Urb, Uu, Uu, Wwg, Yhl, Wwf, Uh, Wwg, Wwf, Xur, Yhl^Xp, Xur, Aa^Esa, Aa^Esa, Urb, Uu, Uu, Uu, Yhl, Urb^Esa, Aa, Xos, Aa, Uu, Urb^Esa, Aa, Xu, Xu, Xos, Xu, Xu, Xu, Xu, Xu, Xu, Xu, Xu, Xu, Xu, Xu, Xu, Xu, Xu, Xu, Xu, Xu, Xu, Xu, Xu, Xu, Xu, Xu, Xu, Xu
Xor, Uu^Ebur, Uh, Uu, Urb, Urb, Uu, Uh, Uh, Uh, Uu, Uh, Yhl, Uu, Yhl, Yhl, Yhl, Urb^Esa, Yhl, Yhl, Urb, Urb^Esa, Yhl, Yhl^Xp, Qxua, Urb, Aa, Uu, Aa^Esa, Xu, Xu, Xu, Xos, Xos, Xu, Xu, Xu, Xu, Xu, Xu, Xu, Xu, Xu, Xu, Xu, Xu, Xu, Xu, Xu, Xu, Xu, Xu, Xu, Xu, Xu, Xu, Xu, Xu
Uu, Uu, Yhl, Urb, Urb, Uh, Uu, Xu, Urb, Uh, Urb, Urb, Yhl, Yhl, Yhl, Yhl, Uh, Yhl^Xp, Uu, Uu^Esa, Xur, Uu, Xu, Aa^Esa, Qxua, Qxua, Qxua, Qxu, Aa, Aa, Xu, Xu, Xu, Xos, Xu, Xu, Xu, Xu, Xu, Xu, Xu, Xu, Xu, Xu, Xu, Xu, Xu, Xu, Xu, Xu, Xu, Xu, Xu, Xu, Xu, Xu, Xu, Xu
Uh, Uh, Uu, Yhl^Xp, Urb, Uh, Urb, Urb, Urb, Urb, Yhl, Urb, Yhl, Yhl, Uu, Xu, Uu, Yhl, Yhl, Uh, Xu, Xu, Xu, Xu, Qxua, Qxua, Aa^Esa, Qxua, Qxua, Aa, Xu, Xu, Xu, Xu, Xu, Xu, Xu, Xu, Xu, Xu, Xu, Xu, Xu, Xu, Xu, Xu, Xu, Xu, Xu, Xu, Xu, Xu, Xu, Xu, Xu, Xu, Xu, Xu
Uu, Uu, Urb, Urb, Urb, Urb, Yhl^Xp, Yhl, Urb, Yhl, Yhl, Uu, Yhl, Yhl^Xp, Uh, Urb, Uu, Yhl, Xur, Xu, Xu, Xu, Xu, Xu, Qxua, Qxua, Aa, Aa, Qxua, Qxua, Xu, Xu, Xu, Xu, Xu, Xu, Xu, Xu, Xu, Xu, Xu, Xu, Xu, Xu, Xu, Xu, Xu, Xu, Xu, Xu, Xu, Xu, Xu, Xu, Xu, Xu, Xu, Xu
Yhl, Uu, Yhl, Urb, Urb, Urb, Urb, Yhl, 1 Urb, Urb, Yhl, Yhl, Urb, Uu, Uu, Uu, Uu, Xur, Xu, Xur, Wog, Uh, Xu, Xu, Xu, Xu, Xu, Xu, Qxua, Qxua, Qxua^Xo, Xu, Xu, Xu, Xu, Xu, Xu, Xu, Xu, Xu, Xu, Xu, Xu, Xu, Xu, Xu, Xu, Xu, Xu, Xu, Xu, Xu, Xu, Xu, Xu, Xu, Xu, Xu
Yhl, Yhl, Yhl^Xp, Yhl, Uu, Urb, Urb, Urb, Yhl^Xp, Urb, Urb, Urb, Urb, Uh, Uu, Uu, Uh, Uh, Wog, Wog, Wog, Xu, Xu, Xu, Xu, Xu, Xu, Xu, Xu, Qxua^Xo, Qxua, Qxua, Xu, Xu, Xu, Xu, Xu, Xu, Xu, Xu, Xu, Xu, Xu, Xu, Xu, Xu, Xu, Xu, Xu, Xu, Xu, Xu, Xu, Xu, Xu, Xu, Xu, Xu
Xu, Yhl^Yva, Uu, Yhl, Uu, Urb, Yhl, Urb, Urb, Urb, Urb, Urb, Yhl^Yva, Yhl, Xu, Xu, Xu, Wog, Wog, Wog, Xu, Xu, Xu, Xu, Xu, Xu, Xu, Xu, Xu, Xu, Xu, Xu, Xu, Xu, Xu, Xu, Xu, Xu, Xu, Xu, Xu, Xu, Xu, Xu, Xu, Xu, Xu, Xu, Xu, Xu, Xu, Xu, Xu, Xu, Xu, Xu, Xu, Xu
Xu, Xu, Xu, Uu, Urb, Urb, Yhl, Yhl, Yhl^Xp, Yhl^Xp, Yhl, Yhl, Xu, Xu, Xu, Xu, Xu, Wog, Wog, Wog, Wog^Xo, Xu, Xu, Xu, Xu, Xu, Xu, Xu, Xu, Xu, Xu, Xu, Xu, Xu, Xu, Xu, Xu, Xu, Xu, Xu, Xu, Xu, Xu, Xu, Xu, Xu, Xu, Xu, Xu, Xu, Xu, Xu, Xu, Xu, Xu, Xu, Xu, Xu
Xu, Xu, Xos, Urb, Urb, Urb, Uu, Yhl, Yhl, Yhl^Yva, Xu, Xu, Xu, Xu, Xu, Xu, Xu, Xu, Wog^Xo, Wog^Xo, Wog, Wog, Xu, Xu, Xu, Xu, Xu, Xu, Xu, Xu, Xu, Xu, Xu, Xu, Xu, Xu, Xu, Xu, Xu, Xu, Xu, Xu, Xu, Xu, Xu, Xu, Xu, Xu, Xu, Xu, Xu, Xu, Xu, Xu, Xu, Xu, Xu, Xu
Xu, Xu, Xos, Xos, Urb^Xo, Urb, Urb^Xo, Yhl^Xp, Xos, Xos, Xos, Xu, Xu, Xu, Xu, Xu, Xu, Xu, Wog, Wog, Wog, Wog, Xu, Xu, Xu, Xu, Xu, Xu, Xu, Xu, Xu, Xu, Xu, Xu, Xu, Xu, Xu, Xu, Xu, Xu, Xu, Xu, Xu, Xu, Xu, Xu, Xu, Xu, Xu, Xu, Xu, Xu, Xu, Xu, Xu, Xu, Xu, Xu
Xu, Xu, Xos, Xos, Yhl, Urb^Xo, Urb, Xor, Xos, Xos, Xos, Xos, Xos, Xu, Xu, Xu, Xu, Xu, Xu, Wog, Xu, Xu, Xu, Xu, Xu, Xu, Xu, Xu, Xu, Xu, Xu, Xu, Xu, Xu, Xu, Xu, Xu, Xu, Xu, Xu, Xu, Xu, Xu, Xu, Xu, Xu, Xu, Xu, Xu, Xu, Xu, Xu, Xu, Xu, Xu, Xu, Xu, Xu
Xu, Xu, Xos, Xor, Yhl, Urb, Urb, Xor, Xot, Xos, Xos, Xos, Xos, Xos, Xos, Xu, Xu, Xu, Xu, Xu, Xu, Xu, Xu, Xu, Xu, Xu, Xu, Xu, Xu, Xu, Xu, Xu, Xu, Xu, Xu, Xu, Xu, Xu, Xu, Xu, Xu, Xu, Xu, Xu, Xu, Xu, Xu, Xu, Xu, Xu, Xu, Xu, Xu, Xu, Xu, Xu, Xu, Xu
Xu, Xu, Xos, Xor, Xor, Urb, Urb, Urb, Urb, Xos, Xos, Xos, Xos, Xos, Xos, Xos, Xos, Xu, Xu, Xu, Xu, Xu, Xu, Xu, Xu, Xu, Xu, Xu, Xu, Xu, Xu, Xu, Xu, Xu, Xu, Xu, Xu, Xu, Xu, Xu, Xu, Xu, Xu, Xu, Xu, Xu, Xu, Xu, Xu, Xu, Xu, Xu, Xu, Xu, Xu, Xu, Xu, Xu
