border_size=1
usage=map

Qxu         , Qxu         , Qxu         , Qxu         , Dd          , Dd^Dr       , Hd          , Dd^Dc       , Dd          , Hd          , Hd^Dr       , Dd          , Qxu         , Dd^Dr       , Dd          , Ds          , Rd          , Dd          , Hd          , Dd          , Dd          , Dd          , Dd^Dr       , Dd          , Dd          , Qxu         , Qxu         , Qxu         , Qxu         , Qxu         , Qxu         , Qxu         
Dd          , Dd          , Qxu         , Qxu         , Rd          , Dd          , Rd          , Hd          , Dd          , Hd          , Dd          , Dd          , Dd          , Dd          , Dd          , Dd          , Rd          , Dd          , Hd          , Hd          , Dd          , Dd^Dc       , Dd          , Dd          , Dd          , Qxu         , Qxu         , Qxu         , Qxu         , Qxu         , Qxu         , Qxu         
Rd          , Rd          , Qxu         , Qxu         , Qxu         , Qxu         , Qxu         , Rd          , Rd^Dr       , Dd          , Qxu         , Qxu         , Qxu         , Qxu         , Qxu         , Qxu         , Qxu         , Qxu         , Qxu         , Hd          , Dd          , Dd          , Dd          , Hd          , Dd^Dr       , Dd          , Qxu         , Qxu         , Qxu         , Qxu         , Qxu         , Qxu         
Qxu         , Ds          , Qxu         , Qxu         , Hd^Dr       , Qxu         , Qxu         , Qxu         , Qxu         , Qxu         , Qxu         , Qxu         , Chr         , Qxu         , Chr         , Qxu         , Qxu         , Qxu         , Qxu         , Qxu         , Qxu         , Qxu         , Qxu         , Dd          , Rd          , Rd          , Qxu         , Dd          , Qxu         , Qxu         , Qxu         , Dd          
Qxu         , Qxu         , Qxu         , Qxu         , Hd          , Dd          , Dd          , Qxu         , Qxu         , Qxu         , Chr         , Qxu         , Qxu         , Chr         , Ds          , Chr         , Urb         , Chr         , Chr         , Chr^Dr      , Chr         , Qxu         , Qxu         , Qxu         , Qxu         , Qxu         , Qxu         , Dd          , Dd^Dr       , Hd          , Qxu         , Qxu         
Rd          , Qxu         , Rd          , Dd          , Hd          , Dd          , Qxu         , Qxu         , Qxu         , Chr         , Qxu         , Qxu         , Qxu         , Urb         , Uu          , Uu          , Urb         , Urb         , Dd^Dr       , Ds          , Qxu         , Qxu         , Chr         , Qxu         , Qxu         , Qxu         , Hd          , Dd          , Dd          , Dd^Dr       , Dd          , Qxu         
Dd          , Rd          , Dd^Dc       , Rd          , Rd          , Dd          , Qxu         , Qxu         , Qxu         , Qxu         , Uu^Dr       , Uu          , Qxu         , Urb         , Urb         , Urb         , Urb         , Urb         , Urb         , Qxu         , Qxu         , Ds          , Ds          , Chr^Dr      , Qxu         , Qxu         , Hd          , Hd          , Hd          , Dd          , Dd          , Hd          
Qxu         , Dd          , Dd          , Dd^Dr       , Dd          , Qxu         , Qxu         , Qxu         , Chr         , Ds          , Uu          , Dd^Dr       , Qxu         , Urb         , Urb         , Urb         , Dd^Dr       , Urb         , Qxu         , Qxu         , Urb         , Dd^Dr       , Ds          , Chr^Dr      , Qxu         , Qxu         , Qxu         , Hd          , Dd          , Dd          , Dd          , Hd          
Qxu         , Qxu         , Hd          , Hd          , Qxu         , Qxu         , Chr         , Qxu         , Urb         , Urb         , Urb         , Dd^Dr       , Urb         , Qxu         , Ds          , Dd^Dr       , Chr         , Ds          , Ds          , Qxu         , Urb         , Uu          , Dd^Dr       , Chr         , Chr         , Qxu         , Qxu         , Hd          , Dd          , Dd          , Dd          , Dd          
Qxu         , Qxu         , Qxu         , Hd          , Qxu         , Chr         , Ds          , Ds          , Uu          , Urb         , Urb         , Urb         , Qxu         , Qxu         , Chr         , Chr         , Ds          , Chr         , Chr^Dr      , Urb         , Urb         , Uu          , Ds          , Ds          , Ds          , Chr         , Qxu         , Qxu         , Dd          , Dd          , Hd          , Hd          
Dd          , Qxu         , Hd          , Dd^Dr       , Qxu         , Chr         , Ds          , Uu          , Uu          , Dd^Dr       , Urb         , Qxu         , Chr         , Qxu         , Qxu         , Ds          , Ds          , Ds          , Urb         , Chr         , Urb         , Urb         , Urb^Dr      , Uu          , Uu          , Chr         , Chr         , Qxu         , Qxu         , Dd          , Qxu         , Qxu         
Rd          , Dd          , Dd          , Qxu         , Qxu         , Chr         , Ds          , Uu^Dr       , Uu          , Uu          , Urb         , Qxu         , Chr^Dr      , Qxu         , Qxu         , Urb         , Chr         , Urb         , Urb         , Urb         , Chr         , Urb         , Qxu         , Urb         , Qxu         , Ds          , Chr         , Qxu         , Qxu         , Qxu         , Qxu         , Qxu         
Dd          , Rd          , Qxu         , Qxu         , Qxu         , Chr         , Dd^Dr       , Uu          , Dd^Dr       , Ds          , Urb         , Qxu         , Chr         , Qxu         , Qxu         , Chr         , Khr^Dr      , Chr         , Qxu         , Qxu         , Chr         , Ds          , Dd^Dr       , Qxu         , Qxu         , Qxu         , Qxu         , Qxu         , Qxu         , Qxu         , Dd          , Dd          
Qxu         , Dd          , Qxu         , Qxu         , Qxu         , Chr         , Ds          , Uu          , Urb         , Urb         , Urb^Dr      , Qxu         , Chr         , Qxu         , Qxu         , Chr^Dr      , Chr         , Chr         , Urb         , Qxu         , Chr         , Ds          , Ds          , Qxu         , Urb         , Chr         , Qxu         , Qxu         , Qxu         , Dd          , Dd          , Dd          
Qxu         , Dd          , Qxu         , Qxu         , Chr         , Urb         , Urb         , Urb         , Urb         , Urb         , Qxu         , Qxu         , Qxu         , Qxu         , Chr         , Qxu         , Qxu         , Urb         , Urb         , Urb         , Urb         , Qxu         , Qxu         , Urb         , Urb         , Chr         , Qxu         , Qxu         , Dd          , Rd          , Rd          , Dd^Vdt      
Qxu         , Qxu         , Qxu         , Qxu         , Chr         , Urb         , Urb         , Urb         , Urb         , Qxu         , Uu^Cd       , Uu^Cd       , Uu^Cd       , Qxu         , Qxu         , Chr         , Qxu         , Qxu         , Chr         , Chr         , Dd^Dr       , Qxu         , Qxu         , Urb         , Uu          , Chr         , Qxu         , Qxu         , Dd          , Dd^Dr       , Dd          , Rd          
Dd          , Qxu         , Qxu         , Chr         , Qxu         , Qxu         , Qxu         , Urb         , Uu^Cd       , Uu^Cd       , Xos         , Xos         , Xos         , Uu^Cd       , Uu^Cd       , Qxu         , Ds          , Chr         , Ds          , Ds          , Ds          , Urb         , Qxu         , Uu          , Ds          , Chr         , Qxu         , Qxu         , Qxu         , Qxu         , Qxu         , Qxu         
Dd^Dc       , Qxu         , Qxu         , Ch          , Qxu         , Qxu         , Qxu         , Qxu         , Uu^Cd       , Xos         , Uu^Cd       , Uu^Cd       , Uu^Cd       , Xos         , Xos         , Uu^Cd       , Dd^Dr       , Ds          , Ds          , Dd^Dr       , Uu          , Urb         , Urb         , Uu          , Ds          , Chr         , Qxu         , Qxu         , Hd          , Qxu         , Dd          , Hd          
Dd          , Qxu         , Qxu         , Chr^Dr      , Qxu         , Qxu         , Qxu         , Qxu         , Uu^Cd       , Xos         , Uu^Cd       , 1 Uu        , Uu          , Xos         , Uu          , Uu^Cd       , Urb         , Ds          , Urb         , Uu          , Urb         , Urb         , Urb         , Ds          , Chr         , Chr         , Qxu         , Qxu         , Hd          , Hd          , Dd^Dr       , Dd          
Dd^Dr       , Qxu         , Qxu         , Chr         , Qxu         , Qxu         , Urb         , Urb         , Uu^Cd       , Xos         , Uu^Cd       , Uu          , Uu          , Uu^Dr       , Uu          , Urb         , Urb         , Urb         , Urb         , Urb         , Urb         , Urb         , Qxu         , Chr         , Qxu         , Qxu         , Qxu         , Dd          , Hd          , Hd          , Dd          , Dd          
Hd          , Qxu         , Qxu         , Chr         , Ch^Dr       , Urb         , Urb         , Urb^Dr      , Uu^Cd       , Xos         , Xos         , Xos         , Xos         , Xos         , Uu^Cd       , Urb         , Urb         , Dd^Dr       , Qxu         , Qxu         , Chr         , Chr         , Qxu         , Qxu         , Qxu         , Qxu         , Qxu         , Dd          , Dd          , Dd          , Ds          , Ds          
Qxu         , Dd          , Qxu         , Qxu         , Qxu         , Qxu         , Chr         , Dd^Dr       , Qxu         , Uu^Cd       , Uu^Cd       , Uu^Cd       , Uu^Cd       , Uu^Cd       , Qxu         , Urb         , Urb         , Qxu         , Qxu         , Chr         , Qxu         , Qxu         , Qxu         , Qxu         , Dd          , Rd          , Qxu         , Dd          , Dd^Dr       , Dd          , Ds          , Ds^Dr       
Dd          , Dd^Dr       , Rd          , Qxu         , Qxu         , Qxu         , Chr^Dr      , Uu          , Uu          , Qxu         , Qxu         , Qxu         , Qxu         , Qxu         , Dd^Dr       , Urb         , Urb         , Urb         , Qxu         , Chr         , Qxu         , Qxu         , Dd          , Dd          , Dd          , Dd          , Qxu         , Qxu         , Rd          , Rd          , Rd          , Ds          
Rd          , Rd          , Dd^Dr       , Dd          , Qxu         , Qxu         , Chr         , Uu          , Uu          , Uu          , Uu          , Uu          , Uu          , Qxu         , Chr         , Urb         , Chr         , Chr         , Qxu         , Qxu         , Qxu         , Qxu         , Dd          , Dd^Dr       , Dd          , Dd^Dr       , Hd          , Qxu         , Qxu         , Dd          , Ds          , Rd          
Qxu         , Dd          , Qxu         , Dd^Dr       , Qxu         , Qxu         , Qxu         , Chr         , Chr         , Uu          , Uu          , Uu^Dr       , Chr         , Chr         , Qxu         , Qxu         , Qxu         , Qxu         , Qxu         , Qxu         , Hd^Dr       , Rd          , Rd          , Dd          , Dd          , Dd          , Dd^Dc       , Hd          , Qxu         , Ds          , Qxu         , Qxu         
Qxu         , Qxu         , Qxu         , Qxu         , Qxu         , Qxu         , Qxu         , Qxu         , Qxu         , Chr         , Ch          , Ch          , Qxu         , Qxu         , Qxu         , Qxu         , Qxu         , Qxu         , Dd          , Hd          , Hd          , Dd          , Dd          , Rd          , Rd          , Dd          , Dd          , Hd          , Qxu         , Qxu         , Qxu         , Qxu         
