Wo, Wo, Wo, Wo, Wo, Wo, Wo, Wo, Wo, Ww, Ds, Gg, Ss, Gg, Gs, Gs, Gs, Gg, Rp, Gg, Gg, Gs, Gs, Gs^Fds, Gs^Fds, Gs^Fds, Gs, Gg, Gg, Gg, Gs^Fds, Gs^Fds, Gs^Fds, Gs^Fds, Gs^Fds, Gg, Gg, Gg, Gg, Gg, Gg, Gs^Fds, Gs^Fds, Gg, Gg, Gg, Hh, Gs^Fds, Gs^Fds, Gs^Fds, Gs^Fds, Gs^Fds, Gs^Fds, Mm, Mm^Xm, Hh, Hh, Mm, Mm^Xm, Mm^Xm, Mm^Xm, Mm, Mm, Mm, Mm, Mm^Xm, Hh, Gg, Hh, Gs, Gs, Gs, Hh, Hh, Hh, Re, Gs, Gs, Gs, Hh, Hh, Gs^Fdw, Gs^Fdw, Gs, Gs^Fdw, Gs, Gs, Gs, Gs, Gs, Gs, Gs^Fdw, Gs^Fdw, Gs^Fdw, Gs^Fdw, Gs, Ds, Gs, Gs^Fdw, Gs, Gs^Fdw, Gs, Gs^Fdw, Ds, Gs^Fdw, Gs^Fdw, Ds, Ds, Gs, Ds, Ds, Ds, Ds, Gs, Gs, Ds, Gs, Gs, Gs^Ft, Gs, Gs^Fdw, Gs, Ds, Gs, Gs, Gs, Gs, Ds, Ss, Ds, Ds, Gs, Gd, Gs, Gd, Gs, Ds, Ss, Gs, Gs, Gs, Gs, Ds, Re, Re, Re, Dd, Dd, Dd, Dd, Re, Re, Hd, Hd, Hd, Hd, Dd, Dd, Dd, Dd, Dd, Dd, Hd, Hd, Hd, Mdd, Mdd, Mdd, Mdd, Mdd, Mdd, Mdd, Hd, Dd, Dd, Dd, Hd, Ce, Hd, Mdd, Mdd, Mdd, Mdd^Xm, Mdd^Xm, Mdd^Xm, Mdd^Xm, Mdd^Xm, Mdd, Mdd, Hd, Hd, Hd, Hd, Hd, Mdd, Mdd, Mdd, Hd, Hd, Hd, Hd, Hd
Wo, Wo, Wo, Wo, Wo, Wo, Wo, Wo, Ww, Wwr, Wwr, Ds, Ss, Ss, Ss, Gs, Chr, Gs, Rp, Gs, Gs, Gs, Gs, Gs^Fds, Gs, Gs^Fds, Gs, Gs^Fds, Gs^Fds, Gs^Fds, Gs, Gs^Fds, Gll^Ftd, Gll^Fds, Gll^Fds, Gg, Gg, Gs^Fds, Gg, Gg, Gg, Gs^Fds, Gs^Fds, Gg, Gg, Gs^Fds, Gg, Hh, Gs^Fds, Gs^Fds, Hh, Gs^Fds, Mm, Mm, Mm^Xm, Mm^Xm, Mm, Mm, Mm^Xm, Mm^Xm, Mm, Mm^Xm, Mm, Mm, Mm, Mm^Xm, Hh, Gg, Gg, Gs, Gs, Gs, Hh, Hh, Hh, Re, Hh, Gs^Fdw, Hh, Hh, Gs, Gs, Gs, Gs, Gs^Fdw, Gs^Fdw, Hh, Gs, Ds, Gs, Gs, Gs^Fdw, Gs^Fdw, Gs^Fdw, Gs^Fdw, Ds, Gs, Ds, Gs^Fdw, Gs, Gs^Fdw, Gs, Gs^Fdw, Ds, Ds, Gs^Fdw, Gs^Fdw, Ds, Gs^Fdw, Gs, Gs, Ds, Ds, Ds, Gs, Gs, Ds, Ds, Co, Gs, Gs^Fdw, Gs, Gs, Gs, Gs, Gs, Ss, Ss, Gd, Ds, Ss, Ds, Gd, Ds, Ds, Gs, Gs, Ss^Vhs, Ss, Ss, Ss, Ds, Ds, Gd, Gd, Re, Hd, Rd, Dd, Dd, Dd, Re, Dd, Hd, Hd, Hd, Dd, Rd, Rd, Dd, Re, Dd, Dd, Hd, Hd, Mdd, Hd, Hd, Dd^Dc, Mdd, Hd, Hd, Ds, Dd, Hd, Hd, Hd, Ce, Dd, Hd, Mdd, Mdd, Mdd, Mdd^Xm, Mdd^Xm, Mdd^Xm, Mdd, Mdd^Xm, Mdd, Mdd, Hd, Hd, Hd, Hd, Hd, Mdd, Hd, Hd, Hd, Hd, Hd, Hd
Wo, Wo, Wo, Wo, Wo, Wo, Wo, Ww, Wwr, Ww, Ww, Ss, Ww, Ds, Ss, Khr, Ss, Gs, Rd, Gg, Gs^Ftd, Gs, Gs^Fds, Gs^Fds, Gs, Gs, Gs, Gs, Gg, Gg, Gs, Gll, Gll, Gll^Fds, Gs^Ftd, Gg, Gs, Gs^Fds, Ce, Gg, Gg, Gs^Fds, Gg, Gs^Fds, Gg, Gs^Fds, Gg, Hh, Hh, Mm, Chr, Hh, Mm, Mm, Mm^Xm, Mm, Mm, Mm^Xm, Mm, Mm, Mm, Mm, Mm, Mm, Mm, Mm^Xm, Hh, Chr, Hh, Hh, Gs, Hh, Gg^Vh, Ce, Re, Re, Gs, Hh, Gs^Fdw, Gs^Fdw, Gs^Fdw, Gs, Gs, Gs, Gs, Gs^Fdw, Gs^Fdw, Hh, Ds, Gs, Gs, Gs, Gs^Fdw, Gs, Gs^Fdw, Gs, Gs, Gs, Ds, Ds, Gs, Gs, Gs^Fdw, Gs^Fdw, Ds, Gs, Gs, Gs^Fdw, Gs, Gs^Fdw, Gs^Fdw, Gs, Gs^Fdw, Gs, Ss, Gs, Ss, Ss, Ko, Gs, Gs, Rd, Rd, Gs, Ds, Ds, Ds, Ss, Rd, Gd, Rd, Gs, Rd, Ds, Gd, Gd, Gd, Gs, Ds, Ss, Ss, Ss, Gd, Ds, Ds, Hd, Hd, Rd, Rd, Dd^Dr, Dd, Rd, Rd, Dd, Hd, Dd, Re, Re, Ds, Ds, Re, Ds, Ds, Hd, Dd, Dd, Dd, Ds, Ds, Dd, Dd, Hd, Dd, Hd, Dd, Dd, Dd, Dd, Hd, Hd, Mdd, Mdd, Mdd, Mdd^Xm, Mdd, Mdd, Hd, Mdd, Mdd, Mdd, Hd, Hd, Hd, Qxe, Qxe, Hd, Hd, Dd, Dd, Qxe, Hd, Hd
Wo, Wo, Wo, Wo, Wo, Wo, Wo, Wo, Wwr, Wwr, Ww^Vm, Ww, Ww, Ds, Ds, Chs, Chs, Gs, Gg, Rd, Rp, Gs^Fds, Gs, Gs, Gg, Gs, Gll^Fds, Gs^Fds, Gs^Ftd, Gs^Fds, Gs, Gs, Gll^Fds, Gll^Ftd, Gs, Gs, Gs, Gs^Ftd, Gg^Vh, Ce, Gg, Gg, Gs^Fts, Gg, Gs^Fds, Gs^Fds, Hh, Hh, Gs^Fds, Hh, Chr, Hh, Mm, Mm^Xm, Mm^Xm, Mm, Mm, Mm^Xm, Mm, Mm, Mm, Mm, Mm^Xm, Mm^Xm, Mm^Xm, Mm^Xm, Hh, Hh, Chr, Hh, Hh, Hh, Ce, Ce, Re, Gg^Vh, Gs, Hh, Gs, Gs^Fdw, Gs^Fdw, Gs^Fdw, Hh, Gs, Gs, Gs^Fdw, Chr, Hh, Hh, Ds, Ds, Gs, Gs, Gs^Fdw, Ds, Gs, Gs, Gs, Ds, Gs, Gs, Gs, Gs^Fdw, Gs^Fdw, Gs, Gs, Gs^Fdw, Gs, Gs^Fdw, Gs^Fdw, Gs^Fdw, Gs^Fdw, Ss, Ds, Ds, Gs, Ss, Co, Ds, Gs, Re, Ss, Rd, Gs, Gs, Ds, Gs^Fdw, Rd, Ds, Gd, Ds, Rd, Ss, Gs, Gd, Ds, Ss, Ds, Ss, Gd, Ds, Gd, Ss, Ds, Ss, Ds, Ds, Ds, Re, Re, Re, Re, Rd, Dd, Dd, Hd, Re, Dd, Dd^Do, Ds, Dd, Re, Dd, Dd, Dd^Dr, Dd, Dd, Ds, Ds, Dd, Dd, Dd, Ds, Dd, Dd, Dd^Dr, Dd, Dd, Ds, Hd, Hd, Mdd, Mdd, Mdd, Mdd, Hd, Mdd, Hd, Hd, Hd, Hd, Hd, Dd, Hd, Qxe, Qxe, Hd, Dd, Dd, Qxe, Qxe, Dd
Wo, Wo, Wo, Wo, Wo, Wo, Wo, Wo, Wwr, Wwr, Wo, Wo, Ww, Wwr, Wwr, Ss, Ss, Gs, Gs^Fds, Gs^Ftd, Rp, Gs^Fds, Gs, Gs, Gg, Gll^Fds, Gll^Ftd, Gs^Ftd, Gg, Gs, Chr, Gg, Gg, Gs^Ftd, Gs, Gg, Gg, Gs^Fds, Gs^Fds, Gs^Fds, Gg, Gg, Gg, Gs^Fts, Gs^Fds, Gs^Fts, Hh, Gs^Fds, Hh, Chr, Gs^Fms, Hh, Mm, Mm^Xm, Mm, Mm, Mm, Mm^Xm, Mm, Mm, Mm^Xm, Mm^Vhh, Mm^Xm, Mm, Mm^Xm, Hh, Hh, Chr, Hh, Hh, Gg, Hh, Rb, Rb, Hh, Hh, Hh, Hh, Gs^Fdw, Gs^Fdw, Gs, Gs, Hh, Gs, Gs, Chr, Gs^Fdw, Chr, Gs^Fdw, Gs, Gs, Ds, Ds, Gs^Fdw, Ds, Gs, Gs, Ds, Gs^Fdw, Gs^Fdw, Gs^Fdw, Ds, Ds, Gs^Fdw, Gs^Fdw, Gs, Gs^Ftd, Ds, Ds, Gs^Fdw, Ds, Ss, Ss, Ss^Vhs, Ss, Ds, Ss, Gs, Ds, Ds, Ds, Ss, Ss, Re, Ss, Gs, Gs, Ds, Gd, Ds, Ss, Ss, Re, Re, Rd, Gd, Gs, Ss, Ss, Re, Rd, Gd, Ds, Ss, Ss, Gd, Gd, Dd, Re, Dd, Ds, Co, Co, Dd^Dc, Dd, Dd, Dd, Dd, Dd, Ds, Hd, Dd, Dd, Hd, Hd, Hd, Dd, Dd, Dd, Hd, Ds, Qxe, Qxe, Ce, Dd, Dd, Dd, Ds, Dd^Vda, Ds, Hd, Hd, Mdd, Mdd^Xm, Mdd, Hd, Hd, Hd, Hd, Qxe, Qxe, Hd, Hd, Hd, Qxe, Qxe, Dd, Hd, Dd, Qxe, Qxe, Hd
Wo, Wo, Wo, Wo, Wo, Wo, Wo, Wo, Wo, Wwr, Ww, Ww, Dd^Vda, Wwf, Wwf, Ss, Ds, Gs, Gs, Gs^Ftd, Rp, Gs, Gs^Ftd, Gs^Ftd, Gll^Ftd, Gll^Fds, Gg, Gs^Ftd, Gs^Fds, Gs^Fds, Gg, Gs^Fp, Gs, Gs^Ftd, Gg, Gg, Gg, Gg, Gg, Gg, Gg, Gg, Gs^Fds, Gg, Gg, Gs^Fts, Hh, Gs^Fds, Mm, Mm, Gs^Fms, Mm, Mm^Xm, Mm, Mm, Mm, Mm, Mm^Xm, Mm^Xm, Mm^Xm, Mm^Xm, Mm^Xm, Mm, Mm, Mm, Mm, Mm, Hh, Hh, Gg, Re, Re, Gs, Gs, Gs, Hh, Gs^Fdw, Gs, Ce, Gs, Gs^Fdw, Gs, Gs, Hh, Gs, Gs^Fdw, Gs, Gs, Gs^Fdw, Gs, Gs^Fdw, Gs, Ds, Gs^Fdw, Gs, Gs, Gs, Ds, Ds, Gs^Fdw, Chr, Gs, Ds, Gs, Ds, Gs^Fdw, Gs^Fdw, Gs^Fdw, Gs, Gs^Fdw, Gs, Gs, Ss, Ss, Ds, Rd, Gs, Ss, Ds, Gs^Fdw, Gs^Fdw, Gs, Ss, Re, Ss, Ss, Rd, Ds, Ss^Vhs, Ds, Rd, Ss, Co, Rd, Gs, Gd, Re, Ss, Ds, Ss, Ds, Rd, Rd, Re, Ss, Ss, Ss^Vhs, Re, Ds, Re, Co, Ko, Hd, Dd, Rd, Ds, Rd, Dd, Hd, Hd, Hd, Dd, Dd, Hd, Dd, Dd, Dd, Dd, Dd, Dd, Hd, Qxe, Dd, Ce, Dd, Dd, Dd, Dd, Dd, Ds, Hd, Hd, Mdd, Mdd^Xm, Mdd^Xm, Mdd, Hd, Hd, Qxe, Qxe, Qxe, Qxe, Dd, Dd, Qxe, Qxe, Qxe, Qxe, Qxe, Qxe, Qxe, Qxe
Wo, Wo, Wo, Wo, Wo, Wo, Wwr, Ww, Wo, Ww, Ww, Ds, Ds, Wwf, Ww, Ss, Ds, Gs, Gs, Gs^Ftd, Gs, Rd, Rp, Gs^Ftd, Gs^Fds, Gs, Gg, Gs^Fds, Gg, Gg, Gs, Gg, Gs, Gs, Gs, Gs^Fms, Gs^Fds, Gs^Fds, Gg, Gg, Gs^Fds, Gg, Gs^Fds, Gs^Fts, Gs^Fts, Gg, Gg, Hh, Mm, Hh, Gs^Fms, Mm, Mm, Mm, Mm^Xm, Mm^Xm, Mm, Mm^Xm, Mm^Xm, Mm^Xm, Mm^Xm, Mm^Xm, Mm^Xm, Mm, Mm, Mm, Mm, Hh, Re, Re, Gg, Rb, Rb, Gs, Hh, Hh, Gs, Gs^Fdw, Ce, Gg^Vh, Gs^Fdw, Gs^Fdw, Gs, Gs, Gs, Gs, Gs^Fdw, Gs^Fdw, Gs^Fdw, Gs^Fdw, Gs, Gs, Ds, Ds, Gs, Hh, Hh, Ds, Gs^Fdw, Gs^Fdw, Gs^Fdw, Gs^Fdw, Gs, Ds, Ds, Gs, Gs^Ftd, Ds, Ds, Gs, Ds, Ds, Ss, Ds, Gs^Fdw, Rd, Gs, Ss, Ss, Gs, Ss, Ss, Ds, Gs, Ds, Ss, Ss, Rd, Ss, Gd, Chr, Ss, Co, Ko, Ss, Ss, Rd, Ds, Ss, Ds, Gd, Rd, Rd, Rd, Re, Ss, Gd, Gd, Hd, Hd, Ds, Hd, Hd, Hd, Dd, Re, Rd, Dd, Hd, Hd, Dd, Dd, Dd, Dd, Dd, Dd, Dd, Dd^Dc, Hd, Dd, Dd, Hd, Dd^Do, Qxe, Dd, Dd^Dc, Dd, Dd, Hd, Dd, Hd, Hd, Hd, Mdd, Hd, Hd, Hd, Hd, Dd, Qxe, Qxe, Qxe, Qxe, Qxe, Qxe, Qxe, Qxe, Qxe, Qxe, Qxe, Qxe, Qxe
Wo, Wo, Wo, Wo, Wo, Wo, Ww, Wo, Wwr, Wwr, Gg, Ds, Ss, Ss, Ww, Wwf, Ds, Ds, Gs^Ftd, Gs, Gg, Gs^Fds, Gs^Ftd, Re, Gs, Gs, Gs^Fds, Gg, Gs^Fds, Gg, Gll^Fds, Gll^Fds, Gll^Fds, Gs^Fds, Gs^Fds, Gs, Gs^Fds, Gs^Fms, Gs^Fds, Gs^Fds, Gs^Fds, Gs^Fds, Ce, Gs^Fts, Gg^Vh, Hh, Hh, Mm, Hh, Gs^Fms, Gs^Fms, Mm, Mm, Mm, Mm, Mm^Xm, Mm^Xm, Mm^Xm, Mm^Xm, Mm^Xm, Mm^Xm, Mm^Xm, Mm, Mm, Mm^Vhh, Re, Re, Re, Gg, Gg, Gg, Gg, Hh, Rb, Re, Hh, Hh, Gs, Ce, Gg^Vh, Gs^Fdw, Gs^Fdw, Gs^Fdw, Gs^Fdw, Gs^Fdw, Hh, Hh, Gs^Fdw, Gs^Fdw, Gs^Fdw, Hh, Gs^Ftd, Ds, Gs, Gs, Gs, Hh, Hh, Hh, Chr, Gs^Fdw, Gs^Fdw, Ds, Ds, Gs, Gs^Ftd, Gs^Fdw, Gs^Fdw, Ds, Gs, Gs^Fdw, Gs, Gs, Gs^Fdw, Gs^Ftd, Gs^Fdw, Rd, Gs^Fdw, Re, Ss, Ss, Gs, Ds, Gs^Fdw, Gs, Gs, Ds, Ss, Rd, Ss, Ss, Re, Ds, Co, Gs, Ss, Rd, Ss, Rd, Gd, Gd, Rd, Rd, Rd, Gd, Ds, Ds, Ds, Hd, Ds, Re, Hd, Dd, Hd, Dd, Qxe, Qxe, Re, Rd, Dd, Dd, Dd, Dd, Ds, Hd, Dd, Dd, Hd, Hd, Dd, Dd, Dd, Dd, Dd, Dd^Vda, Dd, Dd, Dd, Hd, Hd, Hd, Hd, Hd, Hd, Hd, Hd, Hd, Qxe, Dd, Qxe, Qxe, Qxe, Qxe, Qxe, Qxe, Qxe, Qxe, Qxe, Qxe, Qxe, Qxe, Qxe
Wo, Wo, Wo, Wo, Ww, Ww, Ww, Wwr, Ww, Gg, Ds, Ds, Ss, Ss, Ww, Ds, Ds, Ds, Gs^Ftd, Gs, Gg, Gs^Fds, Gs^Ftd, Re, Re, Gs^Ftd, Gs^Ftd, Gs^Fds, Gs^Fds, Gs^Fds, Gs^Ftd, Gll^Fds, Gll^Fms, Gs^Ftd, Gs^Ftd, Gs, Gg, Gg, Gg, Gs^Fts, Gg^Vh, Gs^Fds, Ce, Gs^Fts, Ce, Ce, Hh, Hh, Chr, Hh, Mm, Mm, Mm, Mm, Mm, Hh^Vhh, Mm^Xm, Mm^Xm, Mm^Xm, Mm^Xm, Mm^Xm, Mm, Mm, Mm, Mm^Xm, Mm, Hh, Hh, Hh, Gg, Gg, Hh, Gg, Gg, Gs, Re, Gs, Gs, Gs, Ce, Gs^Fdw, Gs^Fdw, Gs, Gs^Fdw, Gs, Gs, Gs, Gs, Gs^Fdw, Gs, Ds, Hh, Gs, Ds, Gs^Fdw, Gs^Fdw, Gd^Fdw, Gd, Gd, Gs^Fdw, Ds, Ds, Gs, Gs, Gd, Gd, Gd, Gs^Fdw, Ds, Gs, Gd^Fdw, Gd, Gs, Gs, Gs, Gs^Fdw, Ds, Rd, Rd, Rd, Gd, Gd, Ss, Ds, Ss, Ss, Co, Ds, Ds, Rd, Gs, Rd, Gs, Ds, Ds, Re, Ss, Rd, Ss, Rd, Ds, Gd, Rd, Rd, Re, Ds, Ds, Ds, Hd, Dd, Re, Hd, Dd^Dr, Dd, Dd, Qxe, Rd, Re, Dd, Dd, Dd^Dr, Dd, Ds, Ds, Hd, Dd, Dd, Dd, Dd, Dd, Dd, Dd, Dd, Dd, Dd, Dd, Hd, Hd, Hd, Mdd, Hd, Hd, Hd, Hd, Hd, Hd, Hd, Qxe, Qxe, Dd, Qxe, Qxe, Qxe, Qxe, Qxe, Qxe, Qxe, Qxe, Qxe, Qxe, Qxe, Qxe
Wo, Wo, Wo, Wo, Wo, Ww^Vm, Wo, Wwr, Ww, Gg, Gg, Ss, Ww, Ww, Wwf, Ss, Gs, Gg, Gs^Ftd, Gs, Gs, Gs^Fds, Re, Re, Gs, Re, Re, Gg, Re, Gg, Gs^Fds, Gll^Ftd, Gs^Fds, Gs^Fms, Gs^Fds, Gs, Gg, Gg, Gg, Gs^Fts, Gs^Fds, Gs^Fds, Ce, Gs^Fts, Gs, Gs^Fp, Gs^Fp, Hh, Gs^Fp, Hh, Gs^Fp, Hh, Re, Mm, Mm, Mm, Mm, Mm^Xm, Mm^Xm, Mm^Xm, Mm^Xm, Mm^Xm, Mm^Xm, Mm^Xm, Mm, Mm, Hh, Hh, Hh, Hh, Gs, Hh, Hh, Hh, Hh, Re, Gs, Gs, Gs^Fdw, Gs^Fdw, Gs, Gs, Gs, Gs^Fdw, Hh, Gs, Gs, Gs, Gs^Fdw, Gs, Gs, Hh, Ds, Ds, Gd, Gd, Gd, Gd, Gd, Gs, Ds, Gs^Ftd, Gs^Ftd, Gs, Ds, Gd, Gd, Gs^Fdw, Gs, Ds, Gd^Fdw, Ds, Gd, Gs, Gs, Ds, Ds, Gs^Fdw, Rd, Gd, Re, Ss, Gd, Ds, Ss, Ss, Ss^Vhs, Ko, Ds, Ds, Re, Gd, Gd, Ds, Ss, Ss, Ds, Rd, Ss, Rd, Ds, Ss, Ss^Vhs, Ss, Ds, Ds, Dd, Gd, Dd, Ds, Hd, Re, Dd, Dd, Dd, Re, Dd, Dd^Vda, Dd, Dd, Dd, Dd, Dd, Hd, Dd, Dd, Dd, Dd, Dd, Dd^Dr, Ce, Ce, Dd, Dd, Dd, Dd, Hd, Mdd, Hd, Mdd, Mdd^Xm, Hd, Hd, Mdd, Hd, Hd, Qxe, Qxe, Qxe, Qxe, Qxe, Qxe, Qxe, Qxe, Qxe, Qxe, Qxe, Qxe, Qxe, Qxe, Qxe, Qxe
Wo, Wo, Wo, Wo, Wo, Wo, Wo, Ww, Ds, Gs, Gs, Ss, Ss, Ww, Ss, Ds, Ds, Gs, Gg, Gs^Ftd, Re, Re, Gs, Gs, Gs, Gs, Gs, Re, Gd^Ftd, Re, Re, Re, Re, Gs^Fds, Rb, Gg, Gs^Fp, Gg, Gg, Gs^Fts, Gs^Fds, Gg^Vh, Gg, Gg, Gs, Gs^Fp, Re, Re, Re, Hh, Re, Hh, Re, Mm, Mm, Mm, Mm, Mm^Xm, Mm^Xm, Mm^Xm, Mm^Xm, Mm^Xm, Mm^Xm, Mm^Xm, Mm^Xm, Mm, Mm, Hh, Hh, Hh, Gg, Hh, Gs, Hh, Gs, Rb, Rb, Gs, Gs, Gs, Gs, Gs, Gs^Fdw, Chr, Chr, Hh, Gs, Gs, Ds, Gs, Ds, Gs, Gs, Gs, Ds, Ds, Gs^Fdw, Gd, Gd^Fdw, Gd^Fdw, Gs, Ds, Gd, Gs, Ds, Gd, Gs^Ftd, Gd, Gs, Gd^Fdw, Gd^Fdw, Gd^Fdw, Gs^Fdw, Gs, Gs, Ds, Ss, Ds, Ss, Gd, Gd, Rd, Re, Ds, Ds, Ss, Ss, Co, Gd, Ss, Rd, Gd, Gd, Gs, Ss, Ss, Re, Re, Ss, Gd, Ds, Ss, Ss, Ss, Ds, Gd, Dd, Rd, Re, Dd, Hd, Ds, Dd, Dd, Dd, Dd, Dd^Dc, Dd, Rd, Ce, Ce, Dd^Do, Dd^Vda, Dd, Dd, Dd, Dd, Hd, Hd, Ce, Ce, Ds, Ds, Dd, Dd, Dd, Hd, Mdd, Mdd, Mdd, Mdd^Xm, Hd, Hd, Mdd, Mdd, Hd, Qxe, Qxe, Qxe, Qxe, Qxe, Qxe, Qxe, Qxe, Qxe, Qxe, Qxe, Qxe, Qxe, Qxe, Qxe, Qxe
Wo, Wo, Wo, Wo, Wo, Wo, Ww, Wwr, Wwf, Chw, Gs, Gg, Ds, Ds, Ss, Ss, Gs^Fms, Gs, Gs, Gs, Re, Gs, Gg, Gg, Gs, Gs^Fms, Gs^Fms, Gd^Ftd, Gd^Ftd, Gd^Ftd, Gs^Fds, Gs^Fds, Gg, Rb, Gs^Fms, Rb, Rb, Rb, Rb, Gg, Re, Gs^Fds, Gs^Fds, Gg, Rb, Re, Gs, Hh, Hh, Re, Mm, Re, Mm, Mm, Hh, Mm, Mm, Mm, Mm^Xm, Mm^Xm, Mm^Xm, Mm^Xm, Mm^Xm, Mm^Xm, Mm, Mm, Mm, Chr, Hh, Hh, Hh, Gs, Gs, Gs, Gs, Hh, Hh, Re, Re, Gs, Gs, Gs, Ds, Ds, Chr, Hh, Gs^Fdw, Ds, Gs, Hh, Ds, Ds, Gs^Ftd, Gs, Gs, Gs^Fdw, Ds, Gs^Fdw, Gd, Gs, Gs^Fdw, Gd, Gs, Ds, Gs^Fdw, Ds, Gd, Gs^Ftd, Gd, Gd, Gs^Fdw, Ds, Ds, Gs, Gs^Ftd, Gs, Ds, Ss, Ss, Gd, Ds, Gd, Ss, Ss, Re, Gd, Gd, Gd, Ss, Ss, Rd, Re, Gd, Ss, Re, Ds, Gd, Ds, Ds, Gd, Ds, Ss, Ss, Rd, Ds, Gd, Rd, Rd, Re, Dd, Hd, Dd, Rd, Re, Dd, Dd, Hd, Dd, Rd, Ce, Ce, Dd, Dd, Dd, Hd, Dd, Dd, Dd, Hd, Hd, Ce, Dd, Ds, Dd, Dd, Dd, Hd, Mdd, Mdd, Mdd^Xm, Mdd, Mdd, Hd, Mdd, Mdd, Hd, Hd, Qxe, Qxe, Qxe, Qxe, Qxe, Qxe, Qxe, Qxe, Qxe, Qxe, Qxe, Qxe, Qxe, Qxe, Qxe
Wo, Wo, Wo, Wo, Ww, Wwr, Ww, Ww, Wwr, Khw, Chr, Gs, Gs, Ds, Gs, Gs^Fms, Gs^Ftd, Gg, Rp, 2 Re, Gg, Gs^Fms, Gs^Fms, Gs, Gs^Fms, Gg, Chr, Gd^Ftd, Gd^Ftd, Gs^Fds, Gll^Fds, Gs^Fds, Gg, Gg, Gs^Fms, Gg, Gs^Fms, Gs^Fms, Gll^Fms, Re, Gg, Re, Re, Re, Gs^Fms, Gs, Gs, Hh, Gs^Fms, Hh, Hh, Mm, Gs^Fms, Hh, Hh^Vhh, Hh, Gs^Fms, Mm, Mm, Mm^Xm, Mm^Xm, Mm^Xm, Mm^Xm, Mm, Mm, Mm^Xm, Mm, Hh, Hh, Chr, Hh, Hh, Hh, Gg, Hh, Gs, Gs, Hh, Re, Gs, Gs, Gs, Gs, Ds, Ds, Hh, Gs^Fdw, Gs, Gs, Ds, Gs, Gs, Gs, Gd, Gs^Fdw, Gs, Gd, Gd, Gs^Ftd, Ds, Gs^Fdw, Gd^Fdw, Gs^Fdw, Gs^Fdw, Gs^Fdw, Gs^Fdw, Gd, Gd, Gd, Gd, Gd^Fdw, Gs^Fdw, Gs^Fdw, Ds, Gs, Gs, Re, Ss, Ss^Vhs, Gd, Ss, Rd, Rd, Ss, Gd, Ds, Re, Ds, Ss, Ss, Ss, Rd, Re, Gd, Ds, Gd, Ds, Rd, Ds, Re, Ss, Ss, Rd, Rd, Dd, Dd, Hd, Ds, Re, Re, Dd, Ds, Dd, Re, Re, Dd, Hd, Ds, Re, Re, Ds, Ds, Ds, Dd, Hd, Dd, Dd, Dd^Dc, Hd, Hd, Dd, Dd, Ds, Dd^Vda, Dd, Dd, Hd, Hd, Mdd, Mdd, Mdd^Xm, Mdd^Xm, Mdd, Hd, Hd, Hd, Hd, Hd, Qxe, Qxe, Qxe, Qxe, Qxe, Qxe, 1 Qxe, Qxe, Qxe, Qxe, Qxe, Qxe, Qxe, Qxe
Wo, Wo, Wo, Wo, Wo, Ww, Ww, Ww, Ww, Chw, Wwf, Rp, Rp, Ds, Gs, Gs^Fms, Gs, Gs, Rp, Gs, Gg, Gg, Gg, Gs, Gs^Ftd, Gs, Gs, Gg, Gs^Fds, Gll^Ftd, Gll^Ftd, Gs^Fds, Gg, Gg, Chr, Gs^Fp, Gll^Fms, Gll^Fms, Gs^Ftd, Gs^Ftd, Gs, Gs^Fms, Gs, Gs, Gs^Fms, Gs^Fds, Hh, Gs^Fts, Gs^Fts, Gs^Fds, Chr, Gs^Fms, Hh^Fms, Hh, Mm, Mm, Gs^Fp, Mm, Mm, Mm, Mm, Mm^Xm, Mm^Xm, Mm, Mm, Mm, Mm, Hh, Chr, Chr, Hh, Gs, Hh, Gs, Gs, Hh, Ce, Ce, Re, Gs, Gs, Gs, Gs^Fdw, Gs^Fdw, Gs^Fdw, Gs^Fdw, Gs^Fdw, Gs^Fdw, Gs, Gd, Gd, Ds, Ds, Gd, Gd^Fdw, Gs, Ds, Gs, Gs, Gs, Gs, Gd, Gs, Gs, Gs, Gd, Gd, Gd, Gs^Fdw, Gd, Gd, Gd^Fdw, Gs, Gs, Ss, Gs, Re, Gs, Ss, Ds, Gd, Re, Rd, Ss, Re, Ds, Gd, Rd, Ds, Chs, Gd, Gd, Re, Rd, Ss, Gs, Ss, Gs, Rd, Re, Ds, Ds, Dd, Re, Dd, Ds, Hd, Hd, Dd, Rd, Rd, Dd, Dd, Rd, Re, Dd, Dd, Hd, Re, Dd^Vda, Dd, Ds, Dd, Dd, Hd, Hd, Dd, Dd, Dd, Dd, Dd^Dr, Dd, Dd, Dd, Dd, Dd, Hd, Mdd, Mdd, Mdd, Mdd^Xm, Mdd^Xm, Mdd^Xm, Hd, Hd, Qxe, Qxe, Hd, Qxe, Qxe, Qxe, Qxe, Qxe, Qxe, Qxe, Qxe, Qxe, Qxe, Qxe, Qxe, Qxe, Qxe
Wo, Wo, Wo, Wo, Wo, Wo, Ww, Ww, Wwr, Wwr, Ds, Gs^Vh, Gs, Rp, Rp, Gs, Rd, Rp, Gs, Gg, Gs^Fds, Gs^Fds, Gg, Gg, Gs^Ftd, Gs^Ftd, Gs^Fds, Gg, Gs^Fds, Gll^Ftd, Gg, Gg, Gg, Gg, Gg, Chr, Gg, Gll^Fms, Gs^Ftd, Gs, Gs, Gs^Fms, Gs^Fts, Gs, Gs^Fms, Gs^Fds, Gs^Fms, Gs^Fds, Gs^Fts, Mm, Mm, Hh^Fms, Hh, Mm, Gs^Fms, Gs^Fms, Hh, Hh, Mm, Mm, Mm^Xm, Mm^Xm, Mm^Xm, Mm^Xm, Mm^Xm, Mm, Mm, Hh, Hh, Hh, Hh, Gs, Gg, Hh, Gs^Fdw, Gs, Ce, Gg^Vh, Re, Ce, Gs, Gs^Fdw, Gs, Gs^Fdw, Gs^Fdw, Hh, Hh, Hh, Re, Gs, Gd^Fdw, Gd^Fdw, Gs^Fdw, Gd, Gs^Fdw, Ds, Gd^Fdw, Gd, Hh, Gs^Fdw, Gs^Fdw, Ds, Ds, Gs^Ftd, Ds, Gs, Gd, Gd, Gs^Fdw, Gs^Fdw, Gd^Fdw, Gd^Fdw, Ds, Re, Ss, Ss, Re, Gs, Gs, Ss, Gd, Ss, Gd, Ds, Ds, Ds, Ds, Rd, Rd, Chs, Ss, Ds, Re, Rd, Ds, Ss, Ss, Ss^Vhs, Ss, Rd, Rd, Gd, Dd, Dd, Dd, Dd, Dd, Hd, Re, Co, Ko, Hd, Ds, Rd, Dd, Dd, Dd, Dd, Re, Dd^Dc, Dd, Dd, Dd, Dd, Dd, Dd, Ce, Dd, Dd, Dd, Dd, Dd, Dd, Dd, Dd, Dd, Hd, Mdd, Mdd, Mdd^Xm, Mdd^Xm, Mdd^Xm, Mdd, Mdd, Hd, Hd, Hd, Qxe, Qxe, Qxe, Qxe, Qxe, Qxe, Qxe, Qxe, Qxe, Qxe, Qxe, Qxe, Qxe, Qxe, Qxe
Wo, Wo, Wo, Wo, Wo, Wwr, Ww, Ww, Wwr, Wwr, Ww, Ds, Ds, Gs, Gs, Rd, Rp, Gs, Gs, Gg, Gs^Fms, Gs^Fms, Gs, Gs^Fms, Gs, Gs^Ftd, Gs^Ftd, Gs^Fds, Gs^Fds, Gs^Fds, Gg, Gs, Gs^Ftd, Gs^Fms, Gs^Ftd, Chr, Gs^Fms, Gg, Gg, Gg, Gs^Fms, Gs^Fts, Gs^Fds, Gg, Gs^Fms, Hh, Hh, Gs^Fts, Gs^Fms, Gs^Fms, Mm, Gs^Fp, Chr, Chr, Hh, Hh, Mm, Mm, Mm^Xm, Mm^Xm, Mm, Mm^Xm, Mm^Xm, Mm^Xm, Mm, Mm^Xm, Mm^Xm, Mm, Mm, Hh, Hh, Hh, Gg, Hh, Ce, Gg^Vh, Re, Re, Ce, Re, Re, Gs^Fdw, Gs, Gs, Hh, Hh, Re, Re, Ds, Ds, Gs^Fdw, Gd, Gd, Gd, Gs^Ftd, Ds, Gd^Fdw, Gs^Fdw, Hh, Chr, Chr, Gs^Fdw, Gs^Fdw, Ds, Gs^Fdw, Gs^Fdw, Gd^Fdw, Gd^Ftd, Re, Gd, Gs, Re, Gs, Gs, Ss, Rd, Gs, Ss, Gs, Re, Re, Ds, Gd^Fdw, Rd, Ds, Ds, Re, Ss, Rd, Re, Ds, Ss, Rd, Rd, Ds, Gs, Gs, Chs, Ss, Ds, Ds, Gd, Dd, Dd, Dd, Dd^Dr, Re, Re, Dd, Dd, Co, Re, Re, Dd, Dd, Dd^Dr, Dd, Re, Rd, Dd, Dd, Dd, Dd, Dd, Dd, Ce, Ds, Dd, Qxe, Dd, Ds, Ds, Ds, Dd, Hd, Hd, Hd, Hd, Mdd, Mdd, Mdd, Mdd^Xm, Mdd^Xm, Mdd, Mdd, Hd, Hd, Qxe, Qxe, Qxe, Qxe, Qxe, Qxe, Qxe, Qxe, Qxe, Qxe, Qxe, Qxe, Qxe, Qxe, Qxe
Wo, Wo, Wo, Wo, Wo, Wwr, Wwr, Ww, Ww, Ww, Wwr, Ds, Ds, Gg, Gs, Gs, Gs, Rp, Rd, Gs, Gs^Fms, Gs^Fds, Gs, Gd, Gg, Gs, Gs, Gs^Fds, Gg, Gg, Gs^Fds, Gs, Gs, Gs^Ftd, Gg^Ftd, Gs^Ftd, Gg, Gg, Gs^Fms, Gg, Gs^Fts, Gs^Fts, Gs^Fms, Gs^Fms, Gg, Gs, Gs^Fds, Gs^Fts, Hh, Gs^Fms, Gs^Fms, Hh, Chr, Hh, Mm, Mm, Mm^Xm, Mm^Xm, Mm^Xm, Mm^Xm, Mm, Mm, Mm^Xm, Mm^Xm, Mm, Mm, Mm^Xm, Mm, Mm, Hh, Hh, Hh, Hh, Gs^Fdw, Ce, Gg^Vh, Hh, Gg^Vh, Gs, Gs, Re, Gs, Re, Ds, Re, Re, Gs^Fdw, Ds, Gs, Ds, Gs^Fdw, Gd^Fdw, Gd, Gs, Gs^Fdw, Gd^Fdw, Gs, Gd^Fdw, Gs, Hh, Gs^Fdw, Gs^Fdw, Gs, Gs^Fdw, Ds, Gd, Gs, Gs^Fdw, Re, Gd, Ss, Re, Rd, Ss, Ss, Re, Co, Rd, Ss, Rd, Ss, Ss, Re, Gd, Rd, Gd, Ss, Gd, Gd, Rd, Rd, Gs, Re, Rd, Gll, Re, Ds, Ds, Rd, Rd, Gd, Gd, Hd, Hd, Dd, Dd, Re, Hd, Hd, Dd, Ds, Hd, Hd, Rd, Dd, Dd, Dd, Rd, Re, Rd, Dd, Dd, Dd, Dd, Dd, Dd, Hd, Qxe, Qxe, Ds, Hd, Ds, Dd, Ds, Hd, Dd^Vda, Hd, Hd, Dd^Vdt, Mdd, Hd, Mdd, Mdd, Mdd^Xm, Mdd, Mdd, Hd, Hd, Mdd, Qxe, Qxe, Qxe, Qxe, Qxe, Qxe, Qxe, Qxe, Qxe, Qxe, Qxe, Qxe, Qxe
Wo, Wo, Wo, Wo, Wo, Ww, Ww, Ww, Ww, Ww, Ww, Ww, Wwr, Wwf, Ss, Ss, Ds, Gs, Gs, Rd, Gs^Fds, Gs, Gs, Gd, Gs^Fds, Gs^Fds, Gg, Gs, Gs^Fds, Gs^Fds, Gs^Ftd, Gs^Fds, Gs, Gg, Gg, Gg, Gs, Gs^Ftd, Gll, Gs^Fms, Gd, Gs^Fds, Gs^Fds, Gs^Fms, Gs^Fds, Gs, Gs^Fds, Chr, Hh, Mm^Vhh, Mm, Hh, Hh, Hh, Hh, Mm, Mm^Xm, Mm^Xm, Mm, Mm, Hh^Vhh, Mm, Mm, Mm^Xm, Mm^Xm, Mm, Mm, Mm^Xm, Mm^Xm, Mm, Hh, Hh, Hh, Gs^Fdw, Hh, Ce, Hh, Hh, Hh, Hh, Re, Re, Gs, Re, Ds, Gs^Fdw, Gs^Fdw, Gs, Gs, Ds, Hh, Gd, Gs^Fdw, Gd, Ds, Gs^Fdw, Ds, Gd^Fdw, Gd^Fdw, Gs, Gd, Gd, Gd^Fdw, Ds, Ds, Ds, Ds, Ds, Re, Gs, Gs, Rd, Rd, Ss, Ss, Rd, Ds, Ko, Co, Rd, Rd, Ss, Ss, Ss, Re, Re, Ss, Re, Re, Gll, Ss, Ss, Re, Rd, Ds, Rd, Hd, Gs, Dd, Hd, Re, Dd, Hd, Hd, Hd, Ds, Rd, Dd, Hd, Dd, Dd^Do, Dd, Rd, Rd, Ds, Dd, Hd, Dd, Hd, Re, Ds, Hd, Ds, Ds, Dd, Dd, Dd, Qxe, Dd, Dd, Hd, Ce, Dd, Hd, Dd, Hd, Hd, Hd, Hd, Hd, Hd, Hd, Mdd, Mdd^Xm, Mdd, Mdd, Mdd, Mdd, Hd, Hd, Qxe, Qxe, Qxe, Qxe, Qxe, Qxe, Qxe, Qxe, Qxe, Qxe, Qxe, Qxe
Wo, Wo, Wo, Wo, Wo, Wo, Ww^Vm, Ww, Ww, Wwr, Wwr, Ww, Ww, Ww, Ww, Ss, Ds, Ss, Gs, Rp, Rd, Gs, Gs, Gg, Gs^Ftd, Gs^Fds, Gs^Fds, Gg, Gs^Fds, Gs^Ftd, Gs^Ftd, Gs^Fds, Gs, Gs, Gs^Fp, Gs, Gs^Fds, Gs, Gs, Gg, Gg, Gs, Gs, Gs^Fts, Gs^Fms, Gg, Hh, Gs^Fds, Hh, Mm, Hh, Hh, Hh, Mm, Mm^Xm, Mm^Xm, Mm, Mm, Hh, Hh, Hh, Mm, Mm, Mm^Xm, Mm^Xm, Mm^Xm, Mm, Mm^Xm, Mm^Xm, Mm, Mm, Hh, Hh, Gs, Hh, Gs, Gs^Fdw, Ds, Gs, Hh, Re, Gs, Gs^Fdw, Gs, Gs^Fdw, Ds, Gs^Fdw, Gs, Gs, Hh, Gd^Fdw, Gd^Fdw, Gd, Gd, Gd, Ds, Ds, Gs, Gd^Fdw, Gs, Gs, Gd, Gd, Gs, Gs^Fdw, Gs, Rd, Chr, Chw, Ds, Ds, Ds, Ds, Gs, Re, Re, Gs, Ss, Gs, Rd, Rd, Gd, Gd, Ss^Vhs, Ds, Ss, Ss, Gd, Ss, Rd, Ss, Re, Rd, Ss, Gll, Rd, Ds, Hd, Hd, Hd, Re, Dd, Hd, Dd, Rd, Hd, Hd, Rd, Hd, Dd, Dd, Dd, Ds, Dd, Ds, Dd, Dd, Hd, Re, Ds, Dd, Ds, Dd, Hd, Dd, Dd, Dd, Dd^Dc, Dd, Dd, Ce, Ce, Dd, Dd, Dd, Dd, Dd, Hd, Mdd, Hd, Mdd, Mdd, Mdd, Mdd^Xm, Mdd, Mdd, Hd, Hd, Hd, Qxe, Qxe, Qxe, Qxe, Qxe, Qxe, Qxe, Qxe, Qxe, Qxe, Qxe, Qxe, Qxe
Wo, Wo, Wo, Wo, Wo, Wo, Wo, Wo, Wo, Ww, Ww, Wwr, Ww, Ww, Ww, Wwf, Ww, Ds, Ds, Gs, Gs, Rp, Rp, Gs, Gs^Ftd, Gs, Gs, Gs^Fds, Gg, Chr, Gs^Ftd, Gs^Fds, Gs^Ftd, Gs^Ftd, Gs^Ftd, Gll^Ftd, Gs^Fds, Gll^Fds, Gg^Fds, Gs, Gs, Gs, Gs, Gs^Fts, Hh, Hh, Hh, Gs^Fds, Chr, Chr, Hh, Hh, Mm, Mm, Mm^Xm, Mm, Hh, Hh, Hh, Hh, Hh, Mm, Mm^Xm, Mm^Xm, Mm^Xm, Mm^Xm, Mm^Xm, Mm, Mm^Xm, Mm^Xm, Mm^Xm, Mm, Mm, Hh, Hh, Gs^Fdw, Gs^Fdw, Gs, Gs, Hh, Hh, Re, Re, Gs^Fdw, Gs^Fdw, Chr, Ds, Gs, Gs^Fdw, Gs^Fdw, Gs, Gd, Ds, Gd, Gd, Gd, Gd^Fdw, Gs^Ftd, Gd^Ftd, Gs^Fdw, Gd^Fdw, Gd^Fdw, Gs, Gd, Gs^Fdw, Gs, Rd, Chs, Ss, Ds, Ss, Rd, Gs, Ds, Re, Rd, Ss, Ss, Ss, Re, Ss, Rd, Rd, Re, Ds, Gd, Rd, Gll, Ss, Rd, Ss, Gll, Rd, Ss, Ds, Ds, Re, Gs, Gs, Re, Re, Dd, Dd, Hd, Rd, Dd, Dd, Dd, Rd, Hd, Ds, Ds, Re, Re, Hd, Rd, Dd, Re, Re, Dd, Hd, Dd, Dd, Dd, Dd, Dd, Hd, Hd, Hd, Dd, Hd, Dd, Dd, Dd, Dd, Dd^Vda, Dd, Hd, Hd, Mdd, Mdd, Mdd, Mdd, Mdd, Mdd, Mdd, Mdd, Hd, Qxe, Qxe, Hd, Qxe, Qxe, Qxe, Qxe, Qxe, Qxe, Qxe, Qxe, Qxe, Qxe, Qxe
Wo, Wo, Wo, Wo, Wo, Wo, Wo, Wo, Wo, Wo, Ww, Ww, Ww, Wo, Wo, Wo, Wwr, Ww, Ss, Ds, Ss^Vhs, Gs, Gs, Rd, Gs^Fds, Gs^Ftd, Gs^Fds, Gs, Gg, Gs^Fds, Gs^Fds, Gs^Ftd, Gs^Fds, Gs, Gs^Fds, Gll^Fds, Gll^Fds, Gll^Fds, Gll^Fds, Gll^Fds, Gll^Fds, Gs^Fts, Gs^Fts, Gs^Fts, Gs^Fds, Gs^Fds, Gs^Fds, Gs^Fds, Chr, Hh, Hh, Mm, Mm, Mm^Xm, Mm, Mm, Hh, Hh, Mm, Mm, Mm^Xm, Mm^Xm, Mm^Xm, Mm^Xm, Mm^Xm, Mm^Xm, Mm^Xm, Mm, Mm, Mm^Xm, Mm^Xm, Mm^Xm, Mm^Xm, Mm, Mm, Gs, Gs^Fdw, Gs^Fdw, Gs, Gs, Gs, Ds, Re, Gs^Fdw, Chr, Chr, Gs, Gs, Hh, Gs^Fdw, Gs, Gd, Ds, Gs^Fdw, Gs^Fdw, Gd^Fdw, Gd^Ftd, Gd^Ftd, Gs^Fdw, Gs, Hh, Gs, Gs^Fdw, Gd^Ftd, Gs^Fdw, Ds, Ds, Ds, Gs, Ss, Ss, Ss, Rd, Rd, Rd, Rd, Ds, Ss, Gs, Re, Ds, Ds, Ds, Re, Ds, Ds, Gd, Rd, Re, Gll, Re, Ss, Rd, Re, Ds, Re, Ds, Gs, Re, Dd, Hd, Dd, Re, Dd, Re, Rd, Re, Re, Dd, Dd, Dd, Dd, Re, Hd, Hd, Dd, Hd, Dd, Hd, Dd, Dd, Hd, Dd, Dd, Dd, Ce, Ce, Dd, Dd, Dd, Dd^Do, Hd, Dd^Vda, Dd^Dc, Dd, Dd, Dd, Hd, Hd, Hd, Dd^Vdt, Hd, Hd, Hd, Hd, Mdd, Mdd, Mdd, Hd, Hd, Hd, Hd, Hd, Qxe, Qxe, Qxe, Qxe, Qxe, Qxe, Qxe, Qxe, Qxe
Wo, Wo, Wo, Wo, Wo, Wo, Wo, Wo, Wo, Wo, Wo, Wo, Wo, Wo, Wo, Wo, Wo, Ww, Ww, Ss, Ss, Ss, Ss, Rd, Rd, Gs^Fds, Gs^Fds, Gs^Fds, Gs^Fds, Gg, Gg, Gs^Fds, Gs^Fds, Gs^Fds, Gs^Fds, Gs^Fds, Gs^Fds, Gs^Fds, Gs^Fds, Gs^Fds, Gs^Fds, Gs^Fds, Gs^Fds, Gs^Fds, Gs^Fds, Gs^Fds, Gs^Fds, Gs^Fds, Gs^Fds, Gs^Fds, Hh, Mm, Mm, Mm^Xm, Mm, Hh, Hh, Hh, Mm, Mm, Mm, Mm^Xm, Hh, Mm^Xm, Mm^Xm, Mm^Xm, Mm, Mm, Mm, Mm, Hh, Mm^Xm, Mm^Xm, Mm^Xm, Mm, Gs, Gs, Gs^Fdw, Gs^Fdw, Gs, Gs, Gs, Re, Hh, Hh, Hh, Gs, Hh, Gs, Gs, Gs, Gs, Gs, Gs^Fdw, Gs^Fdw, Gd^Fdw, Gs^Fdw, Gs^Fdw, Gs^Fdw, Hh, Gs, Gs, Gs, Gs, Gs^Fdw, Gs, Gs, Gs, Gs, Gs, Gs, Ss, Ss, Ds, Gs, Ds, Gs, Ds, Gs, Gs^Fdw, Gs, Gd, Gd, Gd, Gll, Gd, Ds, Ds, Gll, Gd, Gll, Ds, Ds, Ds, Gs, Gs, Gs, Gs, Ds, Dd, Dd, Hd, Hd, Hd, Hd, Re, Dd, Dd, Dd, Dd, Dd, Dd, Dd, Dd, Dd, Hd, Dd, Dd, Dd, Hd, Dd, Hd, Hd, Dd, Dd, Dd, Dd, Dd, Dd, Dd, Dd, Dd, Dd, Dd, Dd, Dd, Dd, Dd, Dd, Hd, Hd, Hd, Hd, Hd, Md, Hd, Mdd, Hd, Hd, Hd, Hd, Hd, Hd, Qxe, Qxe, Qxe, Qxe, Qxe, Qxe, Qxe, Qxe, Qxe
