border_size=1
usage=map

Uu          , Uu          , Uu          , Uu          , Uu          , Uu          , Uu          , Uu          , Uu          , Uu          , Uu          , Uh          , Rr          , Uh          , Uu          , Uu          , Uu          , Uu          , Uu          , Uu          , Uu          , Uu          , Uu          , Uu          , Uu          , Uu          , Uu          
Uu          , Uu          , Uu          , Uu          , Uu          , Uu          , Uu          , Uu          , Uu          , Uu          , Uu          , Uu^Vud      , Rr          , Uu^Vud      , Uu          , Uu          , Uu          , Uu          , Uu          , Uu          , Uu          , Uu          , Uu          , Uu          , Uu          , Uu          , Uu          
Uu          , Uu          , Uu          , Uu          , Uu          , Uu          , Uu          , Uu          , Uu          , Uu          , Uu          , Uh          , Rr          , Uh          , Uu          , Uu          , Uu          , Uu          , Uu          , Uu          , Uu          , Uu          , Uu          , Uu          , Uu          , Uu          , Uu          
Uu          , Uu          , Uu          , Uu          , Uu^Ii       , Uu^Ii       , Uu^Ii       , Uu          , Uu          , Uu          , Uu          , Cud         , Rr          , Cud         , Uu          , Uu          , Uu          , Uu          , Uu^Ii       , Uu^Ii       , Uu^Ii       , Uu          , Uu          , Uu          , Uu          , Uu          , Uu          
Uu          , Uu          , Uu^Ii       , Uu^Ii       , Uu^Ii       , Re^Gvs      , Uu^Ii       , Uu^Ii       , Uu^Ii       , Uu          , Cud         , Uu^Vud      , Rr          , Uu^Vud      , Cud         , Uu          , Uu^Ii       , Uu^Ii       , Uu^Ii       , Re^Gvs      , Uu^Ii       , Uu^Ii       , Uu^Ii       , Uu          , Uu          , Uu          , Uu          
Uu^Ii       , Uu^Ii       , Uu^Ii       , Re^Gvs      , Uu^Ii       , Uu^Ii       , Uu^Ii       , Re^Gvs      , Uu^Ii       , Uu^Ii       , Cud         , Uh          , Rr          , Uh          , Cud         , Uu          , Uu^Ii       , Re^Gvs      , Uu^Ii       , Uu^Ii       , Uu^Ii       , Re^Gvs      , Uu^Ii       , Uu^Ii       , Uu^Ii       , Uu          , Uu          
Uu^Ii       , Re^Gvs      , Uu^Ii       , Uu^Ii       , Uu^Ii       , Re^Gvs      , Uu^Ii       , Uu^Ii       , Uu^Ii       , Cud         , Wo          , Uu^Vud      , Rr          , Uu^Vud      , Wo          , Cud         , Uu^Ii       , Uu^Ii       , Uu^Ii       , Re^Gvs      , Uu^Ii       , Uu^Ii       , Uu^Ii       , Re^Gvs      , Uu^Ii       , Uu^Ii       , Uu^Ii       
Uu^Ii       , Uu^Ii       , Uu^Ii       , Re^Gvs      , Uu^Ii       , Uu^Ii       , Uu^Ii       , Re^Gvs      , Uu^Ii       , Cud         , Wo          , Cud         , Rr          , Cud         , Wo          , Cud         , Uu^Ii       , Re^Gvs      , Uu^Ii       , Uu^Ii       , Uu^Ii       , Re^Gvs      , Uu^Ii       , Uu^Ii       , Uu^Ii       , Re^Gvs      , Uu^Ii       
Uu^Ii       , Re^Gvs      , Uu^Ii       , Uu^Ii       , Uu^Ii       , Re^Gvs      , Uu^Ii       , Uu^Ii       , Cud         , Cud         , Wo          , Cud         , Rr          , Cud         , Wo          , Cud         , Cud         , Uu^Ii       , Uu^Ii       , Re^Gvs      , Uu^Ii       , Uu^Ii       , Uu^Ii       , Re^Gvs      , Uu^Ii       , Uu^Ii       , Uu^Ii       
Uu^Ii       , Uu^Ii       , Uu^Ii       , Re^Gvs      , Uu^Ii       , Uu^Ii       , Uu          , Uu          , Cud         , Wo^Bw\      , Cud         , Cud         , Cud         , Cud         , Cud         , Wo^Bw/      , Cud         , Uu          , Uu          , Uu^Ii       , Uu^Ii       , Re^Gvs      , Uu^Ii       , Uu^Ii       , Uu^Ii       , Re^Gvs      , Uu^Ii       
Uu^Ii       , Re^Gvs      , Uu^Ii       , Uu^Ii       , Cud         , Uu          , Cud         , Cud         , Wo          , Wo          , Wo          , Cud         , Cud         , Cud         , Wo          , Wo          , Wo          , Cud         , Cud         , Uu          , Cud         , Uu^Ii       , Uu^Ii       , Re^Gvs      , Uu^Ii       , Uu^Ii       , Uu          
Uh          , Uu^Ii       , Uh          , Cud         , Uh          , Cud         , Uh          , Wo          , Cud         , Cud         , Wo^Bw/      , Cud         , 2 Kud       , Cud         , Wo^Bw\      , Cud         , Cud         , Wo          , Uu          , Cud         , Uu          , Cud         , Uu          , Uu^Ii       , Uh          , Uh          , Uh          
Rr          , Uu^Vud      , Rr          , Uu^Vud      , Rr          , Uu^Vud      , Rr          , Wo          , Rr          , Cud         , Cud         , Cud         , Cud         , Cud         , Cud         , Cud         , Rr          , Wo          , Rr          , Uu^Vud      , Rr          , Uu^Vud      , Rr          , Uu^Vud      , Rr          , Uu^Vud      , Rr          
Uh          , Rr          , Uu^Vud      , Rr          , Uu^Vud      , Rr          , Uu^Vud      , Rr          , Cud         , Rr          , Wo^Bw\      , 1 Cud       , Rr          , Cud         , Wo^Bw/      , Rr          , Cud         , Rr          , Uu^Vud      , Rr          , Uu^Vud      , Rr          , Uu^Vud      , Rr          , Uu^Vud      , Rr          , Uu          
Uu          , Uh          , Uu          , Uh          , Cud         , Uh          , Cud         , Wo          , Wo          , Cud         , Wo          , Cud         , Rr          , Cud         , Wo          , Cud         , Wo          , Wo          , Cud         , Uu          , Cud         , Uu          , Uh          , Uu          , Uh          , Uu          , Uh          
Uu          , Uu          , Uu^Ii       , Uu^Ii       , Uu^Ii       , Cud         , Uu^Ii       , Cud         , Cud         , Wo          , Cud         , Cud         , Rr          , Cud         , Cud         , Wo          , Cud         , Cud         , Uu^Ii       , Cud         , Uu^Ii       , Uh          , Uu^Ii       , Uh          , Uu          , Uh          , Uu          
Uu^Ii       , Uu^Ii       , Uu^Ii       , Re^Gvs      , Uu^Ii       , Uu^Ii       , Re^Gvs      , Uu^Ii       , Cud         , Wo^Bw/      , Wo          , Wo          , Rr          , Wo          , Wo          , Wo^Bw\      , Cud         , Uu^Ii       , Re^Gvs      , Uu^Ii       , Uu^Ii       , Re^Gvs      , Uu^Ii       , Uu^Ii       , Uu^Ii       , Uu          , Uu          
Uu^Ii       , Re^Gvs      , Uu^Ii       , Uu^Ii       , Re^Gvs      , Uu^Ii       , Uu^Ii       , Uu^Ii       , Uu^Ii       , Cud         , Cud         , Wo          , Rr          , Wo          , Cud         , Cud         , Uu^Ii       , Uu^Ii       , Uu^Ii       , Uu^Ii       , Re^Gvs      , Uu^Ii       , Uu^Ii       , Re^Gvs      , Uu^Ii       , Uu          , Uu          
Uu          , Uu^Ii       , Re^Gvs      , Uu^Ii       , Uu^Ii       , Uu^Ii       , Uu^Ii       , Re^Gvs      , Uu^Ii       , Uu^Ii       , Cud         , Wo          , Rr          , Wo          , Cud         , Uu^Ii       , Uu^Ii       , Re^Gvs      , Uu^Ii       , Uu^Ii       , Uu^Ii       , Uu^Ii       , Re^Gvs      , Uu^Ii       , Uu          , Uu          , Uu          
Uu          , Uu^Ii       , Uu^Ii       , Uu^Ii       , Uu^Ii       , Re^Gvs      , Uu^Ii       , Uu^Ii       , Re^Gvs      , Uu^Ii       , Uu^Ii       , Uu^Vud      , Rr          , Uu^Vud      , Uu^Ii       , Uu^Ii       , Re^Gvs      , Uu^Ii       , Uu^Ii       , Re^Gvs      , Uu^Ii       , Uu^Ii       , Uu^Ii       , Uu^Ii       , Uu          , Uu          , Uu          
Uu          , Uu          , Uu^Ii       , Re^Gvs      , Uu^Ii       , Uu^Ii       , Re^Gvs      , Uu^Ii       , Uu^Ii       , Uu^Ii       , Re^Gvs      , Cud         , Rr          , Cud         , Re^Gvs      , Uu^Ii       , Uu^Ii       , Uu^Ii       , Re^Gvs      , Uu^Ii       , Uu^Ii       , Re^Gvs      , Uu^Ii       , Uu          , Uu          , Uu          , Uu          
Uu          , Uu          , Uu          , Uu^Ii       , Re^Gvs      , Uu^Ii       , Uu^Ii       , Uu^Ii       , Re^Gvs      , Uu^Ii       , Uu^Ii       , Uh          , Rr          , Uh          , Uu^Ii       , Uu^Ii       , Re^Gvs      , Uu^Ii       , Uu^Ii       , Uu^Ii       , Re^Gvs      , Uu^Ii       , Uu          , Uu          , Uu          , Uu          , Uu          
Uu          , Uu          , Uu          , Uu^Ii       , Uu^Ii       , Uu^Ii       , Re^Gvs      , Uu^Ii       , Uu^Ii       , Uu^Ii       , Uu          , Uu^Vud      , Rr          , Uu^Vud      , Uu          , Uu^Ii       , Uu^Ii       , Uu^Ii       , Re^Gvs      , Uu^Ii       , Uu^Ii       , Uu^Ii       , Uu          , Uu          , Uu          , Uu          , Uu          
Uu          , Uu          , Uu          , Uu          , Uu          , Uu^Ii       , Uu^Ii       , Uu^Ii       , Uu          , Uu          , Uu          , Uh          , Rr          , Uh          , Uu          , Uu          , Uu          , Uu^Ii       , Uu^Ii       , Uu^Ii       , Uu          , Uu          , Uu          , Uu          , Uu          , Uu          , Uu          
Uu          , Uu          , Uu          , Uu          , Uu          , Uu          , Uu          , Uu          , Uu          , Uu          , Uu          , Uu^Vud      , Rr          , Uu^Vud      , Uu          , Uu          , Uu          , Uu          , Uu          , Uu          , Uu          , Uu          , Uu          , Uu          , Uu          , Uu          , Uu          
Uu          , Uu          , Uu          , Uu          , Uu          , Uu          , Uu          , Uu          , Uu          , Uu          , Uu          , Uh          , Rr          , Uh          , Uu          , Uu          , Uu          , Uu          , Uu          , Uu          , Uu          , Uu          , Uu          , Uu          , Uu          , Uu          , Uu          
Uu          , Uu          , Uu          , Uu          , Uu          , Uu          , Uu          , Uu          , Uu          , Uu          , Uu          , Uh          , Rr          , Uh          , Uu          , Uu          , Uu          , Uu          , Uu          , Uu          , Uu          , Uu          , Uu          , Uu          , Uu          , Uu          , Uu          
