border_size=1
usage=map

Ms          , Ms          , Ha          , Ms          , Ms          , Ms          , Ha          , Ms          , Ha          , Aa          , Aa          , Aa          , Aa          , Aa          , Ha          , Ms          , Ms          , Ms          , Ms          , Ms          
Ms          , Ms          , Ha          , Ms          , Ha          , Aa^Fpa      , Aa^Fpa      , Mm          , Hh^Fmw      , Gs^Fmw      , Aa^Fma      , Aa          , Aa          , Ha          , Aa          , Gs^Fmw      , Aa^Fma      , Ms          , Ms          , Ms          
Ms          , Ms          , Ms          , Ha          , Ha          , Mm^Xm       , Mm          , Hh^Fmw      , Aa^Fma      , Gs^Fmw      , Aa^Fpa      , Gs          , Gs          , Aa          , Gs^Fmw      , Gs^Fp       , Aa^Fma      , Aa^Fpa      , Ms          , Ms          
Mm          , Mm^Xm       , Ms          , Ms          , Mm          , Mm^Xm       , Hh^Fmw      , Gs^Fmw      , Aa^Fma      , Aa^Fma      , Ha          , Ha          , Aa          , Gs^Fmw      , Gs^Fmw      , Hh^Fmw      , Ms          , Mm^Xm       , Mm^Xm       , Mm^Xm       
Mm          , Mm^Xm       , Mm          , Mm          , Ha          , Hh          , Aa^Fpa      , Hh          , Gs^Fp       , Aa^Fda      , Aa^Fpa      , Aa          , Aa^Fma      , Aa          , Gs          , Gs^Fp       , Hh          , Mm^Xm       , Mm^Xm       , Mm^Xm       
Mm          , Mm          , Mm^Xm       , Mm          , Mm          , Mm          , Aa^Fda      , Aa^Fma      , Aa          , Aa          , Aa^Fma      , Aa          , Aa^Fda      , Aa          , Gs          , Aa^Fpa      , Gg          , Mm^Xm       , Mm^Xm       , Mm^Xm       
Mm          , Mm^Xm       , Mm^Xm       , Mm^Xm       , Ha          , Ha          , Ha^Fpa      , Aa^Fda      , Gs          , Aa          , Aa          , Aa^Fpa      , Gs          , Gs          , Aa^Fma      , Aa^Fpa      , Mm          , Mm^Xm       , Mm^Xm       , Mm^Xm       
Mm          , Mm          , Mm^Xm       , Mm^Xm       , Ha          , Mm^Xm       , Ha^Fpa      , Aa          , Ha^Fpa      , Aa          , Aa^Fma      , Aa^Fma      , Hh^Fmw      , Aa          , Aa^Fpa      , Hh          , Mm          , Mm^Xm       , Mm^Xm       , Mm^Xm       
Mm          , Mm          , Mm          , Mm^Xm       , Mm          , Mm          , Mm          , Mm          , Ha          , Aa^Fpa      , Aa^Fma      , Aa^Fpa      , Aa          , Hh^Fmw      , Mm          , Mm          , Mm^Xm       , Mm^Xm       , Mm^Xm       , Mm          
Mm          , Mm          , Mm^Xm       , Mm^Xm       , Mm          , Mm          , Ha          , Hh          , Aa^Fpa      , Gs^Fmw      , Aa^Fma      , Aa          , Gs^Fmw      , Hh          , Mm          , Mm^Xm       , Mm^Xm       , Mm          , Mm^Xm       , Mm          
Mm          , Mm^Xm       , Mm^Xm       , Mm          , Mm          , Mm          , Ha^Fpa      , Ha          , Aa^Fpa      , Aa^Fma      , Aa          , Aa          , Gs^Fmw      , Aa^Fda      , Mm          , Mm          , Mm          , Mm          , Mm^Xm       , Mm          
Mm          , Mm          , Mm^Xm       , Mm          , Hh          , Hh^Fmw      , Aa^Fpa      , Gs^Fmw      , Gs          , Aa          , Aa^Fda      , Aa          , Aa          , Hh          , Aa^Fpa      , Mm          , Mm          , Mm^Xm       , Mm^Xm       , Mm          
Mm          , Mm          , Mm^Xm       , Ha^Fma      , Ha          , Ha^Fma      , Ha          , Gs^Fp       , Gs          , Aa^Fpa      , Gs^Fp       , Gs^Fmw      , Aa^Fpa      , Gs          , Gs          , Hh^Fmw      , Ha^Fma      , Mm          , Mm          , Mm          
Mm          , Mm          , Mm^Xm       , Ha          , Mm          , Ha          , Ha^Fpa      , Aa          , Gs          , Gs          , Aa          , Aa          , Gs^Fp       , Aa          , Gs          , Aa^Fpa      , Ha          , Mm          , Mm          , Mm          
Mm          , Mm          , Mm^Xm       , Mm^Xm       , Ha^Fma      , Ha          , Ha^Fpa      , Gs^Fp       , 1 Gs        , Aa^Fma      , Gs          , Aa          , Gs^Fmw      , Aa^Fma      , Aa^Fma      , Aa^Fpa      , Mm          , Mm          , Ha          , Mm^Xm       
Mm          , Mm^Xm       , Mm          , Ha          , Mm          , Mm          , Ha          , Gs^Fmw      , Gs^Fp       , Gs          , Aa          , Aa^Fpa      , Gs^Fp       , Gs^Fmw      , Ha          , Hh          , Hh          , Ha          , Mm          , Mm^Xm       
Mm          , Mm^Xm       , Mm^Xm       , Mm          , Mm          , Mm          , Ha          , Ha          , Mm          , Gs          , Gs          , Aa          , Aa^Fpa      , Ha          , Mm          , Hh          , Mm^Xm       , Mm          , Mm          , Mm          
Mm          , Mm^Xm       , Mm^Xm       , Mm          , Mm          , Mm          , Mm          , Mm          , Mm          , Mm          , Gs          , Aa          , Mm          , Mm^Xm       , Mm^Xm       , Mm^Xm       , Mm^Xm       , Mm^Xm       , Mm^Xm       , Mm          
Xu          , Xu          , Mm^Xm       , Mm^Xm       , Mm^Xm       , Mm^Xm       , Xu          , Mm^Xm       , Xu          , Mm          , Gs          , Gs          , Xu          , Mm^Xm       , Xu          , Xu          , Xu          , Xu          , Xu          , Xu          
Xu          , Xu          , Xu          , Xu          , Xu          , Xu          , Xu          , Xu          , Xu          , Uu^Ii       , Uu^Ii       , Uu^Ii       , Xu          , Xu          , Xu          , Xu          , Xu          , Xu          , Xu          , Xu          
Xu          , Xu          , Xu          , Xu          , Xu          , Xu          , Xu          , Xu          , Xu          , Uu^Ii       , Uu^Ii       , Uu^Ii       , Uu^Ii       , Xu          , Xu          , Xu          , Xu          , Xu          , Xu          , Xu          
Xu          , Xu          , Xu          , Xu          , Xu          , Xu          , Xu          , Xu          , Xu          , Uu^Ii       , Uu^Ii       , Uu^Ii       , Uu^Ii       , Xu          , Xu          , Xu          , Xu          , Xu          , Xu          , Xu          
