border_size=1
usage=map

Ms^Xm, Mm^Xm, Mm^Xm, Mm^Xm, Mm^Xm, Mm^Xm, Ms, Ms, Ha, Ms, Ms, Ms, Ha, Ms, Ha, Aa, Aa, Aa, Aa, Aa, Ha, Ms, Ms, Ms, Ms, Ms, Ms^Xm, Ms^Xm, Ms^Xm, Ms^Xm, Ms^Xm, Ms^Xm
Ms^Xm, Mm^Xm, Mm^Xm, Mm^Xm, Ms^Xm, Mm^Xm, Ms, Ms, Ha, Ms, Ha, Aa^Fpa, Aa^Fpa, Mm, Hhd^Fmw, Gs^Fmw, Aa^Fma, Aa, Aa, Ha, Aa, Gll^Fmw, Aa^Fma, Ms, Ms, Ms, Mm^Xm, Mm^Xm, Mm^Xm, Ms^Xm, Ms^Xm, Ms^Xm
Ms^Xm, Mm^Xm, Mm^Xm, Ms^Xm, Ms^Xm, Mm^Xm, Ms, Ms, Ms, Ha, Ha, Ms^Xm, Mm, Hhd^Fmw, Aa^Fma, Gs^Fmw, Aa^Fpa, Gs, Gs, Aa, Gll^Fmw, Gll^Fp, Aa^Fma, Aa^Fpa, Ms, Ms, Mm^Xm, Mm^Xm, Mm^Xm, Ms^Xm, Ms^Xm, Mm^Xm
Ms^Xm, Ms^Xm, Ms^Xm, Ms^Xm, Ms^Xm, Mm^Xm, Ms, Ms^Xm, Ms, Ms, Ms, Ms^Xm, Hhd^Fmw, Gs^Fmw, Aa^Fma, Aa^Fma, Ha, Ha, Aa, Gs^Fmw, Gll^Fmw, Hhd^Fmw, Ms, Ms^Xm, Ms^Xm, Ms^Xm, Mm^Xm, Mm^Xm, Mm^Xm, Ms^Xm, Mm^Xm, Mm^Xm
Ms^Xm, Ms^Xm, Ms^Xm, Ms^Xm, Ms^Xm, Ms^Xm, Ms, Ms^Xm, Ms, Ms, Ha, Hhd, Aa^Fpa, Hhd, Gs^Fp, Aa^Fda, Aa^Fpa, Aa, Aa^Fma, Aa, Gd, Gll^Fp, Hhd, Ms^Xm, Ms^Xm, Ms^Xm, Mm^Xm, Mm^Xm, Mm^Xm, Mm^Xm, Mm^Xm, Mm^Xm
Mm^Xm, Ms^Xm, Ms^Xm, Ms^Xm, Mm^Xm, Mm^Xm, Ms, Ms, Ms^Xm, Ms, Ms, Ms, Aa^Fda, Aa^Fma, Aa, Aa, Aa^Fma, Aa, Aa^Fda, Aa, Gd, Aa^Fpa, Gd, Ms^Xm, Ms^Xm, Ms^Xm, Ms^Xm, Mm^Xm, Mm^Xm, Mm^Xm, Ms^Xm, Mm^Xm
Mm^Xm, Ms^Xm, Mm^Xm, Ms^Xm, Mm^Xm, Mm^Xm, Ms, Ms^Xm, Ms^Xm, Ms^Xm, Ha, Ha, Ha^Fpa, Aa^Fda, Gs, Aa, Aa, Aa^Fpa, Gs, Gd, Aa^Fma, Aa^Fpa, Ms, Mm^Xm, Ms^Xm, Mm^Xm, Ms^Xm, Ms^Xm, Ms^Xm, Ms^Xm, Ms^Xm, Mm^Xm
Mm^Xm, Mm^Xm, Mm^Xm, Mm^Xm, Mm^Xm, Ms^Xm, Ms, Ms, Ms^Xm, Ms^Xm, Ha, Mm^Xm, Ha^Fpa, Aa, Ha^Fpa, Aa, Aa^Fma, Aa^Fma, Hhd^Fmw, Aa, Aa^Fpa, Hhd, Mm, Ms^Xm, Ms^Xm, Ms^Xm, Ms^Xm, Ms^Xm, Ms^Xm, Ms^Xm, Ms^Xm, Mm^Xm
Ms^Xm, Ms^Xm, Ms^Xm, Ms^Xm, Ms^Xm, Ms^Xm, Ms, Ms, Ms, Ms^Xm, Mm, Mm, Mm, Mm, Ha, Aa^Fpa, Aa^Fma, Aa^Fpa, Aa, Hhd^Fmw, Ms, Mm, Mm^Xm, Mm^Xm, Mm^Xm, Mm^Xm, Ms^Xm, Mm^Xm, Mm^Xm, Ms^Xm, Ms^Xm, Mm^Xm
Mm^Xm, Ms^Xm, Ms^Xm, Ms^Xm, Ms^Xm, Ms^Xm, Mm, Ms, Ms^Xm, Ms^Xm, Mm, Mm, Ha, Hhd, Aa^Fpa, Gs^Fmw, Aa^Fma, Aa, Gs^Fmw, Hhd, Mm, Mm^Xm, Mm^Xm, Mm^Xm, Mm^Xm, Mm^Xm, Ms^Xm, Ms^Xm, Mm^Xm, Ms^Xm, Ms^Xm, Mm^Xm
Mm^Xm, Ms^Xm, Ms^Xm, Ms^Xm, Ms^Xm, Mm^Xm, Mm, Mm^Xm, Mm^Xm, Mm, Mm, Mm, Ha^Fpa, Ha, Aa^Fpa, Aa^Fma, Aa, Aa, Gs^Fmw, Aa^Fda, Mm, Mm, Mm^Xm, Mm^Xm, Mm^Xm, Mm^Xm, Ms^Xm, Mm^Xm, Ms^Xm, Ms^Xm, Ms^Xm, Ms^Xm
Mm^Xm, Mm^Xm, Ms^Xm, Ms^Xm, Mm^Xm, Mm^Xm, Mm, Mm, Mm^Xm, Mm, Hhd, Hhd^Fmw, Aa^Fpa, Gd^Fmw, Gs, Aa, Aa^Fda, Aa, Aa, Hhd, Aa^Fpa, Mm^Xm, Ms^Xm, Mm^Xm, Ms^Xm, Ms, Ms^Xm, Ms^Xm, Ms^Xm, Ms^Xm, Ms^Xm, Ms^Xm
Mm^Xm, Mm^Xm, Mm^Xm, Mm^Xm, Mm^Xm, Mm^Xm, Mm, Mm, Mm^Xm, Ha^Fma, Ha, Ha^Fma, Ha, Gd^Fp, Gd, Aa^Fpa, Gs^Fp, Gs^Fmw, Aa^Fpa, Gs, Gd, Hhd^Fmw, Ha^Fma, Ms, Ms, Ms, Mm^Xm, Mm^Xm, Mm^Xm, Ms^Xm, Ms^Xm, Ms^Xm
Mm^Xm, Mm^Xm, Mm^Xm, Mm^Xm, Ms^Xm, Mm^Xm, Mm, Mm, Mm^Xm, Ha, Ms, Ha, Ha^Fpa, Aa, Gd, Gd, Aa, Aa, Gs^Fp, Gs, Gs, Aa^Fpa, Ha, Ms, Ms, Ms, Ms^Xm, Mm^Xm, Mm^Xm, Mm^Xm, Ms^Xm, Ms^Xm
Ms^Xm, Mm^Xm, Mm^Xm, Ms^Xm, Ms^Xm, Ms^Xm, Ms^Xm, Mm, Ms^Xm, Ms^Xm, Ha^Fma, Ha, Ha^Fpa, Gs^Fp, Gs, Aa^Fma, Gd, Aa, Gs^Fmw, Aa^Fma, Aa^Fma, Aa^Fpa, Ms, Ms, Ha, Ms^Xm, Ms^Xm, Mm^Xm, Ms^Xm, Mm^Xm, Ms^Xm, Ms^Xm
Ms^Xm, Ms^Xm, Ms^Xm, Ms^Xm, Ms^Xm, Ms^Xm, Ms^Xm, Mm^Xm, Ms, Ha, Ms, Ms, Ha, Gs^Fmw, Gs^Fp, Gd, Gd, Gs, Gs^Fp, Gs^Fmw, Ha, Hhd, Hhd, Ha, Ms, Ms^Xm, Ms^Xm, Ms^Xm, Ms^Xm, Mm^Xm, Ms^Xm, Ms^Xm
Ms^Xm, Ms^Xm, Ms^Xm, Ms^Xm, Ms^Xm, Ms^Xm, Ms^Xm, Ms^Xm, Ms^Xm, Ms, Ms, Ms, Ha, Ha, Ms, Gs, Gs, Gd, Aa^Fpa, Ha, Ms, Hhd, Ms^Xm, Ms, Ms, Ms, Ms^Xm, Ms^Xm, Ms^Xm, Ms^Xm, Ms^Xm, Ms^Xm
Ms^Xm, Ms^Xm, Ms^Xm, Ms^Xm, Ms^Xm, Ms^Xm, Ms^Xm, Ms^Xm, Ms^Xm, Ms, Ms, Ms, Ms, Ms, Ms, Ms, Gs, Aa, Ms, Ms^Xm, Ms^Xm, Ms^Xm, Ms^Xm, Ms^Xm, Ms^Xm, Ms, Ms^Xm, Ms^Xm, Ms^Xm, Ms^Xm, Ms^Xm, Ms^Xm
Xue, Xue, Xue, Xue, Xue, Xue, Xue, Xue, Ms^Xm, Ms^Xm, Ms^Xm, Ms^Xm, Xue, Ms^Xm, Xue, Ms, Gs, Gd, Xue, Ms^Xm, Xue, Xue, Xue, Xue, Xue, Xue, Xue, Xue, Xue, Xue, Xue, Xue
Xue, Xue, Xue, Xue, Xue, Xue, Xue, Xue, Xue, Xue, Xue, Xue, Xue, Xue, Xue, Uue, Uue, Uue, Xue, Xue, Xue, Xue, Xue, Xue, Xue, Xue, Xue, Xue, Xue, Xue, Xue, Xue
Xue, Xue, Xue, Xue, Xue, Xue, Xue, Xue, Xue, Xue, Xue, Xue, Xue, Xue, Xue, Uue, Uue, 1 Uue, Uue, Xue, Xue, Xue, Xue, Xue, Xue, Xue, Xue, Xue, Xue, Xue, Xue, Xue
Xue, Xue, Xue, Xue, Xue, Xue, Xue, Xue, Xue, Xue, Xue, Xue, Xue, Xue, Xue, Uue, Uue, Uue, Uue, Xue, Xue, Xue, Xue, Xue, Xue, Xue, Xue, Xue, Xue, Xue, Xue, Xue
