border_size=1
usage=map

Gg          , Gg          , Gg          , Gg          , Gg          , Gg          , Gs          , Rr          , Gs          , Gg          , Gg          , Gg          , Rr          , Gg          , Gg          , Gg          , Gg          , Gg          , Gg          , Gg          , Gg          , Gg          
Gg          , Gg          , Gg          , Gg          , Gg          , Gs          , Gs          , Rr          , Ce          , Gg          , Gs^Fds      , Gg          , Rr          , Gg          , Gg          , Gg          , Gs^Fds      , Gs^Fds      , Gs^Fds      , Gg          , Gg          , Gg          
Gg          , Gg          , Ke          , Gg          , Ce          , Gg          , Rr          , Rr          , Gs          , Gs^Fds      , Gs^Fds      , Gg          , Rr          , Gg          , Ce          , Gs          , Ce          , Gs^Fds      , Ce          , Gg          , Gg          , Gg          
Gg          , Ce          , Gg          , Ce          , Gg^Fet      , Ce          , Rp          , Rr          , Ce          , Ke          , Ce          , Ce          , Rr          , Gg          , Gg^Ve       , Ce          , Gs          , Ke          , Gs^Fds      , Ce          , Gs^Fds      , Gg          
Ww          , Gg          , Gs^Fms      , Gs^Fms      , Gs^Fms      , Gs^Fds      , Rp          , Rr          , Gs^Fms      , Wwf         , Wwf         , Wwf         , Rp          , Gs          , Gs          , Gs^Fp       , Gs^Fds      , Gg          , Gs^Fds      , Ke          , Ce          , Gs          
Ww          , Ww          , Ww          , Gs^Fds      , Gs          , Gs          , Rp          , Gs^Fds      , Wwf         , Wwf         , Gs^Fms      , Wwf         , Gs^Fms      , Rp          , Rp          , Gs          , Gs^Fms      , Gs^Fms      , Gg          , Gs^Fp       , Gs          , Gs          
Ww          , Ww          , Wo          , Ww          , Ww          , Gg^Ve       , Ww^Bw|      , Gs^Fds      , Wwf         , Gs^Fms      , Gs^Fms      , Rp^Vhc      , Gs^Fms      , Gs^Fms      , Rp          , Gg^Wm       , Gs          , Gs^Fms      , Gs^Fds      , Gg          , Gs^Fp       , Gs          
Gg          , Ww          , Ss          , Wo          , Wo          , Ww          , Ww^Bw|      , Ww          , Ss          , Ss          , Gg          , Rp          , Rp          , Gg          , Rp          , Rp          , Rp          , Gg^Vh       , Gs^Fds      , Gs^Fms      , Gs          , Gs          
Gg          , Gg          , Chs         , Ss          , Ww          , Wo          , Rr          , Ww          , Ww          , Ss          , Gs^Fxo      , Rp          , Rp^Vhc      , Rp          , Rp          , Rp^Vhc      , Rr          , Gg          , Gs^Fxo      , Gs^Fms      , Gs^Fms      , Gs          
Gg          , Gg          , Gg          , Ww          , Ww          , Gg          , Rr          , Ss          , Ww          , Ww          , Gg^Vh       , Rp          , Rp^Vhc      , Rr          , Rp          , Rp^Vhc      , Ss          , Ss          , Ss          , Gs^Fms      , Ww          , Ww          
Ggf         , Ke          , Ce          , Gg^Ve       , Ww          , Gg^Wm       , Rr          , Ss          , Ww          , Ww          , Ww          , Gs^Fms      , Gs^Fms      , Rr          , Rr          , Gg          , Ww          , Ww          , Wo          , Wo          , Ww          , Ww          
Rr          , Gg          , Rr          , Ggf         , Rr          , Rr          , Rp^Vhc      , Gg^Fet      , Gg^Vh       , Ww          , Wo          , Ww          , Ww          , Gg^Ve       , Ww^Bw|      , Ww          , Wo          , Wo          , Ww          , Ss          , Ss          , Ww          
Gg          , Rr          , Ce          , Rr          , Gg^Vh       , Rp          , Rp          , Gs^Fms      , Gs^Fms      , Ch          , Ww          , Wo          , Ch          , Ww          , Ww^Bw|      , Ww          , Ch          , Kh          , Gs^Fms      , Gs^Fms      , Gg          , Gg          
Ggf         , Gg          , Ce          , Gs^Fms      , Ww          , Gs^Fms      , Rp          , Rp          , Rp          , Ggf         , Ww          , Wo          , Gg^Fet      , Gs^Fms      , Rp          , Gg          , Rp^Vhc      , Gs^Fms      , Ggf         , Gg          , Gg          , Gg          
Ggf         , Gg          , Gg          , Gs^Fds      , Rp          , Rp          , Ch          , Gs^Fms      , Ww          , Ww^Bw\      , Ww^Bw\      , Ww          , Gg^Ve       , Ggf         , Ch          , Rp          , Ggf         , Gs^Fms      , Gg^Ve       , Ch          , Ss          , Ss          
Rr          , Rr          , Rr          , Rr          , Gs^Fms      , Rp^Vhc      , Ww          , Ww          , Ww          , Ww          , Ss          , Ggf         , Ch          , Ch          , Ch          , Rp          , Rp          , Gg^Fet      , Gs^Fp       , Kh          , Ss          , Ss          
Gg          , Ce          , Ww          , Gg^Wm       , Ww          , Gs^Fms      , Ww          , Ww          , Gs^Fms      , Gs^Fms      , Ss          , Gg^Ve       , Ch          , 2 Kh        , Ch          , Gg^Fet      , Gs^Fds      , Rp          , Ggf         , Ch          , Gs^Fms      , Ss          
Ww          , Ww          , Ke          , Ww          , Gs^Fds      , Ww          , Ww          , Kh          , Ch          , Gs^Fds      , Rp          , Ss          , Rp          , Ch          , Gs^Fds      , Ch          , Rp          , Rp          , Gs^Fxo      , Ch          , Gs^Fds      , Gs^Fms      
Gg          , Ggf         , Ce          , Gs^Vht      , Rp          , Rp          , Rp          , Ww          , Ww^Bw/      , Rp          , Gs^Fds      , Rp          , Rp^Vhc      , Rp          , Rp          , Gs^Fds      , Rp          , Rp          , Rr          , Gs^Fds      , Gg^Ve       , Gs^Fms      
Gg          , Gg          , 1 Rr        , Rr          , Ce          , Gs^Fms      , Ggf         , Rp          , Ss          , Ww          , Ww          , Ch          , Gs^Fds      , Ggf         , Rp          , Rp          , Kh          , Ch          , Ggf         , Rr          , Rr          , Gs^Fds      
Rr          , Rr          , 3 Gg        , Gg          , 4 Ce        , Gs^Fms      , Gs^Fms      , Gg          , Ss          , Ss          , Ww          , Gg          , Gs^Fds      , Gs^Fms      , Rp          , Rp^Vhc      , Gs^Fds      , Gs^Fds      , Gs^Fds      , Gg          , Gg          , Rr          
Gg          , Gg          , Gg          , Gg          , Gg          , Gs^Fms      , Gs^Fms      , Gs^Fds      , Wwf         , Ww          , Ww          , Gs^Fds      , Gs^Fms      , Gs^Fds      , Rp          , Gs^Fms      , Gs^Fds      , Gs^Fms      , Gs^Fds      , Gg          , Gg          , Gg          
