border_size=1
usage=map

Xu          , _off^_usr   , Xu          , _off^_usr   , Xu          , _off^_usr   , Xu          , _off^_usr   , Ch          , Rr          , Rr          , Rp          , Rp          , Rp          , Rr          , Rr          , Ch          , _off^_usr   , Xu          , _off^_usr   , Xu          , _off^_usr   
Xu          , Xu          , Xu          , Xu          , Xu          , Xu          , Xu          , Xu          , Ch          , Rr          , Rr          , Rp          , Rp          , Rp          , Rr          , Rr          , Ch          , Xu          , Xu          , Xu          , Xu          , Xu          
Xu          , Xu          , Xu          , Xu          , Xu          , Xu          , Xu          , Xu          , Ch          , Rr          , Rp          , Rp          , Gg^Fet      , Rp          , Rp          , Rr          , Ch          , Xu          , Xu          , Xu          , Xu          , Xu          
Ch          , Ch          , Ch          , Ch          , Ch          , Ch          , Ch          , Ch          , Rp          , Rp          , Gs^Fp       , Rp          , Rp          , Rp          , Gs^Fp       , Rp          , Rp          , Ch          , Ch          , Ch          , Ch          , Ch          
Rr          , Rr          , Rr          , Rr          , Rr          , Rr          , Rp          , Rp          , Gs^Fp       , Gs^Fp       , Rp          , Ch          , 5 Kh        , Ch          , Rp          , Gs^Fp       , Gs^Fp       , Rp          , Rp          , Rr          , Rr          , Rr          
Rr          , Rr          , Rr          , Rr          , Rr          , Rr          , Rp          , Gs^Fp       , Rp          , Rp          , 2 Ch        , Ch          , Wwf         , Ch          , 6 Ch        , Rp          , Rp          , Gs^Fp       , Rp          , Rr          , Rr          , Rr          
Rp          , Rp          , Rp          , Rp          , Rp          , Rp          , Rp          , Rp          , Ch          , Ch          , Ggf         , Wwf         , Wwf         , Wwf         , Ggf         , Ch          , Ch          , Rp          , Rp          , Rp          , Rp          , Rp          
Rp          , Rp          , Rp          , Rp          , Rp          , Rp          , Rp          , Gg^Fet      , Ch          , 1 Kh        , Ggf         , Wwf         , Wwf         , Wwf         , Ggf         , 8 Kh        , Ch          , Gg^Fet      , Rp          , Rp          , Rp          , Rp          
Rr          , Rp          , Rr          , Rp          , Rr          , Rp          , Rp          , Rp          , Rp          , Ch          , 3 Ch        , Wwf         , Wwf         , Wwf         , 7 Ch        , Ch          , Rp          , Rp          , Rp          , Rp          , Rr          , Rp          
Rr          , Rr          , Rr          , Rr          , Rr          , Rr          , Rp          , Gs^Fp       , Gs^Fp       , Rp          , Rp          , Ch          , 4 Kh        , Ch          , Rp          , Rp          , Gs^Fp       , Gs^Fp       , Rp          , Rr          , Rr          , Rr          
Rr          , Rr          , Rr          , Rr          , Rr          , Rr          , Rr          , Rp          , Rp          , Gs^Fp       , Gs^Fp       , Ch          , Rp          , Ch          , Gs^Fp       , Gs^Fp       , Rp          , Rp          , Rr          , Rr          , Rr          , Rr          
Ch          , Ch          , Ch          , Ch          , Ch          , Ch          , Ch          , Ch          , Ch          , Rp          , Rp          , Rp          , Gg^Fet      , Rp          , Rp          , Rp          , Ch          , Ch          , Ch          , Ch          , Ch          , Ch          
Xu          , Xu          , Xu          , Xu          , Xu          , Xu          , Xu          , Xu          , Xu          , Ch          , Rr          , Rp          , Rp          , Rp          , Rr          , Ch          , Xu          , Xu          , Xu          , Xu          , Xu          , Xu          
Xu          , Xu          , Xu          , Xu          , Xu          , Xu          , Xu          , Xu          , Xu          , Ch          , Rr          , Rp          , Rp          , Rp          , Rr          , Ch          , Xu          , Xu          , Xu          , Xu          , Xu          , Xu          
