border_size=1
usage=map

Gg          , Gg          , Gg          , Gg          , Gg          , Gg          , Gs          , Rr          , Gs          , Gg          , Gg          , Gg          , Rr          , Gg          , Gg          , Gg          , Gg          , Gg          , Gg          , Gg          , Gg          , Gg          
Gg          , Gg          , Gg          , Gg          , Gg          , Gs          , Gs          , Rr          , Ce          , Gg          , Gs^Fp       , Gg          , Rr          , Gg          , Gg          , Gg          , Gs^Fp       , Gs^Fp       , Gs^Fp       , Gg          , Gg          , Gg          
Gg          , Gg          , Ke          , Gg          , Ce          , Gg          , Rr          , Rr          , Gs          , Gs^Fp       , Gs^Fp       , Gg          , Rr          , Gg          , Ce          , Gs          , Ce          , Gs^Fp       , Ce          , Gg          , Gg          , Gg          
Gg          , Ce          , Gg          , Ce          , Gg^Fet      , Ce          , Rp          , Rr          , Ce          , Ke          , Ce          , Ce          , Rr          , Gg          , Gg^Ve       , Ce          , Gs          , Ke          , Gs^Fp       , Ce          , Gs^Fp       , Gg          
Ww          , Gg          , Gs^Fp       , Gs^Fp       , Gs^Fp       , Gs^Fp       , Rp          , Rr          , Gs^Fp       , Wwf         , Wwf         , Wwf         , Rp          , Gs          , Gs          , Gs^Fp       , Gs^Fp       , Gg          , Gs^Fp       , Ke          , Ce          , Gs          
Ww          , Ww          , Ww          , Gs^Fp       , Gs          , Gs          , Rp          , Gs^Fp       , Wwf         , Wwf         , Gs^Fp       , Wwf         , Gs^Fp       , Rp          , Rp          , Gs          , Gs^Fp       , Gs^Fp       , Gg          , Gs^Fp       , Gs          , Gs          
Ww          , Ww          , Wo          , Ww          , Ww          , Gg^Ve       , Ww^Bw|      , Gs^Fp       , Wwf         , Gs^Fp       , Gs^Fp       , Rp^Vhc      , Gs^Fp       , Gs^Fp       , Rp          , Gg^Wm       , Gs          , Gs^Fp       , Gs^Fp       , Gg          , Gs^Fp       , Gs          
Gg          , Ww          , Ss          , Wo          , Wo          , Ww          , Ww^Bw|      , Ww          , Ss          , Ss          , Gg          , Rp          , Rp          , Gg          , Rp          , Rp          , Rp          , Gg^Vh       , Gs^Fp       , Gs^Fp       , Gs          , Gs          
Gg          , Gg          , Chs         , Ss          , Ww          , Wo          , Rr          , Ww          , Ww          , Ss          , Gs^Fxo      , Rp          , Rp^Vhc      , Rp          , Rp          , Rp^Vhc      , Rr          , Gg          , Gs^Fxo      , Gs^Fp       , Gs^Fp       , Gs          
Gg          , Gg          , Gg          , Ww          , Ww          , Gg          , Rr          , Ss          , Ww          , Ww          , Gg^Vh       , Rp          , Rp^Vhc      , Rr          , Rp          , Rp^Vhc      , Ss          , Ss          , Ss          , Gs^Fp       , Ww          , Ww          
Ggf         , Ke          , Ce          , Gg^Ve       , Ww          , Gg^Wm       , Rr          , Ss          , Ww          , Ww          , Ww          , Gs^Fp       , Gs^Fp       , Rr          , Rr          , Gg          , Ww          , Ww          , Wo          , Wo          , Ww          , Ww          
Rr          , Gg          , Rr          , Ggf         , Rr          , Rr          , Rp^Vhc      , Gg^Fet      , Gg^Vh       , Ww          , Wo          , Ww          , Ww          , Gg^Ve       , Ww^Bw|      , Ww          , Wo          , Wo          , Ww          , Ss          , Ss          , Ww          
Gg          , Rr          , Ce          , Rr          , Gg^Vh       , Rp          , Rp          , Gs^Fp       , Gs^Fp       , Ch          , Ww          , Wo          , Ch          , Ww          , Ww^Bw|      , Ww          , Ch          , Kh          , Gs^Fp       , Gs^Fp       , Gg          , Gg          
Ggf         , Gg          , Ce          , Gs^Fp       , Ww          , Gs^Fp       , Rp          , Rp          , Rp          , Ggf         , Ww          , Wo          , Gg^Fet      , Gs^Fp       , Rp          , Gg          , Rp^Vhc      , Gs^Fp       , Ggf         , Gg          , Gg          , Gg          
Ggf         , Gg          , Gg          , Gs^Fp       , Rp          , Rp          , Ch          , Gs^Fp       , Ww          , Ww^Bw\      , Ww^Bw\      , Ww          , Gg^Ve       , Ggf         , Ch          , Rp          , Ggf         , Gs^Fp       , Gg^Ve       , Ch          , Ss          , Ss          
Rr          , Rr          , Rr          , Rr          , Gs^Fp       , Rp^Vhc      , Ww          , Ww          , Ww          , Ww          , Ss          , Ggf         , Ch          , Ch          , Ch          , Rp          , Rp          , Gg^Fet      , Gs^Fp       , Kh          , Ss          , Ss          
Gg          , Ce          , Ww          , Gg^Wm       , Ww          , Gs^Fp       , Ww          , Ww          , Gs^Fp       , Gs^Fp       , Ss          , Gg^Ve       , Ch          , 2 Kh        , Ch          , Gg^Fet      , Gs^Fp       , Rp          , Ggf         , Ch          , Gs^Fp       , Ss          
Ww          , Ww          , Ke          , Ww          , Gs^Fp       , Ww          , Ww          , Kh          , Ch          , Gs^Fp       , Rp          , Ss          , Rp          , Ch          , Gs^Fp       , Ch          , Rp          , Rp          , Gs^Fxo      , Ch          , Gs^Fp       , Gs^Fp       
Gg          , Ggf         , Ce          , Gs^Vht      , Rp          , Rp          , Rp          , Ww          , Ww^Bw/      , Rp          , Gs^Fp       , Rp          , Rp^Vhc      , Rp          , Rp          , Gs^Fp       , Rp          , Rp          , Rr          , Gs^Fp       , Gg^Ve       , Gs^Fp       
Gg          , Gg          , 1 Rr        , Rr          , Ce          , Gs^Fp       , Ggf         , Rp          , Ss          , Ww          , Ww          , Ch          , Gs^Fp       , Ggf         , Rp          , Rp          , Kh          , Ch          , Ggf         , Rr          , Rr          , Gs^Fp       
Rr          , Rr          , 3 Gg        , Gg          , 4 Ce        , Gs^Fp       , Gs^Fp       , Gg          , Ss          , Ss          , Ww          , Gg          , Gs^Fp       , Gs^Fp       , Rp          , Rp^Vhc      , Gs^Fp       , Gs^Fp       , Gs^Fp       , Gg          , Gg          , Rr          
Gg          , Gg          , Gg          , Gg          , Gg          , Gs^Fp       , Gs^Fp       , Gs^Fp       , Wwf         , Ww          , Ww          , Gs^Fp       , Gs^Fp       , Gs^Fp       , Rp          , Gs^Fp       , Gs^Fp       , Gs^Fp       , Gs^Fp       , Gg          , Gg          , Gg          
