border_size=1
usage=map

Yr          , Ryd         , Ryd         , Ryd         , Yr          , Yr          , Ryd         , Ryd         , Ryd         , Yr          , Ryd         , Yr          , Yrh         , Yr          , Ryd         , Ryd         , Yr          , Yr          , Ryd         , Yr          , Ryd         , Ryd         , Ryd         , Ryd         , Ryd         , Yr          , Ryd         , Ryd         , Yr          , Ryd         , Yr          , Ryd         , Ryd         , Ryd         , Ryd         , Ryd         , Yr          , Ryd         , Yrh         , Ryd         , Yrh         , Yr          
Ryd         , Yr          , Ryd         , Yr          , Yr          , Yrh         , Yr          , Ryd         , Ryd         , Yr          , Yr          , Yr          , Ryd         , Yr          , Yl          , Ryd         , Yrh         , Ryd         , Ryd         , Yr          , Ryd         , Yr          , Yrh         , Ryd         , Ryd         , Yr          , Ryd         , Ryd         , Yr          , Ryd         , Ryd         , Yl          , Ryd         , Yr          , Ryd         , Ryd         , Ryd         , Ryd         , Ryd         , Ryd         , Yr          , Yr          
Yr          , Ryd         , Ryd         , Ryd         , Ryd         , Yr          , Ryd         , Ryd         , Yr          , Ryd         , Ryd         , Ryd         , Yr          , Ryd         , Yl          , Yl          , Ryd         , Yr          , Ryd         , Yr          , Ryd         , Yr          , Yr          , Yr          , Yr          , Yr          , Ryd         , Yrh         , Ryd         , Yr          , Ryd         , Ryd         , Ryd         , Ryd         , Yr          , Yr          , Yr          , Ryd         , Yr          , Yl          , Ryd         , Ryd         
Yrh         , Ryd         , Yr          , Ryd         , Yr          , Ryd         , Ryd         , Ryd         , Ryd         , Yrh         , Ryd         , Ryd         , Yl          , Yr          , Yl          , Yr          , Yr          , Ryd         , Yr          , Yr          , Yr          , Yr          , Yl          , Yr          , Ryd         , Yr          , Ryd         , Ryd         , Yr          , Ryd         , Ryd         , Yl          , Yl          , Ryd         , Ryd         , Yrh         , Yr          , Yr          , Ryd         , Ryd         , Ryd         , Yr          
Yr          , Ryd         , Ryd         , Yrh         , Ryd         , Ryd         , Ryd         , Ryd         , Yl          , Yl          , Ryd         , Yr          , Ryd         , Yl          , Yl          , Ryd         , Yr          , Yrh         , Ryd         , Ryd         , Yrh         , Yr          , Yr          , Yl          , Ryd         , Yrh         , Ryd         , Ryd         , Yr          , Ryd         , Ryd         , Yr          , Yr          , Yr          , Ryd         , Yr          , Yr          , Ryd         , Ryd         , Yrh         , Ryd         , Yr          
Yr          , Yl          , Yl          , Yr          , Ryd         , Yrh         , Yr          , Yr          , Yl          , Yr          , Yrh         , Yr          , Yr          , Yl          , Ryd         , Yr          , Yr          , Ryd         , Yr          , Yr          , Ryd         , Yr          , Ryd         , Ryd         , Ryd         , Yr          , Ryd         , Ryd         , Yr          , Ryd         , Yl          , Yr          , Ryd         , Ryd         , Yr          , Ryd         , Yl          , Ryd         , Yl          , Yr          , Ryd         , Yl          
Ryd         , Yl          , Yr          , Yr          , Yr          , Ryd         , Ryd         , Yr          , Yl          , Yr          , Ryd         , Yr          , Ryd         , Yl          , Ryd         , Yr          , Ryd         , Yl          , Yr          , Ryd         , Ryd         , Yr          , Yr          , Yr          , Ryd         , Ryd         , Yr          , Ryd         , Ryd         , Yr          , Ryd         , Ryd         , Ryd         , Ryd         , Yr          , Ryd         , Yr          , Ryd         , Ryd         , Ryd         , Yr          , Ryd         
Ryd         , Yl          , Ryd         , Yr          , Ryd         , Yr          , Yr          , Ryd         , Yl          , Yl          , Ryd         , Yr          , Ryd         , Ryd         , Yrh         , Yr          , Ryd         , Yr          , Ryd         , Ryd         , Yrh         , Ryd         , Ryd         , Ryd         , Ryd         , Yl          , Yr          , Yr          , Ryd         , Yl          , Yr          , Ryd         , Ryd         , Yr          , Ryd         , Yl          , Yr          , Yr          , Yl          , Ryd         , Yr          , Yr          
Yr          , Yl          , Ryd         , Yr          , Yr          , Ryd         , Yr          , Yr          , Yrh         , Ryd         , Ryd         , Yr          , Ryd         , Ryd         , Ryd         , Ryd         , Yr          , Ryd         , Ryd         , Ryd         , Yr          , Ryd         , Ryd         , Ryd         , Yr          , Ryd         , Yr          , Yrh         , Ryd         , Yrh         , Ryd         , Yr          , Yr          , Ryd         , Yr          , Yl          , Yr          , Yr          , Ryd         , Yr          , Ryd         , Ryd         
Yr          , Ryd         , Yrh         , Ryd         , Ryd         , Ryd         , Ryd         , Yr          , Yr          , Yr          , Yr          , Yr          , Ryd         , Ryd         , Ryd         , Yr          , Ryd         , Yrh         , Yr          , Ryd         , Ryd         , Ryd         , Yr          , Ryd         , Ryd         , Ryd         , Ryd         , Yr          , Ryd         , Yr          , Yr          , Yr          , Yr          , Yl          , Ryd         , Ryd         , Ryd         , Ryd         , Yr          , Ryd         , Ryd         , Ryd         
Ryd         , Ryd         , Ryd         , Yr          , Ryd         , Ryd         , Yr          , Yr          , Yr          , Yl          , Ryd         , Ryd         , Yr          , Ryd         , Yr          , Ryd         , Yr          , Ryd         , Ryd         , Yl          , Ryd         , Yrh         , Ryd         , Yr          , Yr          , Ryd         , Ryd         , Ryd         , Yr          , Yr          , Ryd         , Ryd         , Yrh         , Ryd         , Ryd         , Ryd         , Yr          , Yrh         , Yl          , Ryd         , Yl          , Yr          
Ryd         , Ryd         , Ryd         , Yr          , Ryd         , Yr          , Yr          , Yrh         , Yr          , Ryd         , Ryd         , Ryd         , Yrh         , Yr          , Ryd         , Ryd         , Yrh         , Ryd         , Ryd         , Yr          , Yr          , Yr          , Yr          , Ryd         , Yr          , Yrh         , Yr          , Ryd         , Ryd         , Yr          , Ryd         , Yr          , Ryd         , Yl          , Yl          , Ryd         , Yr          , Yr          , Ryd         , Yl          , Yrh         , Yr          
Yr          , Ryd         , Yr          , Yl          , Yl          , Ryd         , Yr          , Ryd         , Yr          , Ryd         , Ryd         , Yr          , Yr          , Ryd         , Ryd         , Yr          , Yl          , Yr          , Ryd         , Yr          , Ryd         , 1 Yr        , Ryd         , Ryd         , Ryd         , Ryd         , Yl          , Ryd         , Yr          , Ryd         , Yr          , Yr          , Ryd         , Yl          , Yr          , Ryd         , Ryd         , Ryd         , Ryd         , Yr          , Ryd         , Yr          
Ryd         , Yr          , Ryd         , Yr          , Ryd         , Ryd         , Yl          , Yl          , Yr          , Ryd         , Ryd         , Yr          , Yr          , Yl          , Ryd         , Ryd         , Ryd         , Ryd         , Yr          , Yr          , Ryd         , Ryd         , Yr          , Yrh         , Ryd         , Yr          , Yr          , Yr          , Ryd         , Yr          , Ryd         , Ryd         , Ryd         , Yr          , Ryd         , Ryd         , Yr          , Yr          , Yl          , Ryd         , Ryd         , Ryd         
Ryd         , Ryd         , Ryd         , Yrh         , Yr          , Ryd         , Yr          , Yr          , Yr          , Ryd         , Yl          , Ryd         , Yr          , Ryd         , Ryd         , Ryd         , Ryd         , Yl          , Yr          , Ryd         , Yr          , Yl          , Yr          , Yr          , Yr          , Ryd         , Ryd         , Ryd         , Yr          , Yl          , Ryd         , Ryd         , Yr          , Yrh         , Yr          , Yr          , Yr          , Ryd         , Ryd         , Ryd         , Yrh         , Ryd         
Ryd         , Ryd         , Ryd         , Ryd         , Yr          , Ryd         , Yr          , Yrh         , Ryd         , Ryd         , Yr          , Ryd         , Ryd         , Yr          , Ryd         , Yr          , Yr          , Yr          , Ryd         , Ryd         , Ryd         , Ryd         , Ryd         , Yl          , Ryd         , Yl          , Ryd         , Ryd         , Ryd         , Yr          , Yr          , Ryd         , Ryd         , Ryd         , Ryd         , Ryd         , Ryd         , Yl          , Yr          , Yl          , Ryd         , Ryd         
Yr          , Ryd         , Ryd         , Yr          , Yr          , Ryd         , Ryd         , Yr          , Yr          , Ryd         , Ryd         , Yl          , Ryd         , Yrh         , Ryd         , Ryd         , Yrh         , Ryd         , Yr          , Yr          , Ryd         , Ryd         , Ryd         , Yr          , Ryd         , Yr          , Yr          , Ryd         , Yr          , Yr          , Yr          , Yr          , Yr          , Ryd         , Ryd         , Ryd         , Ryd         , Ryd         , Yr          , Yr          , Ryd         , Ryd         
Ryd         , Yr          , Ryd         , Ryd         , Yl          , Yr          , Yr          , Ryd         , Ryd         , Ryd         , Ryd         , Yr          , Yr          , Ryd         , Yr          , Ryd         , Ryd         , Ryd         , Ryd         , Ryd         , Yr          , Yr          , Ryd         , Yr          , Yr          , Ryd         , Yr          , Yr          , Yr          , Yrh         , Ryd         , Yr          , Ryd         , Yl          , Ryd         , Yrh         , Yr          , Ryd         , Ryd         , Yr          , Ryd         , Ryd         
Ryd         , Ryd         , Ryd         , Yr          , Ryd         , Ryd         , Yr          , Ryd         , Ryd         , Yr          , Ryd         , Ryd         , Ryd         , Yl          , Yr          , Yl          , Ryd         , Ryd         , Ryd         , Ryd         , Ryd         , Ryd         , Yl          , Yr          , Ryd         , Yr          , Ryd         , Yr          , Ryd         , Ryd         , Yr          , Ryd         , Ryd         , Yr          , Ryd         , Yr          , Yr          , Yl          , Ryd         , Yr          , Ryd         , Ryd         
Ryd         , Ryd         , Yr          , Ryd         , Ryd         , Ryd         , Yr          , Ryd         , Yr          , Yrh         , Ryd         , Ryd         , Ryd         , Yr          , Yrh         , Yr          , Yr          , Yr          , Ryd         , Ryd         , Ryd         , Yr          , Yr          , Yr          , Ryd         , Yr          , Yr          , Ryd         , Ryd         , Ryd         , Yrh         , Ryd         , Ryd         , Ryd         , Yr          , Ryd         , Ryd         , Yr          , Yr          , Yr          , Ryd         , Ryd         
Yr          , Yr          , Ryd         , Ryd         , Yr          , Yl          , Yr          , Yr          , Ryd         , Ryd         , Ryd         , Ryd         , Yr          , Yr          , Ryd         , Ryd         , Ryd         , Ryd         , Yr          , Yl          , Yr          , Ryd         , Ryd         , Ryd         , Yl          , Yr          , Yrh         , Ryd         , Yl          , Yr          , Ryd         , Ryd         , Ryd         , Ryd         , Yr          , Yr          , Ryd         , Yr          , Yr          , Yrh         , Yr          , Yl          
Yrh         , Ryd         , Yr          , Ryd         , Ryd         , Yrh         , Ryd         , Ryd         , Yr          , Ryd         , Yr          , Ryd         , Ryd         , Ryd         , Ryd         , Ryd         , Ryd         , Ryd         , Ryd         , Yrh         , Yrh         , Ryd         , Ryd         , Ryd         , Ryd         , Yr          , Yr          , Yr          , Ryd         , Yr          , Ryd         , Ryd         , Yr          , Yrh         , Ryd         , Ryd         , Ryd         , Yr          , Yr          , Ryd         , Ryd         , Yr          
Yr          , Yr          , Ryd         , Ryd         , Yr          , Yr          , Ryd         , Ryd         , Ryd         , Yrh         , Yr          , Ryd         , Ryd         , Ryd         , Ryd         , Yr          , Yr          , Yl          , Yr          , Ryd         , Yrh         , 3 Yr        , Ryd         , Yl          , Yr          , Yr          , Ryd         , Ryd         , Ryd         , Yr          , Ryd         , Ryd         , Ryd         , Ryd         , Ryd         , Yl          , Yrh         , Ryd         , Ryd         , Ryd         , Yr          , Yr          
Ryd         , Ryd         , Ryd         , Ryd         , Ryd         , Ryd         , Ryd         , Yr          , Yr          , Yr          , Ryd         , Ryd         , Yr          , Ryd         , Ryd         , Ryd         , Ryd         , Yr          , Ryd         , Ryd         , Ryd         , Ryd         , Yr          , Yl          , Ryd         , Yr          , Yr          , Ryd         , Ryd         , Yr          , Yrh         , Yr          , Ryd         , Ryd         , Yr          , Yr          , Yr          , Yr          , Yr          , Ryd         , Ryd         , Ryd         
Yr          , Yr          , Ryd         , Yl          , Yrh         , Ryd         , Ryd         , Yr          , Ryd         , Yr          , Ryd         , Ryd         , Yl          , Yl          , Ryd         , Ryd         , Yrh         , Yl          , Ryd         , Ryd         , Ryd         , Ryd         , Ryd         , Yl          , Yl          , Ryd         , Ryd         , Ryd         , Yl          , Yr          , Ryd         , Ryd         , Ryd         , Ryd         , Ryd         , Ryd         , Ryd         , Yrh         , Ryd         , Ryd         , Ryd         , Ryd         
Yr          , Ryd         , Ryd         , Yr          , Yr          , Ryd         , Yr          , Yr          , Ryd         , Ryd         , Yrh         , Yr          , Yr          , Yl          , Ryd         , Yr          , Yr          , Ryd         , Yr          , Yr          , Ryd         , Yr          , Yr          , Yrh         , Yr          , Yl          , Ryd         , Ryd         , Ryd         , Yr          , Yr          , Ryd         , Yrh         , Ryd         , Yr          , Ryd         , Ryd         , Ryd         , Yl          , Yr          , Ryd         , Ryd         
Yr          , Yrh         , Ryd         , Ryd         , Ryd         , Ryd         , Yr          , Ryd         , Yr          , Yr          , Yr          , Yr          , Yl          , Ryd         , Ryd         , Yl          , Ryd         , Ryd         , Ryd         , Ryd         , Yl          , Ryd         , Ryd         , Ryd         , Ryd         , Yr          , Yr          , Ryd         , Ryd         , Yr          , Yr          , Ryd         , Ryd         , Ryd         , Yr          , Ryd         , Yr          , Yr          , Yr          , Ryd         , Ryd         , Ryd         
Yr          , Yr          , Yr          , Yl          , Yr          , Ryd         , Yr          , Ryd         , Yr          , Yl          , Yr          , Yrh         , Ryd         , Ryd         , Ryd         , Ryd         , Yr          , Yl          , Ryd         , Ryd         , Yr          , Ryd         , Ryd         , Yr          , Yr          , Yrh         , Ryd         , Yr          , Ryd         , Ryd         , Yl          , Yrh         , Ryd         , Ryd         , Ryd         , Ryd         , Yr          , Yrh         , Ryd         , Yrh         , Yr          , Ryd         
Ryd         , Ryd         , Ryd         , Yr          , Yr          , Ryd         , Yrh         , Yr          , Yr          , Ryd         , Ryd         , Ryd         , Ryd         , Ryd         , Ryd         , Yr          , Yr          , Yrh         , Yr          , Yr          , Yl          , Yr          , Yr          , Ryd         , Yr          , Yr          , Ryd         , Ryd         , Ryd         , Yr          , Ryd         , Yr          , Yr          , Ryd         , Ryd         , Yr          , Yrh         , Yr          , Ryd         , Yr          , Yl          , Ryd         
Ryd         , Ryd         , Ryd         , Ryd         , Ryd         , Yr          , Yr          , Ryd         , Ryd         , Ryd         , Ryd         , Yr          , Yr          , Ryd         , Yr          , Yl          , Ryd         , Yr          , Yr          , Ryd         , Ryd         , Ryd         , Yr          , Yl          , Yr          , Ryd         , Yl          , Ryd         , Ryd         , Yr          , Ryd         , Ryd         , Ryd         , Yr          , Ryd         , Yr          , Yrh         , Ryd         , Yr          , Ryd         , Ryd         , Ryd         
Ryd         , Yr          , Ryd         , Ryd         , Ryd         , Yr          , Yr          , Ryd         , Yrh         , Ryd         , Ryd         , Yr          , Ryd         , Ryd         , Yl          , Yl          , Yr          , Yl          , Ryd         , Ryd         , Ryd         , Ryd         , Yrh         , Yr          , Ryd         , Ryd         , Ryd         , Ryd         , Ryd         , Ryd         , Ryd         , Ryd         , Ryd         , Yr          , Ryd         , Yr          , Ryd         , Yrh         , Ryd         , Ryd         , Yrh         , Ryd         
Yr          , Yrh         , Ryd         , Yr          , Ryd         , Yr          , Yr          , Yr          , Yr          , Ryd         , Ryd         , Yr          , Ryd         , Ryd         , Ryd         , Yl          , Yr          , Yr          , Yr          , Ryd         , Ryd         , Yr          , Yr          , Ryd         , Yr          , Yr          , Yr          , Ryd         , Ryd         , Yr          , Ryd         , Ryd         , Yrh         , Ryd         , Yr          , Yr          , Ryd         , Yr          , Ryd         , Yl          , Yr          , Yr          
Yr          , Ryd         , Yr          , Yr          , Yr          , Ryd         , Yr          , Ryd         , Ryd         , Yr          , Yr          , Yr          , Ryd         , Ryd         , Yr          , Ryd         , Ryd         , Ryd         , Yr          , Ryd         , Ryd         , Yr          , Ryd         , Ryd         , Ryd         , Ryd         , Ryd         , Ryd         , Ryd         , Yr          , Yl          , Yr          , Ryd         , Yr          , Ryd         , Ryd         , Yr          , Yr          , Ryd         , Ryd         , Ryd         , Ryd         
Ryd         , Ryd         , Ryd         , Ryd         , Yr          , Ryd         , Yrh         , Ryd         , Ryd         , Ryd         , Yr          , Ryd         , Yr          , Yr          , Ryd         , Ryd         , Yr          , Yrh         , Ryd         , Ryd         , Ryd         , Ryd         , Ryd         , Yrh         , Yrh         , Ryd         , Yr          , Ryd         , Yl          , Yr          , Ryd         , Ryd         , Ryd         , Yr          , Ryd         , Ryd         , Yr          , Ryd         , Ryd         , Ryd         , Yrh         , Ryd         
Ryd         , Ryd         , Yr          , Yr          , Ryd         , Ryd         , Ryd         , Ryd         , Yr          , Yr          , Yrh         , Yrh         , Yr          , Ryd         , Ryd         , Ryd         , Yr          , Yr          , Yr          , Ryd         , Yr          , Yr          , Ryd         , Ryd         , Ryd         , Yrh         , Ryd         , Yrh         , Yr          , Yr          , Yr          , Yr          , Yr          , Yr          , Yr          , Ryd         , Ryd         , Yr          , Yr          , Yr          , Yr          , Ryd         
Yr          , Yl          , Ryd         , Ryd         , Ryd         , Yr          , Ryd         , Ryd         , Ryd         , Yl          , Ryd         , Yr          , Yr          , Ryd         , Ryd         , Yr          , Ryd         , Ryd         , Yr          , Yr          , Yr          , Yrh         , Yr          , Yr          , Yr          , Ryd         , Yr          , Yr          , Yr          , Yl          , Yrh         , Ryd         , Yr          , Ryd         , Ryd         , Ryd         , Ryd         , Ryd         , Yr          , Ryd         , Yrh         , Ryd         
Yrh         , Yr          , Ryd         , Ryd         , Ryd         , Ryd         , Ryd         , Ryd         , Yr          , Ryd         , Ryd         , Yr          , Ryd         , Ryd         , Yl          , Yr          , Yrh         , Ryd         , Ryd         , Yl          , Yr          , Ryd         , Yr          , Ryd         , Ryd         , Ryd         , Yr          , Yr          , Ryd         , Yr          , Ryd         , Ryd         , Yr          , Yr          , Yrh         , Yl          , Yr          , Ryd         , Ryd         , Ryd         , Yl          , Ryd         
Ryd         , Yr          , Yr          , Ryd         , Yrh         , Yr          , Yr          , Ryd         , Yl          , Ryd         , Yr          , Ryd         , Ryd         , Yr          , Yrh         , Yr          , Ryd         , Yr          , Ryd         , Ryd         , Yr          , Ryd         , Ryd         , Ryd         , Ryd         , Ryd         , Yr          , Ryd         , Ryd         , Yrh         , Yr          , Ryd         , Yr          , Yr          , Yr          , Yr          , Yr          , Yr          , Ryd         , Yr          , Yr          , Yr          
Ryd         , Ryd         , Ryd         , Ryd         , Yl          , Ryd         , Ryd         , Yr          , Ryd         , Yr          , Ryd         , Ryd         , Ryd         , Ryd         , Yr          , Ryd         , Yr          , Ryd         , Ryd         , Ryd         , Ryd         , Ryd         , Yr          , Yr          , Yr          , Ryd         , Ryd         , Yrh         , Ryd         , Ryd         , Yrh         , Ryd         , Yr          , Ryd         , Ryd         , Ryd         , Yr          , Yrh         , Ryd         , Ryd         , Ryd         , Ryd         
Yr          , Ryd         , Yrh         , Ryd         , Yr          , Ryd         , Yr          , Ryd         , Ryd         , Ryd         , Yrh         , Ryd         , Ryd         , Yr          , Ryd         , Ryd         , Yl          , Yrh         , Yr          , Yr          , Ryd         , Ryd         , Yr          , Yl          , Ryd         , Ryd         , Yr          , Ryd         , Ryd         , Ryd         , Ryd         , Ryd         , Ryd         , Ryd         , Yr          , Yr          , Yrh         , Yr          , Yl          , Yr          , Ryd         , Yr          
Ryd         , Yr          , Yr          , Ryd         , Yr          , Ryd         , Ryd         , Ryd         , Yr          , Ryd         , Yr          , Yr          , Yrh         , Ryd         , Ryd         , Ryd         , Ryd         , Ryd         , Ryd         , Ryd         , Ryd         , Ryd         , Yr          , Ryd         , Ryd         , Ryd         , Yl          , Ryd         , Yrh         , Ryd         , Ryd         , Yrh         , Yr          , Ryd         , Yr          , Ryd         , Yr          , Yr          , Yr          , Yrh         , Yr          , Ryd         
Yr          , Ryd         , Ryd         , Yr          , Yr          , Ryd         , Ryd         , Yr          , Ryd         , Ryd         , Ryd         , Yl          , Yr          , Yr          , Ryd         , Ryd         , Yr          , Yr          , Ryd         , Ryd         , Ryd         , Yr          , Ryd         , Yr          , Ryd         , Yr          , Yr          , Yr          , Yr          , Yr          , Yr          , Yr          , Ryd         , Yl          , Yr          , Yr          , Ryd         , Ryd         , Yr          , Ryd         , Ryd         , Ryd         
