border_size=1
usage=map

Yhr^Zok     , Uu^Zok      , Uu^Zok      , Ryd^Zok     , Yhr^Zok     , Yhr^Zok     , Uu^Zok      , Uu^Zok      , Uu^Zok      , Yhr^Zok     , Ryd^Zok     , Yhr^Zok     , Yhr^Zok     , Yhr^Zok     , Ryd^Zok     , Ryd^Zok     , Yhr^Zok     , Yhr^Zok     , Ryd^Zok     , Yhr^Zok     , Ryd^Zok     , Ryd^Zok     , Ryd^Zok     , Ryd^Zok     , Ryd^Zok     , Yhr^Zok     , Ryd^Zok     , Ryd^Zok     , Yhr^Zok     , Ryd^Zok     , Yhr^Zok     , Ryd^Zok     , Ryd^Zok     , Ryd^Zok     , Ryd^Zok     , Ryd^Zok     , Yhr^Zok     , Ryd^Zok     , Yhr^Zok     , Ryd^Zok     , Yhr^Zok     , Yhr^Zok     
Ryd^Zok     , Yhr^Zok     , Ryd^Zok     , Yhr^Zok     , Yhr^Zok     , Yhr^Zok     , Yhr^Zok     , Uu^Zok      , Ryd^Zok     , Yhr^Zok     , Yhr^Zok     , Yhr^Zok     , Ryd^Zok     , Yhr^Zok     , Yhl^Zok     , Ryd^Zok     , Yhr^Zok     , Ryd^Zok     , Ryd^Zok     , Yhr^Zok     , Ryd^Zok     , Yhr^Zok     , Yhr^Zok     , Ryd^Zok     , Ryd^Zok     , Yhr^Zok     , Ryd^Zok     , Ryd^Zok     , Yhr^Zok     , Ryd^Zok     , Ryd^Zok     , Yhl^Zok     , Ryd^Zok     , Yhr^Zok     , Ryd^Zok     , Ryd^Zok     , Ryd^Zok     , Ryd^Zok     , Ryd^Zok     , Ryd^Zok     , Yhr^Zok     , Yhr^Zok     
Yhr^Zok     , Ryd^Zok     , Ryd^Zok     , Ryd^Zok     , Ryd^Zok     , Yhr^Zok     , Ryd^Zok     , Ryd^Zok     , Yhr^Zok     , Ryd^Zok     , Ryd^Zok     , Ryd^Zok     , Yhr^Zok     , Ryd^Zok     , Yhl^Zok     , Yhl^Zok     , Ryd^Zok     , Yhr^Zok     , Ryd^Zok     , Yhr^Zok     , Ryd^Zok     , Yhr^Zok     , Yhr^Zok     , Yhr^Zok     , Yhr^Zok     , Yhr^Zok     , Ryd^Zok     , Yhr^Zok     , Ryd^Zok     , Yhr^Zok     , Ryd^Zok     , Ryd^Zok     , Ryd^Zok     , Ryd^Zok     , Yhr^Zok     , Yhr^Zok     , Yhr^Zok     , Ryd^Zok     , Yhr^Zok     , Yhl^Zok     , Ryd^Zok     , Ryd^Zok     
Yhr^Zok     , Ryd^Zok     , Yhr^Zok     , Ryd^Zok     , Yhr^Zok     , Ryd^Zok     , Ryd^Zok     , Uu^Zok      , Uu^Zok      , Yhr^Zok     , Ryd^Zok     , Ryd^Zok     , Yhl^Zok     , Yhr^Zok     , Yhl^Zok     , Yhr^Zok     , Yhr^Zok     , Ryd^Zok     , Yhr^Zok     , Yhr^Zok     , Yhr^Zok     , Yhr^Zok     , Yhl^Zok     , Yhr^Zok     , Ryd^Zok     , Yhr^Zok     , Ryd^Zok     , Ryd^Zok     , Yhr^Zok     , Ryd^Zok     , Ryd^Zok     , Yhl^Zok     , Yhl^Zok     , Ryd^Zok     , Ryd^Zok     , Yhr^Zok     , Yhr^Zok     , Yhr^Zok     , Uu^Zok      , Ryd^Zok     , Ryd^Zok     , Yhr^Zok     
Yhr^Zok     , Ryd^Zok     , Ryd^Zok     , Yhr^Zok     , Ryd^Zok     , Ryd^Zok     , Ryd^Zok     , Uu^Zok      , Yhl^Zok     , Yhl^Zok     , Ryd^Zok     , Yhr^Zok     , Ryd^Zok     , Yhl^Zok     , Yhl^Zok     , Ryd^Zok     , Yhr^Zok     , Yhr^Zok     , Ryd^Zok     , Ryd^Zok     , Yhr^Zok     , Yhr^Zok     , Yhr^Zok     , Yhl^Zok     , Ryd^Zok     , Yhr^Zok     , Ryd^Zok     , Ryd^Zok     , Yhr^Zok     , Uu^Zok      , Uu^Zok      , Yhr^Zok     , Yhr^Zok     , Yhr^Zok     , Ryd^Zok     , Yhr^Zok     , Yhr^Zok     , Uu^Zok      , Uu^Zok      , Yhr^Zok     , Ryd^Zok     , Yhr^Zok     
Yhr^Zok     , Yhl^Zok     , Yhl^Zok     , Yhr^Zok     , Ryd^Zok     , Yhr^Zok     , Yhr^Zok     , Yhr^Zok     , Yhl^Zok     , Yhr^Zok     , Yhr^Zok     , Yhr^Zok     , Yhr^Zok     , Yhl^Zok     , Ryd^Zok     , Yhr^Zok     , Yhr^Zok     , Ryd^Zok     , Yhr^Zok     , Yhr^Zok     , Ryd^Zok     , Yhr^Zok     , Ryd^Zok     , Ryd^Zok     , Ryd^Zok     , Yhr^Zok     , Ryd^Zok     , Ryd^Zok     , Yhr^Zok     , Uu^Zok      , Yhl^Zok     , Yhr^Zok     , Ryd^Zok     , Ryd^Zok     , Yhr^Zok     , Ryd^Zok     , Yhl^Zok     , Uu^Zok      , Yhl^Zok     , Yhr^Zok     , Ryd^Zok     , Yhl^Zok     
Ryd^Zok     , Yhl^Zok     , Yhr^Zok     , Yhr^Zok     , Yhr^Zok     , Ryd^Zok     , Ryd^Zok     , Yhr^Zok     , Yhl^Zok     , Yhr^Zok     , Ryd^Zok     , Yhr^Zok     , Uu^Zok      , Yhl^Zok     , Ryd^Zok     , Yhr^Zok     , Ryd^Zok     , Yhl^Zok     , Yhr^Zok     , Ryd^Zok     , Ryd^Zok     , Yhr^Zok     , Yhr^Zok     , Yhr^Zok     , Ryd^Zok     , Ryd^Zok     , Yhr^Zok     , Ryd^Zok     , Ryd^Zok     , Yhr^Zok     , Ryd^Zok     , Ryd^Zok     , Ryd^Zok     , Ryd^Zok     , Yhr^Zok     , Ryd^Zok     , Yhr^Zok     , Uu^Zok      , Ryd^Zok     , Ryd^Zok     , Yhr^Zok     , Ryd^Zok     
Ryd^Zok     , Yhl^Zok     , Ryd^Zok     , Yhr^Zok     , Ryd^Zok     , Yhr^Zok     , Yhr^Zok     , Ryd^Zok     , Yhl^Zok     , Yhl^Zok     , Ryd^Zok     , Uu^Zok      , Uu^Zok      , Uu^Zok      , Yhr^Xp      , Yhr^Zok     , Ryd         , Yhr^Zok     , Ryd         , Ryd^Zok     , Yhr^Xp      , Ryd^Zok     , Ryd         , Ryd^Zok     , Ryd         , Yhl^Zok     , Yhr         , Yhr^Zok     , Ryd         , Yhl^Zok     , Yhr^Zok     , Ryd^Zok     , Ryd^Zok     , Yhr^Zok     , Ryd^Zok     , Yhl^Zok     , Yhr^Zok     , Yhr^Zok     , Yhl^Zok     , Ryd^Zok     , Yhr^Zok     , Yhr^Zok     
Yhr^Zok     , Yhl^Zok     , Ryd^Zok     , Yhr^Zok     , Yhr^Zok     , Ryd^Zok     , Yhr^Zok     , Yhr^Zok     , Yhr^Zok     , Ryd^Zok     , Ryd^Zok     , Yhr^Zok     , Ryd^Zok     , Ryd^Zok     , Ryd         , Ryd         , Yhr         , Ryd         , Ryd         , Ryd         , Yhr         , Ryd         , Ryd         , Ryd         , Yhr         , Ryd         , Yhr         , Yhr^Xp      , Ryd         , Yhr^Xp      , Ryd^Zok     , Yhr^Zok     , Yhr^Zok     , Ryd^Zok     , Yhr^Zok     , Yhl^Zok     , Yhr^Zok     , Yhr^Zok     , Ryd^Zok     , Yhr^Zok     , Ryd^Zok     , Ryd^Zok     
Yhr^Zok     , Ryd^Zok     , Yhr^Zok     , Ryd^Zok     , Uu^Zok      , Ryd^Zok     , Uu^Zok      , Yhr^Zok     , Yhr^Zok     , Yhr^Zok     , Yhr^Zok     , Yhr^Zok     , Ryd^Zok     , Ryd^Zok     , Ryd         , Yhr         , Ryd         , Yhr^Xp      , Yhr         , Ryd         , Ryd         , Ryd         , Yhr         , Ryd         , Ryd         , Ryd         , Ryd         , Yhr         , Ryd         , Yhr         , Yhr^Zok     , Yhr^Zok     , Yhr^Zok     , Yhl^Zok     , Ryd^Zok     , Ryd^Zok     , Ryd^Zok     , Ryd^Zok     , Yhr^Zok     , Ryd^Zok     , Ryd^Zok     , Ryd^Zok     
Ryd^Zok     , Ryd^Zok     , Ryd^Zok     , Yhr^Zok     , Uu^Zok      , Uu^Zok      , Yhr^Zok     , Yhr^Zok     , Yhr^Zok     , Yhl^Zok     , Uu^Zok      , Ryd^Zok     , Yhr^Zok     , Ryd^Zok     , Yhr         , Ryd         , Yhr         , Ryd         , Ryd         , Yhl         , Ryd         , Yhr^Xp      , Ryd         , Yhr         , Yhr         , Ryd         , Ryd         , Ryd         , Yhr         , Yhr         , Ryd^Zok     , Ryd^Zok     , Yhr^Zok     , Ryd^Zok     , Ryd^Zok     , Ryd^Zok     , Yhr^Zok     , Yhr^Zok     , Yhl^Zok     , Ryd^Zok     , Yhl^Zok     , Yhr^Zok     
Ryd^Zok     , Ryd^Zok     , Ryd^Zok     , Yhr^Zok     , Ryd^Zok     , Yhr^Zok     , Yhr^Zok     , Yhr^Zok     , Yhr^Zok     , Uu^Zok      , Uu^Zok      , Ryd^Zok     , Yhr^Zok     , Yhr^Zok     , Ryd         , Ryd         , Yhr^Xp      , Ryd         , Ryd         , Yhr         , Yhr         , Yhr         , Yhr         , Ryd         , Yhr         , Yhr^Xp      , Yhr         , Ryd         , Ryd         , Yhr         , Ryd^Zok     , Yhr^Zok     , Ryd^Zok     , Yhl^Zok     , Yhl^Zok     , Ryd^Zok     , Yhr^Zok     , Yhr^Zok     , Ryd^Zok     , Yhl^Zok     , Yhr^Zok     , Yhr^Zok     
Yhr^Zok     , Ryd^Zok     , Yhr^Zok     , Yhl^Zok     , Yhl^Zok     , Ryd^Zok     , Yhr^Zok     , Ryd^Zok     , Yhr^Zok     , Ryd^Zok     , Ryd^Zok     , Yhr^Zok     , Yhr^Zok     , Ryd^Zok     , Ryd         , Yhr         , Yhl         , Yhr         , Ryd         , Yhr         , Ryd         , 1 Yhr       , Ryd         , Ryd         , Ryd         , Ryd         , Yhl         , Ryd         , Yhr         , Ryd         , Yhr^Zok     , Yhr^Zok     , Ryd^Zok     , Yhl^Zok     , Yhr^Zok     , Ryd^Zok     , Ryd^Zok     , Ryd^Zok     , Ryd^Zok     , Yhr^Zok     , Ryd^Zok     , Yhr^Zok     
Ryd^Zok     , Yhr^Zok     , Ryd^Zok     , Yhr^Zok     , Ryd^Zok     , Ryd^Zok     , Yhl^Zok     , Yhl^Zok     , Yhr^Zok     , Ryd^Zok     , Ryd^Zok     , Yhr^Zok     , Yhr^Zok     , Yhl^Zok     , Ryd         , Ryd         , Ryd         , Ryd         , Yhr         , Yhr         , Ryd         , Ryd         , Yhr         , Yhr^Xp      , Ryd         , Yhr         , Yhr         , Yhr         , Ryd         , Yhr         , Ryd^Zok     , Ryd^Zok     , Ryd^Zok     , Yhr^Zok     , Uu^Zok      , Ryd^Zok     , Yhr^Zok     , Yhr^Zok     , Yhl^Zok     , Ryd^Zok     , Ryd^Zok     , Ryd^Zok     
Ryd^Zok     , Ryd^Zok     , Ryd^Zok     , Yhr^Zok     , Yhr^Zok     , Ryd^Zok     , Yhr^Zok     , Yhr^Zok     , Yhr^Zok     , Ryd^Zok     , Uu^Zok      , Ryd^Zok     , Yhr^Zok     , Uu^Zok      , Uu          , Uu          , Ryd         , Yhl         , Yhr         , Ryd         , Yhr         , Yhl         , Yhr         , Yhr         , Yhr         , Ryd         , Ryd         , Ryd         , Yhr         , Yhl         , Ryd^Zok     , Ryd^Zok     , Yhr^Zok     , Yhr^Zok     , Yhr^Zok     , Uu^Zok      , Yhr^Zok     , Ryd^Zok     , Ryd^Zok     , Ryd^Zok     , Yhr^Zok     , Ryd^Zok     
Ryd^Zok     , Ryd^Zok     , Ryd^Zok     , Ryd^Zok     , Yhr^Zok     , Ryd^Zok     , Yhr^Zok     , Yhr^Zok     , Uu^Zok      , Uu^Zok      , Uu^Zok      , Uu^Zok      , Uu^Zok      , Uu^Zok      , Uu          , Yhr         , Yhr         , Yhr         , Ryd         , Ryd         , Ryd         , Ryd         , Ryd         , Yhl         , Ryd         , Yhl         , Ryd         , Ryd         , Ryd         , Yhr         , Yhr^Zok     , Ryd^Zok     , Ryd^Zok     , Ryd^Zok     , Ryd^Zok     , Uu^Zok      , Uu^Zok      , Yhl^Zok     , Yhr^Zok     , Yhl^Zok     , Ryd^Zok     , Ryd^Zok     
Yhr^Zok     , Ryd^Zok     , Ryd^Zok     , Yhr^Zok     , Yhr^Zok     , Ryd^Zok     , Ryd^Zok     , Yhr^Zok     , Uu^Zok      , Uu^Zok      , Ryd^Zok     , Uu^Zok      , Uu^Zok      , Yhr^Zok     , Ryd         , Ryd         , Yhr^Xp      , Ryd         , Yhr         , Yhr         , Ryd         , Ryd         , Ryd         , Yhr         , Ryd         , Yhr         , Yhr         , Ryd         , Yhr         , Yhr         , Yhr^Zok     , Yhr^Zok     , Yhr^Zok     , Ryd^Zok     , Ryd^Zok     , Uu^Zok      , Uu^Zok      , Uu^Zok      , Yhr^Zok     , Yhr^Zok     , Ryd^Zok     , Ryd^Zok     
Ryd^Zok     , Yhr^Zok     , Ryd^Zok     , Ryd^Zok     , Yhl^Zok     , Yhr^Zok     , Yhr^Zok     , Ryd^Zok     , Ryd^Zok     , Ryd^Zok     , Ryd^Zok     , Yhr^Zok     , Yhr^Zok     , Ryd^Zok     , Ryd         , Ryd         , Ryd         , Ryd         , Ryd         , Ryd         , Yhr         , Yhr         , Ryd         , Yhr         , Yhr         , Uu          , Uu          , Yhr         , Yhr         , Yhr^Xp      , Uu^Zok      , Yhr^Zok     , Ryd^Zok     , Yhl^Zok     , Ryd^Zok     , Uu^Zok      , Uu^Zok      , Ryd^Zok     , Ryd^Zok     , Yhr^Zok     , Ryd^Zok     , Ryd^Zok     
Ryd^Zok     , Ryd^Zok     , Ryd^Zok     , Yhr^Zok     , Uu^Zok      , Uu^Zok      , Yhr^Zok     , Ryd^Zok     , Ryd^Zok     , Yhr^Zok     , Ryd^Zok     , Ryd^Zok     , Ryd^Zok     , Yhl^Zok     , Yhr         , Yhl         , Ryd         , Ryd         , Ryd         , Ryd         , Ryd         , Ryd         , Yhl         , Yhr         , Ryd         , Yhr         , Uu          , Yhr         , Ryd         , Uu          , Uu^Zok      , Uu^Zok      , Uu^Zok      , Yhr^Zok     , Ryd^Zok     , Yhr^Zok     , Yhr^Zok     , Yhl^Zok     , Ryd^Zok     , Yhr^Zok     , Ryd^Zok     , Ryd^Zok     
Ryd^Zok     , Ryd^Zok     , Yhr^Zok     , Uu^Zok      , Ryd^Zok     , Uu^Zok      , Yhr^Zok     , Ryd^Zok     , Yhr^Zok     , Yhr^Zok     , Ryd^Zok     , Ryd^Zok     , Ryd^Zok     , Yhr^Zok     , Yhr^Xp      , Yhr         , Yhr         , Yhr         , Ryd         , Ryd         , Ryd         , Yhr         , Yhr         , Yhr         , Ryd         , Yhr         , Yhr         , Uu          , Ryd         , Uu          , Yhr^Zok     , Ryd^Zok     , Ryd^Zok     , Ryd^Zok     , Yhr^Zok     , Ryd^Zok     , Ryd^Zok     , Yhr^Zok     , Yhr^Zok     , Yhr^Zok     , Ryd^Zok     , Ryd^Zok     
Yhr^Zok     , Yhr^Zok     , Ryd^Zok     , Ryd^Zok     , Yhr^Zok     , Yhl^Zok     , Yhr^Zok     , Yhr^Zok     , Ryd^Zok     , Ryd^Zok     , Ryd^Zok     , Ryd^Zok     , Yhr^Zok     , Yhr^Zok     , Uu          , Ryd         , Ryd         , Ryd         , Yhr         , Yhl         , Yhr         , Ryd         , Ryd         , Ryd         , Yhl         , Yhr         , Yhr^Xp      , Ryd         , Yhl         , Yhr         , Ryd^Zok     , Ryd^Zok     , Ryd^Zok     , Ryd^Zok     , Yhr^Zok     , Yhr^Zok     , Ryd^Zok     , Yhr^Zok     , Yhr^Zok     , Yhr^Zok     , Yhr^Zok     , Yhl^Zok     
Yhr^Zok     , Ryd^Zok     , Yhr^Zok     , Ryd^Zok     , Ryd^Zok     , Yhr^Zok     , Ryd^Zok     , Ryd^Zok     , Yhr^Zok     , Ryd^Zok     , Yhr^Zok     , Ryd^Zok     , Ryd^Zok     , Uu^Zok      , Uu          , Uu          , Ryd         , Ryd         , Ryd         , Yhr^Xp      , Yhr^Xp      , Ryd         , Ryd         , Ryd         , Ryd         , Yhr         , Yhr         , Yhr         , Ryd         , Yhr         , Ryd^Zok     , Ryd^Zok     , Yhr^Zok     , Yhr^Zok     , Uu^Zok      , Ryd^Zok     , Ryd^Zok     , Yhr^Zok     , Yhr^Zok     , Ryd^Zok     , Ryd^Zok     , Yhr^Zok     
Yhr^Zok     , Yhr^Zok     , Ryd^Zok     , Ryd^Zok     , Yhr^Zok     , Yhr^Zok     , Ryd^Zok     , Ryd^Zok     , Ryd^Zok     , Yhr^Zok     , Yhr^Zok     , Ryd^Zok     , Ryd^Zok     , Ryd^Zok     , Ryd         , Yhr         , Yhr         , Yhl         , Yhr         , Ryd         , Yhr^Xp      , 3 Yhr       , Ryd         , Yhl         , Yhr         , Yhr         , Ryd         , Ryd         , Ryd         , Yhr         , Ryd^Zok     , Ryd^Zok     , Uu^Zok      , Uu^Zok      , Ryd^Zok     , Yhl^Zok     , Yhr^Zok     , Ryd^Zok     , Ryd^Zok     , Ryd^Zok     , Yhr^Zok     , Yhr^Zok     
Ryd^Zok     , Ryd^Zok     , Ryd^Zok     , Ryd^Zok     , Ryd^Zok     , Ryd^Zok     , Ryd^Zok     , Yhr^Zok     , Yhr^Zok     , Yhr^Zok     , Ryd^Zok     , Ryd^Zok     , Yhr^Zok     , Ryd^Zok     , Ryd         , Ryd         , Ryd         , Yhr         , Ryd         , Ryd         , Ryd         , Ryd         , Yhr         , Yhl         , Ryd         , Yhr         , Yhr         , Ryd         , Ryd         , Yhr         , Yhr^Zok     , Yhr^Zok     , Ryd^Zok     , Uu^Zok      , Yhr^Zok     , Yhr^Zok     , Yhr^Zok     , Yhr^Zok     , Yhr^Zok     , Ryd^Zok     , Ryd^Zok     , Ryd^Zok     
Yhr^Zok     , Yhr^Zok     , Ryd^Zok     , Yhl^Zok     , Yhr^Zok     , Ryd^Zok     , Ryd^Zok     , Yhr^Zok     , Ryd^Zok     , Yhr^Zok     , Ryd^Zok     , Ryd^Zok     , Yhl^Zok     , Yhl^Zok     , Ryd         , Ryd         , Yhr^Xp      , Yhl         , Ryd         , Ryd         , Yhr         , Ryd         , Ryd         , Yhl         , Yhl         , Ryd         , Ryd         , Ryd         , Yhl         , Yhr         , Ryd^Zok     , Ryd^Zok     , Ryd^Zok     , Ryd^Zok     , Ryd^Zok     , Ryd^Zok     , Ryd^Zok     , Yhr^Zok     , Ryd^Zok     , Ryd^Zok     , Ryd^Zok     , Ryd^Zok     
Yhr^Zok     , Ryd^Zok     , Ryd^Zok     , Yhr^Zok     , Yhr^Zok     , Ryd^Zok     , Yhr^Zok     , Yhr^Zok     , Ryd^Zok     , Ryd^Zok     , Yhr^Zok     , Yhr^Zok     , Yhr^Zok     , Yhl^Zok     , Ryd^Zok     , Yhr         , Yhr^Zok     , Ryd         , Yhr^Zok     , Yhr         , Yhr^Zok     , Yhr         , Yhr^Zok     , Ryd         , Yhr^Zok     , Yhr         , Yhr^Zok     , Yhr         , Ryd^Zok     , Yhr^Zok     , Yhr^Zok     , Ryd^Zok     , Yhr^Zok     , Ryd^Zok     , Yhr^Zok     , Ryd^Zok     , Ryd^Zok     , Ryd^Zok     , Yhl^Zok     , Yhr^Zok     , Ryd^Zok     , Ryd^Zok     
Yhr^Zok     , Yhr^Zok     , Ryd^Zok     , Ryd^Zok     , Ryd^Zok     , Ryd^Zok     , Yhr^Zok     , Ryd^Zok     , Yhr^Zok     , Yhr^Zok     , Yhr^Zok     , Yhr^Zok     , Yhl^Zok     , Ryd^Zok     , Ryd^Zok     , Yhl^Zok     , Ryd^Zok     , Ryd^Zok     , Ryd^Zok     , Ryd^Zok     , Yhl^Zok     , Ryd^Zok     , Ryd^Zok     , Ryd^Zok     , Ryd^Zok     , Yhr^Zok     , Yhr^Zok     , Ryd^Zok     , Ryd^Zok     , Yhr^Zok     , Yhr^Zok     , Ryd^Zok     , Ryd^Zok     , Uu^Zok      , Uu^Zok      , Ryd^Zok     , Yhr^Zok     , Yhr^Zok     , Yhr^Zok     , Ryd^Zok     , Ryd^Zok     , Ryd^Zok     
Yhr^Zok     , Yhr^Zok     , Yhr^Zok     , Yhl^Zok     , Uu^Zok      , Uu^Zok      , Yhr^Zok     , Ryd^Zok     , Yhr^Zok     , Yhl^Zok     , Yhr^Zok     , Yhr^Zok     , Uu^Zok      , Uu^Zok      , Ryd^Zok     , Ryd^Zok     , Yhr^Zok     , Yhl^Zok     , Ryd^Zok     , Ryd^Zok     , Yhr^Zok     , Ryd^Zok     , Ryd^Zok     , Yhr^Zok     , Yhr^Zok     , Yhr^Zok     , Ryd^Zok     , Yhr^Zok     , Ryd^Zok     , Ryd^Zok     , Yhl^Zok     , Yhr^Zok     , Uu^Zok      , Uu^Zok      , Uu^Zok      , Ryd^Zok     , Yhr^Zok     , Yhr^Zok     , Ryd^Zok     , Yhr^Zok     , Yhr^Zok     , Ryd^Zok     
Ryd^Zok     , Ryd^Zok     , Ryd^Zok     , Yhr^Zok     , Yhr^Zok     , Uu^Zok      , Yhr^Zok     , Yhr^Zok     , Yhr^Zok     , Ryd^Zok     , Ryd^Zok     , Ryd^Zok     , Uu^Zok      , Uu^Zok      , Ryd^Zok     , Yhr^Zok     , Yhr^Zok     , Yhr^Zok     , Yhr^Zok     , Yhr^Zok     , Yhl^Zok     , Yhr^Zok     , Yhr^Zok     , Ryd^Zok     , Yhr^Zok     , Yhr^Zok     , Ryd^Zok     , Ryd^Zok     , Ryd^Zok     , Yhr^Zok     , Ryd^Zok     , Yhr^Zok     , Yhr^Zok     , Uu^Zok      , Uu^Zok      , Yhr^Zok     , Yhr^Zok     , Yhr^Zok     , Ryd^Zok     , Yhr^Zok     , Yhl^Zok     , Ryd^Zok     
Ryd^Zok     , Ryd^Zok     , Ryd^Zok     , Ryd^Zok     , Ryd^Zok     , Yhr^Zok     , Yhr^Zok     , Ryd^Zok     , Ryd^Zok     , Ryd^Zok     , Ryd^Zok     , Yhr^Zok     , Uu^Zok      , Ryd^Zok     , Yhr^Zok     , Yhl^Zok     , Ryd^Zok     , Yhr^Zok     , Yhr^Zok     , Ryd^Zok     , Ryd^Zok     , Uu^Zok      , Uu^Zok      , Yhl^Zok     , Yhr^Zok     , Ryd^Zok     , Yhl^Zok     , Ryd^Zok     , Ryd^Zok     , Yhr^Zok     , Ryd^Zok     , Ryd^Zok     , Ryd^Zok     , Yhr^Zok     , Uu^Zok      , Yhr^Zok     , Yhr^Zok     , Ryd^Zok     , Yhr^Zok     , Ryd^Zok     , Ryd^Zok     , Ryd^Zok     
Ryd^Zok     , Yhr^Zok     , Ryd^Zok     , Uu^Zok      , Uu^Zok      , Yhr^Zok     , Yhr^Zok     , Ryd^Zok     , Yhr^Zok     , Ryd^Zok     , Ryd^Zok     , Yhr^Zok     , Ryd^Zok     , Ryd^Zok     , Yhl^Zok     , Yhl^Zok     , Yhr^Zok     , Yhl^Zok     , Ryd^Zok     , Ryd^Zok     , Uu^Zok      , Uu^Zok      , Yhr^Zok     , Yhr^Zok     , Ryd^Zok     , Ryd^Zok     , Ryd^Zok     , Ryd^Zok     , Ryd^Zok     , Ryd^Zok     , Ryd^Zok     , Ryd^Zok     , Ryd^Zok     , Yhr^Zok     , Uu^Zok      , Yhr^Zok     , Ryd^Zok     , Yhr^Zok     , Ryd^Zok     , Ryd^Zok     , Yhr^Zok     , Ryd^Zok     
Yhr^Zok     , Yhr^Zok     , Ryd^Zok     , Yhr^Zok     , Uu^Zok      , Uu^Zok      , Yhr^Zok     , Yhr^Zok     , Yhr^Zok     , Ryd^Zok     , Ryd^Zok     , Yhr^Zok     , Ryd^Zok     , Ryd^Zok     , Ryd^Zok     , Yhl^Zok     , Yhr^Zok     , Yhr^Zok     , Yhr^Zok     , Ryd^Zok     , Ryd^Zok     , Yhr^Zok     , Yhr^Zok     , Ryd^Zok     , Yhr^Zok     , Yhr^Zok     , Yhr^Zok     , Ryd^Zok     , Ryd^Zok     , Yhr^Zok     , Ryd^Zok     , Ryd^Zok     , Yhr^Zok     , Ryd^Zok     , Yhr^Zok     , Yhr^Zok     , Ryd^Zok     , Yhr^Zok     , Ryd^Zok     , Yhl^Zok     , Yhr^Zok     , Yhr^Zok     
Yhr^Zok     , Ryd^Zok     , Yhr^Zok     , Yhr^Zok     , Yhr^Zok     , Uu^Zok      , Yhr^Zok     , Ryd^Zok     , Ryd^Zok     , Yhr^Zok     , Yhr^Zok     , Yhr^Zok     , Ryd^Zok     , Ryd^Zok     , Yhr^Zok     , Ryd^Zok     , Ryd^Zok     , Ryd^Zok     , Yhr^Zok     , Ryd^Zok     , Ryd^Zok     , Yhr^Zok     , Ryd^Zok     , Ryd^Zok     , Ryd^Zok     , Ryd^Zok     , Ryd^Zok     , Ryd^Zok     , Ryd^Zok     , Yhr^Zok     , Yhl^Zok     , Yhr^Zok     , Ryd^Zok     , Yhr^Zok     , Ryd^Zok     , Ryd^Zok     , Yhr^Zok     , Yhr^Zok     , Ryd^Zok     , Ryd^Zok     , Ryd^Zok     , Ryd^Zok     
Ryd^Zok     , Ryd^Zok     , Ryd^Zok     , Ryd^Zok     , Yhr^Zok     , Ryd^Zok     , Yhr^Zok     , Ryd^Zok     , Ryd^Zok     , Ryd^Zok     , Yhr^Zok     , Ryd^Zok     , Yhr^Zok     , Yhr^Zok     , Ryd^Zok     , Ryd^Zok     , Yhr^Zok     , Yhr^Zok     , Ryd^Zok     , Ryd^Zok     , Ryd^Zok     , Ryd^Zok     , Ryd^Zok     , Yhr^Zok     , Yhr^Zok     , Ryd^Zok     , Yhr^Zok     , Ryd^Zok     , Yhl^Zok     , Yhr^Zok     , Ryd^Zok     , Ryd^Zok     , Ryd^Zok     , Yhr^Zok     , Ryd^Zok     , Ryd^Zok     , Yhr^Zok     , Uu^Zok      , Uu^Zok      , Ryd^Zok     , Yhr^Zok     , Ryd^Zok     
Ryd^Zok     , Ryd^Zok     , Yhr^Zok     , Uu^Zok      , Ryd^Zok     , Ryd^Zok     , Ryd^Zok     , Ryd^Zok     , Yhr^Zok     , Yhr^Zok     , Yhr^Zok     , Yhr^Zok     , Yhr^Zok     , Uu^Zok      , Uu^Zok      , Ryd^Zok     , Yhr^Zok     , Yhr^Zok     , Yhr^Zok     , Ryd^Zok     , Yhr^Zok     , Yhr^Zok     , Ryd^Zok     , Ryd^Zok     , Ryd^Zok     , Yhr^Zok     , Ryd^Zok     , Yhr^Zok     , Yhr^Zok     , Yhr^Zok     , Yhr^Zok     , Yhr^Zok     , Yhr^Zok     , Yhr^Zok     , Yhr^Zok     , Ryd^Zok     , Ryd^Zok     , Yhr^Zok     , Uu^Zok      , Yhr^Zok     , Yhr^Zok     , Ryd^Zok     
Yhr^Zok     , Yhl^Zok     , Uu^Zok      , Uu^Zok      , Uu^Zok      , Yhr^Zok     , Ryd^Zok     , Ryd^Zok     , Ryd^Zok     , Yhl^Zok     , Ryd^Zok     , Yhr^Zok     , Yhr^Zok     , Uu^Zok      , Uu^Zok      , Yhr^Zok     , Uu^Zok      , Ryd^Zok     , Yhr^Zok     , Yhr^Zok     , Yhr^Zok     , Yhr^Zok     , Yhr^Zok     , Yhr^Zok     , Yhr^Zok     , Ryd^Zok     , Yhr^Zok     , Yhr^Zok     , Yhr^Zok     , Yhl^Zok     , Yhr^Zok     , Uu^Zok      , Yhr^Zok     , Ryd^Zok     , Ryd^Zok     , Ryd^Zok     , Ryd^Zok     , Ryd^Zok     , Uu^Zok      , Uu^Zok      , Yhr^Zok     , Ryd^Zok     
