border_size=1
usage=map

Yhr          , Uu          , Uu          , Ryd         , Yhr          , Yhr          , Uu          , Uu          , Uu          , Yhr          , Ryd         , Yhr          , Yhr^Xp         , Yhr          , Ryd         , Ryd         , Yhr          , Yhr          , Ryd         , Yhr          , Ryd         , Ryd         , Ryd         , Ryd         , Ryd         , Yhr          , Ryd         , Ryd         , Yhr          , Ryd         , Yhr          , Ryd         , Ryd         , Ryd         , Ryd         , Ryd         , Yhr          , Ryd         , Yhr^Xp         , Ryd         , Yhr^Xp         , Yhr
Ryd         , Yhr          , Ryd         , Yhr          , Yhr          , Yhr^Xp         , Yhr          , Uu          , Ryd         , Yhr          , Yhr          , Yhr          , Ryd         , Yhr          , Yhl          , Ryd         , Yhr^Xp         , Ryd         , Ryd         , Yhr          , Ryd         , Yhr          , Yhr^Xp         , Ryd         , Ryd         , Yhr          , Ryd         , Ryd         , Yhr          , Ryd         , Ryd         , Yhl          , Ryd         , Yhr          , Ryd         , Ryd         , Ryd         , Ryd         , Ryd         , Ryd         , Yhr          , Yhr
Yhr          , Ryd         , Ryd         , Ryd         , Ryd         , Yhr          , Ryd         , Ryd         , Yhr          , Ryd         , Ryd         , Ryd         , Yhr          , Ryd         , Yhl          , Yhl          , Ryd         , Yhr          , Ryd         , Yhr          , Ryd         , Yhr          , Yhr          , Yhr          , Yhr          , Yhr          , Ryd         , Yhr^Xp         , Ryd         , Yhr          , Ryd         , Ryd         , Ryd         , Ryd         , Yhr          , Yhr          , Yhr          , Ryd         , Yhr          , Yhl          , Ryd         , Ryd
Yhr^Xp         , Ryd         , Yhr          , Ryd         , Yhr          , Ryd         , Ryd         , Uu          , Uu          , Yhr^Xp         , Ryd         , Ryd         , Yhl          , Yhr          , Yhl          , Yhr          , Yhr          , Ryd         , Yhr          , Yhr          , Yhr          , Yhr          , Yhl          , Yhr          , Ryd         , Yhr          , Ryd         , Ryd         , Yhr          , Ryd         , Ryd         , Yhl          , Yhl          , Ryd         , Ryd         , Yhr^Xp         , Yhr          , Yhr          , Uu          , Ryd         , Ryd         , Yhr
Yhr          , Ryd         , Ryd         , Yhr^Xp         , Ryd         , Ryd         , Ryd         , Uu          , Yhl          , Yhl          , Ryd         , Yhr          , Ryd         , Yhl          , Yhl          , Ryd         , Yhr          , Yhr^Xp         , Ryd         , Ryd         , Yhr^Xp         , Yhr          , Yhr          , Yhl          , Ryd         , Yhr^Xp         , Ryd         , Ryd         , Yhr          , Uu          , Uu          , Yhr          , Yhr          , Yhr          , Ryd         , Yhr          , Yhr          , Uu          , Uu          , Yhr^Xp         , Ryd         , Yhr
Yhr          , Yhl          , Yhl          , Yhr          , Ryd         , Yhr^Xp         , Yhr          , Yhr          , Yhl          , Yhr          , Yhr^Xp         , Yhr          , Yhr          , Yhl          , Ryd         , Yhr          , Yhr          , Ryd         , Yhr          , Yhr          , Ryd         , Yhr          , Ryd         , Ryd         , Ryd         , Yhr          , Ryd         , Ryd         , Yhr          , Uu          , Yhl          , Yhr          , Ryd         , Ryd         , Yhr          , Ryd         , Yhl          , Uu          , Yhl          , Yhr          , Ryd         , Yhl
Ryd         , Yhl          , Yhr          , Yhr          , Yhr          , Ryd         , Ryd         , Yhr          , Yhl          , Yhr          , Ryd         , Yhr          , Uu          , Yhl          , Ryd         , Yhr          , Ryd         , Yhl          , Yhr          , Ryd         , Ryd         , Yhr          , Yhr          , Yhr          , Ryd         , Ryd         , Yhr          , Ryd         , Ryd         , Yhr          , Ryd         , Ryd         , Ryd         , Ryd         , Yhr          , Ryd         , Yhr          , Uu          , Ryd         , Ryd         , Yhr          , Ryd
Ryd         , Yhl          , Ryd         , Yhr          , Ryd         , Yhr          , Yhr          , Ryd         , Yhl          , Yhl          , Ryd         , Uu          , Uu          , Uu          , Yhr^Xp         , Yhr          , Ryd         , Yhr          , Ryd         , Ryd         , Yhr^Xp         , Ryd         , Ryd         , Ryd         , Ryd         , Yhl          , Yhr          , Yhr          , Ryd         , Yhl          , Yhr          , Ryd         , Ryd         , Yhr          , Ryd         , Yhl          , Yhr          , Yhr          , Yhl          , Ryd         , Yhr          , Yhr
Yhr          , Yhl          , Ryd         , Yhr          , Yhr          , Ryd         , Yhr          , Yhr          , Yhr^Xp         , Ryd         , Ryd         , Yhr          , Ryd         , Ryd         , Ryd         , Ryd         , Yhr          , Ryd         , Ryd         , Ryd         , Yhr          , Ryd         , Ryd         , Ryd         , Yhr          , Ryd         , Yhr          , Yhr^Xp         , Ryd         , Yhr^Xp         , Ryd         , Yhr          , Yhr          , Ryd         , Yhr          , Yhl          , Yhr          , Yhr          , Ryd         , Yhr          , Ryd         , Ryd
Yhr          , Ryd         , Yhr^Xp         , Ryd         , Uu          , Ryd         , Uu          , Yhr          , Yhr          , Yhr          , Yhr          , Yhr          , Ryd         , Ryd         , Ryd         , Yhr          , Ryd         , Yhr^Xp         , Yhr          , Ryd         , Ryd         , Ryd         , Yhr          , Ryd         , Ryd         , Ryd         , Ryd         , Yhr          , Ryd         , Yhr          , Yhr          , Yhr          , Yhr          , Yhl          , Ryd         , Ryd         , Ryd         , Ryd         , Yhr          , Ryd         , Ryd         , Ryd
Ryd         , Ryd         , Ryd         , Yhr          , Uu          , Uu          , Yhr          , Yhr          , Yhr          , Yhl          , Uu          , Ryd         , Yhr          , Ryd         , Yhr          , Ryd         , Yhr          , Ryd         , Ryd         , Yhl          , Ryd         , Yhr^Xp         , Ryd         , Yhr          , Yhr          , Ryd         , Ryd         , Ryd         , Yhr          , Yhr          , Ryd         , Ryd         , Yhr^Xp         , Ryd         , Ryd         , Ryd         , Yhr          , Yhr^Xp         , Yhl          , Ryd         , Yhl          , Yhr
Ryd         , Ryd         , Ryd         , Yhr          , Ryd         , Yhr          , Yhr          , Yhr^Xp         , Yhr          , Uu          , Uu          , Ryd         , Yhr^Xp         , Yhr          , Ryd         , Ryd         , Yhr^Xp         , Ryd         , Ryd         , Yhr          , Yhr          , Yhr          , Yhr          , Ryd         , Yhr          , Yhr^Xp         , Yhr          , Ryd         , Ryd         , Yhr          , Ryd         , Yhr          , Ryd         , Yhl          , Yhl          , Ryd         , Yhr          , Yhr          , Ryd         , Yhl          , Yhr^Xp         , Yhr
Yhr          , Ryd         , Yhr          , Yhl          , Yhl          , Ryd         , Yhr          , Ryd         , Yhr          , Ryd         , Ryd         , Yhr          , Yhr          , Ryd         , Ryd         , Yhr          , Yhl          , Yhr          , Ryd         , Yhr          , Ryd         , 1 Yhr        , Ryd         , Ryd         , Ryd         , Ryd         , Yhl          , Ryd         , Yhr          , Ryd         , Yhr          , Yhr          , Ryd         , Yhl          , Yhr          , Ryd         , Ryd         , Ryd         , Ryd         , Yhr          , Ryd         , Yhr
Ryd         , Yhr          , Ryd         , Yhr          , Ryd         , Ryd         , Yhl          , Yhl          , Yhr          , Ryd         , Ryd         , Yhr          , Yhr          , Yhl          , Ryd         , Ryd         , Ryd         , Ryd         , Yhr          , Yhr          , Ryd         , Ryd         , Yhr          , Yhr^Xp         , Ryd         , Yhr          , Yhr          , Yhr          , Ryd         , Yhr          , Ryd         , Ryd         , Ryd         , Yhr          , Uu          , Ryd         , Yhr          , Yhr          , Yhl          , Ryd         , Ryd         , Ryd
Ryd         , Ryd         , Ryd         , Yhr^Xp         , Yhr          , Ryd         , Yhr          , Yhr          , Yhr          , Ryd         , Uu          , Ryd         , Yhr          , Uu          , Uu          , Uu          , Ryd         , Yhl          , Yhr          , Ryd         , Yhr          , Yhl          , Yhr          , Yhr          , Yhr          , Ryd         , Ryd         , Ryd         , Yhr          , Yhl          , Ryd         , Ryd         , Yhr          , Yhr^Xp         , Yhr          , Uu          , Yhr          , Ryd         , Ryd         , Ryd         , Yhr^Xp         , Ryd
Ryd         , Ryd         , Ryd         , Ryd         , Yhr          , Ryd         , Yhr          , Yhr^Xp         , Uu          , Uu          , Uu          , Uu          , Uu          , Uu          , Uu          , Yhr          , Yhr          , Yhr          , Ryd         , Ryd         , Ryd         , Ryd         , Ryd         , Yhl          , Ryd         , Yhl          , Ryd         , Ryd         , Ryd         , Yhr          , Yhr          , Ryd         , Ryd         , Ryd         , Ryd         , Uu          , Uu          , Yhl          , Yhr          , Yhl          , Ryd         , Ryd
Yhr          , Ryd         , Ryd         , Yhr          , Yhr          , Ryd         , Ryd         , Yhr          , Uu          , Uu          , Ryd         , Uu          , Uu          , Yhr^Xp         , Ryd         , Ryd         , Yhr^Xp         , Ryd         , Yhr          , Yhr          , Ryd         , Ryd         , Ryd         , Yhr          , Ryd         , Yhr          , Yhr          , Ryd         , Yhr          , Yhr          , Yhr          , Yhr          , Yhr          , Ryd         , Ryd         , Uu          , Uu          , Uu          , Yhr          , Yhr          , Ryd         , Ryd
Ryd         , Yhr          , Ryd         , Ryd         , Yhl          , Yhr          , Yhr          , Ryd         , Ryd         , Ryd         , Ryd         , Yhr          , Yhr          , Ryd         , Yhr          , Ryd         , Ryd         , Ryd         , Ryd         , Ryd         , Yhr          , Yhr          , Ryd         , Yhr          , Yhr          , Uu          , Uu          , Yhr          , Yhr          , Yhr^Xp         , Uu          , Yhr          , Ryd         , Yhl          , Ryd         , Uu          , Uu          , Ryd         , Ryd         , Yhr          , Ryd         , Ryd
Ryd         , Ryd         , Ryd         , Yhr          , Uu          , Uu          , Yhr          , Ryd         , Ryd         , Yhr          , Ryd         , Ryd         , Ryd         , Yhl          , Yhr          , Yhl          , Ryd         , Ryd         , Ryd         , Ryd         , Ryd         , Ryd         , Yhl          , Yhr          , Ryd         , Yhr          , Uu          , Yhr          , Ryd         , Uu          , Uu          , Uu          , Uu          , Yhr          , Ryd         , Yhr          , Yhr          , Yhl          , Ryd         , Yhr          , Ryd         , Ryd
Ryd         , Ryd         , Yhr          , Uu          , Ryd         , Uu          , Yhr          , Ryd         , Yhr          , Yhr^Xp         , Ryd         , Ryd         , Ryd         , Yhr          , Yhr^Xp         , Yhr          , Yhr          , Yhr          , Ryd         , Ryd         , Ryd         , Yhr          , Yhr          , Yhr          , Ryd         , Yhr          , Yhr          , Uu          , Ryd         , Uu          , Yhr^Xp         , Ryd         , Ryd         , Ryd         , Yhr          , Ryd         , Ryd         , Yhr          , Yhr          , Yhr          , Ryd         , Ryd
Yhr          , Yhr          , Ryd         , Ryd         , Yhr          , Yhl          , Yhr          , Yhr          , Ryd         , Ryd         , Ryd         , Ryd         , Yhr          , Yhr          , Uu          , Ryd         , Ryd         , Ryd         , Yhr          , Yhl          , Yhr          , Ryd         , Ryd         , Ryd         , Yhl          , Yhr          , Yhr^Xp         , Ryd         , Yhl          , Yhr          , Ryd         , Ryd         , Ryd         , Ryd         , Yhr          , Yhr          , Ryd         , Yhr          , Yhr          , Yhr^Xp         , Yhr          , Yhl
Yhr^Xp         , Ryd         , Yhr          , Ryd         , Ryd         , Yhr^Xp         , Ryd         , Ryd         , Yhr          , Ryd         , Yhr          , Ryd         , Ryd         , Uu          , Uu          , Uu          , Ryd         , Ryd         , Ryd         , Yhr^Xp         , Yhr^Xp         , Ryd         , Ryd         , Ryd         , Ryd         , Yhr          , Yhr          , Yhr          , Ryd         , Yhr          , Ryd         , Ryd         , Yhr          , Yhr^Xp         , Uu          , Ryd         , Ryd         , Yhr          , Yhr          , Ryd         , Ryd         , Yhr
Yhr          , Yhr          , Ryd         , Ryd         , Yhr          , Yhr          , Ryd         , Ryd         , Ryd         , Yhr^Xp         , Yhr          , Ryd         , Ryd         , Ryd         , Ryd         , Yhr          , Yhr          , Yhl          , Yhr          , Ryd         , Yhr^Xp         , 3 Yhr        , Ryd         , Yhl          , Yhr          , Yhr          , Ryd         , Ryd         , Ryd         , Yhr          , Ryd         , Ryd         , Uu          , Uu          , Ryd         , Yhl          , Yhr^Xp         , Ryd         , Ryd         , Ryd         , Yhr          , Yhr
Ryd         , Ryd         , Ryd         , Ryd         , Ryd         , Ryd         , Ryd         , Yhr          , Yhr          , Yhr          , Ryd         , Ryd         , Yhr          , Ryd         , Ryd         , Ryd         , Ryd         , Yhr          , Ryd         , Ryd         , Ryd         , Ryd         , Yhr          , Yhl          , Ryd         , Yhr          , Yhr          , Ryd         , Ryd         , Yhr          , Yhr^Xp         , Yhr          , Ryd         , Uu          , Yhr          , Yhr          , Yhr          , Yhr          , Yhr          , Ryd         , Ryd         , Ryd
Yhr          , Yhr          , Ryd         , Yhl          , Yhr^Xp         , Ryd         , Ryd         , Yhr          , Ryd         , Yhr          , Ryd         , Ryd         , Yhl          , Yhl          , Ryd         , Ryd         , Yhr^Xp         , Yhl          , Ryd         , Ryd         , Ryd         , Ryd         , Ryd         , Yhl          , Yhl          , Ryd         , Ryd         , Ryd         , Yhl          , Yhr          , Ryd         , Ryd         , Ryd         , Ryd         , Ryd         , Ryd         , Ryd         , Yhr^Xp         , Ryd         , Ryd         , Ryd         , Ryd
Yhr          , Ryd         , Ryd         , Yhr          , Yhr          , Ryd         , Yhr          , Yhr          , Ryd         , Ryd         , Yhr^Xp         , Yhr          , Yhr          , Yhl          , Ryd         , Yhr          , Yhr          , Ryd         , Yhr          , Yhr          , Ryd         , Yhr          , Yhr          , Yhr^Xp         , Yhr          , Yhl          , Ryd         , Ryd         , Ryd         , Yhr          , Yhr          , Ryd         , Yhr^Xp         , Ryd         , Yhr          , Ryd         , Ryd         , Ryd         , Yhl          , Yhr          , Ryd         , Ryd
Yhr          , Yhr^Xp         , Ryd         , Ryd         , Ryd         , Ryd         , Yhr          , Ryd         , Yhr          , Yhr          , Yhr          , Yhr          , Yhl          , Ryd         , Ryd         , Yhl          , Ryd         , Ryd         , Ryd         , Ryd         , Yhl          , Ryd         , Ryd         , Ryd         , Ryd         , Yhr          , Yhr          , Ryd         , Ryd         , Yhr          , Yhr          , Ryd         , Ryd         , Uu          , Uu          , Ryd         , Yhr          , Yhr          , Yhr          , Ryd         , Ryd         , Ryd
Yhr          , Yhr          , Yhr          , Yhl          , Uu          , Uu          , Yhr          , Ryd         , Yhr          , Yhl          , Yhr          , Yhr^Xp         , Uu          , Uu          , Ryd         , Ryd         , Yhr          , Yhl          , Ryd         , Ryd         , Yhr          , Ryd         , Ryd         , Yhr          , Yhr          , Yhr^Xp         , Ryd         , Yhr          , Ryd         , Ryd         , Yhl          , Yhr^Xp         , Uu          , Uu          , Uu          , Ryd         , Yhr          , Yhr^Xp         , Ryd         , Yhr^Xp         , Yhr          , Ryd
Ryd         , Ryd         , Ryd         , Yhr          , Yhr          , Uu          , Yhr^Xp         , Yhr          , Yhr          , Ryd         , Ryd         , Ryd         , Uu          , Uu          , Ryd         , Yhr          , Yhr          , Yhr^Xp         , Yhr          , Yhr          , Yhl          , Yhr          , Yhr          , Ryd         , Yhr          , Yhr          , Ryd         , Ryd         , Ryd         , Yhr          , Ryd         , Yhr          , Yhr          , Uu          , Uu          , Yhr          , Yhr^Xp         , Yhr          , Ryd         , Yhr          , Yhl          , Ryd
Ryd         , Ryd         , Ryd         , Ryd         , Ryd         , Yhr          , Yhr          , Ryd         , Ryd         , Ryd         , Ryd         , Yhr          , Uu          , Ryd         , Yhr          , Yhl          , Ryd         , Yhr          , Yhr          , Ryd         , Ryd         , Uu          , Uu          , Yhl          , Yhr          , Ryd         , Yhl          , Ryd         , Ryd         , Yhr          , Ryd         , Ryd         , Ryd         , Yhr          , Uu          , Yhr          , Yhr^Xp         , Ryd         , Yhr          , Ryd         , Ryd         , Ryd
Ryd         , Yhr          , Ryd         , Uu          , Uu          , Yhr          , Yhr          , Ryd         , Yhr^Xp         , Ryd         , Ryd         , Yhr          , Ryd         , Ryd         , Yhl          , Yhl          , Yhr          , Yhl          , Ryd         , Ryd         , Uu          , Uu          , Yhr^Xp         , Yhr          , Ryd         , Ryd         , Ryd         , Ryd         , Ryd         , Ryd         , Ryd         , Ryd         , Ryd         , Yhr          , Uu          , Yhr          , Ryd         , Yhr^Xp         , Ryd         , Ryd         , Yhr^Xp         , Ryd
Yhr          , Yhr^Xp         , Ryd         , Yhr          , Uu          , Uu          , Yhr          , Yhr          , Yhr          , Ryd         , Ryd         , Yhr          , Ryd         , Ryd         , Ryd         , Yhl          , Yhr          , Yhr          , Yhr          , Ryd         , Ryd         , Yhr          , Yhr          , Ryd         , Yhr          , Yhr          , Yhr          , Ryd         , Ryd         , Yhr          , Ryd         , Ryd         , Yhr^Xp         , Ryd         , Yhr          , Yhr          , Ryd         , Yhr          , Ryd         , Yhl          , Yhr          , Yhr
Yhr          , Ryd         , Yhr          , Yhr          , Yhr          , Uu          , Yhr          , Ryd         , Ryd         , Yhr          , Yhr          , Yhr          , Ryd         , Ryd         , Yhr          , Ryd         , Ryd         , Ryd         , Yhr          , Ryd         , Ryd         , Yhr          , Ryd         , Ryd         , Ryd         , Ryd         , Ryd         , Ryd         , Ryd         , Yhr          , Yhl          , Yhr          , Ryd         , Yhr          , Ryd         , Ryd         , Yhr          , Yhr          , Ryd         , Ryd         , Ryd         , Ryd
Ryd         , Ryd         , Ryd         , Ryd         , Yhr          , Ryd         , Yhr^Xp         , Ryd         , Ryd         , Ryd         , Yhr          , Ryd         , Yhr          , Yhr          , Ryd         , Ryd         , Yhr          , Yhr^Xp         , Ryd         , Ryd         , Ryd         , Ryd         , Ryd         , Yhr^Xp         , Yhr^Xp         , Ryd         , Yhr          , Ryd         , Yhl          , Yhr          , Ryd         , Ryd         , Ryd         , Yhr          , Ryd         , Ryd         , Yhr          , Uu          , Uu          , Ryd         , Yhr^Xp         , Ryd
Ryd         , Ryd         , Yhr          , Uu          , Ryd         , Ryd         , Ryd         , Ryd         , Yhr          , Yhr          , Yhr^Xp         , Yhr^Xp         , Yhr          , Uu          , Uu          , Ryd         , Yhr          , Yhr          , Yhr          , Ryd         , Yhr          , Yhr          , Ryd         , Ryd         , Ryd         , Yhr^Xp         , Ryd         , Yhr^Xp         , Yhr          , Yhr          , Yhr          , Yhr          , Yhr          , Yhr          , Yhr          , Ryd         , Ryd         , Yhr          , Uu          , Yhr          , Yhr          , Ryd
Yhr          , Yhl          , Uu          , Uu          , Uu          , Yhr          , Ryd         , Ryd         , Ryd         , Yhl          , Ryd         , Yhr          , Yhr          , Uu          , Uu          , Yhr          , Uu          , Ryd         , Yhr          , Yhr          , Yhr          , Yhr^Xp         , Yhr          , Yhr          , Yhr          , Ryd         , Yhr          , Yhr          , Yhr          , Yhl          , Yhr^Xp         , Uu          , Yhr          , Ryd         , Ryd         , Ryd         , Ryd         , Ryd         , Uu          , Uu          , Yhr^Xp         , Ryd
Yhr^Xp         , Yhr          , Uu          , Uu          , Ryd         , Ryd         , Ryd         , Ryd         , Yhr          , Ryd         , Ryd         , Yhr          , Ryd         , Ryd         , Yhl          , Yhr          , Yhr^Xp         , Uu          , Ryd         , Yhl          , Yhr          , Ryd         , Yhr          , Ryd         , Ryd         , Ryd         , Yhr          , Yhr          , Ryd         , Yhr          , Uu          , Uu          , Yhr          , Yhr          , Yhr^Xp         , Yhl          , Yhr          , Ryd         , Ryd         , Uu          , Yhl          , Ryd
Ryd         , Yhr          , Yhr          , Uu          , Yhr^Xp         , Yhr          , Yhr          , Ryd         , Yhl          , Ryd         , Yhr          , Ryd         , Ryd         , Yhr          , Yhr^Xp         , Yhr          , Ryd         , Uu          , Ryd         , Ryd         , Yhr          , Ryd         , Ryd         , Ryd         , Ryd         , Ryd         , Yhr          , Ryd         , Ryd         , Yhr^Xp         , Yhr          , Uu          , Uu          , Yhr          , Yhr          , Yhr          , Yhr          , Yhr          , Ryd         , Yhr          , Yhr          , Yhr
Ryd         , Ryd         , Ryd         , Ryd         , Yhl          , Uu          , Uu          , Yhr          , Ryd         , Yhr          , Ryd         , Ryd         , Ryd         , Ryd         , Yhr          , Ryd         , Yhr          , Ryd         , Ryd         , Ryd         , Ryd         , Ryd         , Yhr          , Yhr          , Yhr          , Ryd         , Ryd         , Yhr^Xp         , Ryd         , Ryd         , Yhr^Xp         , Uu          , Uu          , Uu          , Ryd         , Ryd         , Yhr          , Yhr^Xp         , Ryd         , Ryd         , Ryd         , Ryd
Yhr          , Ryd         , Yhr^Xp         , Ryd         , Yhr          , Uu          , Yhr          , Ryd         , Ryd         , Ryd         , Yhr^Xp         , Ryd         , Ryd         , Yhr          , Ryd         , Ryd         , Yhl          , Yhr^Xp         , Yhr          , Yhr          , Ryd         , Ryd         , Yhr          , Yhl          , Ryd         , Ryd         , Yhr          , Ryd         , Ryd         , Ryd         , Ryd         , Uu          , Uu          , Uu          , Yhr          , Yhr          , Yhr^Xp         , Yhr          , Yhl          , Yhr          , Ryd         , Yhr
Ryd         , Yhr          , Yhr          , Ryd         , Yhr          , Ryd         , Ryd         , Ryd         , Yhr          , Ryd         , Yhr          , Yhr          , Yhr^Xp         , Ryd         , Ryd         , Ryd         , Ryd         , Ryd         , Ryd         , Ryd         , Ryd         , Ryd         , Yhr          , Ryd         , Ryd         , Ryd         , Yhl          , Ryd         , Yhr^Xp         , Ryd         , Ryd         , Yhr^Xp         , Yhr          , Ryd         , Yhr          , Ryd         , Yhr          , Yhr          , Yhr          , Yhr^Xp         , Yhr          , Ryd
Yhr          , Ryd         , Ryd         , Yhr          , Yhr          , Ryd         , Ryd         , Yhr          , Ryd         , Ryd         , Ryd         , Yhl          , Yhr          , Yhr          , Ryd         , Ryd         , Yhr          , Yhr          , Ryd         , Ryd         , Ryd         , Yhr          , Ryd         , Yhr          , Ryd         , Yhr          , Yhr          , Yhr          , Yhr          , Yhr          , Yhr          , Yhr          , Ryd         , Yhl          , Yhr          , Yhr          , Ryd         , Ryd         , Yhr          , Ryd         , Ryd         , Ryd
